R,G,B,X,Y,Z,Lv,sx,sy,sz,lT,duv,Lv_amb,Reflection,Lv_min,Lv_max,L_ratio
0,0,0,0,0,0,,,0,0,0,,,,,,
3,3,21,0,0,0,,,3,3,21,,,,,,
7,7,43,7,7,43,,,0,0,0,,,,,,
10,11,66,10,10,66,,,0,1,0,,,,,,
14,14,90,14,14,90,,,0,0,0,,,,,,
18,18,113,17,18,113,,,1,0,0,,,,,,
21,22,137,21,22,137,,,0,0,0,,,,,,
25,26,161,25,25,161,,,0,1,0,,,,,,
29,29,185,29,29,185,,,0,0,0,,,,,,
32,33,210,32,33,209,,,0,0,1,,,,,,
36,37,234,36,37,234,,,0,0,0,,,,,,
40,41,258,40,41,258,,,0,0,0,,,,,,
44,45,283,44,45,283,,,0,0,0,,,,,,
48,49,308,47,49,307,,,1,0,1,,,,,,
51,53,332,51,53,332,,,0,0,0,,,,,,
55,57,357,55,57,357,,,0,0,0,,,,,,
59,61,382,59,61,382,,,0,0,0,,,,,,
63,65,407,63,65,407,,,0,0,0,,,,,,
67,69,432,67,69,432,,,0,0,0,,,,,,
71,73,457,71,72,457,,,0,1,0,,,,,,
75,76,482,75,76,482,,,0,0,0,,,,,,
79,80,507,78,80,507,,,1,0,0,,,,,,
82,84,532,82,84,532,,,0,0,0,,,,,,
86,88,557,86,88,557,,,0,0,0,,,,,,
90,92,583,90,92,583,,,0,0,0,,,,,,
94,97,608,94,96,608,,,0,1,0,,,,,,
98,101,633,98,101,633,,,0,0,0,,,,,,
102,105,659,102,105,658,,,0,0,1,,,,,,
106,109,684,106,109,684,,,0,0,0,,,,,,
110,113,710,110,113,709,,,0,0,1,,,,,,
114,117,735,114,117,735,,,0,0,0,,,,,,
118,121,761,118,121,760,,,0,0,1,,,,,,
13,24,6,0,0,0,,,13,24,6,,,,,,
14,24,21,0,0,0,,,14,24,21,,,,,,
15,25,44,7,7,43,,,8,18,1,,,,,,
17,26,67,10,10,66,,,7,16,1,,,,,,
19,27,90,14,14,90,,,5,13,0,,,,,,
22,29,113,17,18,113,,,5,11,0,,,,,,
25,32,137,21,22,137,,,4,10,0,,,,,,
28,34,161,25,25,161,,,3,9,0,,,,,,
31,37,185,29,29,185,,,2,8,0,,,,,,
35,40,210,32,33,209,,,3,7,1,,,,,,
38,43,234,36,37,234,,,2,6,0,,,,,,
42,47,258,40,41,258,,,2,6,0,,,,,,
45,50,283,44,45,283,,,1,5,0,,,,,,
49,54,308,47,49,307,,,2,5,1,,,,,,
53,57,332,51,53,332,,,2,4,0,,,,,,
57,61,357,55,57,357,,,2,4,0,,,,,,
60,64,382,59,61,382,,,1,3,0,,,,,,
64,68,407,63,65,407,,,1,3,0,,,,,,
68,72,432,67,69,432,,,1,3,0,,,,,,
72,76,457,71,72,457,,,1,4,0,,,,,,
76,80,482,75,76,482,,,1,4,0,,,,,,
79,83,507,78,80,507,,,1,3,0,,,,,,
83,87,532,82,84,532,,,1,3,0,,,,,,
87,91,557,86,88,557,,,1,3,0,,,,,,
91,95,583,90,92,583,,,1,3,0,,,,,,
95,99,608,94,96,608,,,1,3,0,,,,,,
99,103,633,98,101,633,,,1,2,0,,,,,,
103,107,659,102,105,658,,,1,2,1,,,,,,
107,111,684,106,109,684,,,1,2,0,,,,,,
110,115,710,110,113,709,,,0,2,1,,,,,,
114,119,735,114,117,735,,,0,2,0,,,,,,
118,123,761,118,121,760,,,0,2,1,,,,,,
28,50,13,28,50,13,,,0,0,0,,,,,,
28,50,24,28,50,13,,,0,0,11,,,,,,
28,50,45,28,50,45,,,0,0,0,,,,,,
29,51,67,29,51,67,,,0,0,0,,,,,,
31,52,90,31,52,90,,,0,0,0,,,,,,
32,53,114,32,53,114,,,0,0,0,,,,,,
34,54,138,34,54,138,,,0,0,0,,,,,,
37,55,162,36,55,162,,,1,0,0,,,,,,
39,57,186,39,57,186,,,0,0,0,,,,,,
42,59,210,42,59,210,,,0,0,0,,,,,,
45,61,234,45,61,234,,,0,0,0,,,,,,
48,63,259,48,63,258,,,0,0,1,,,,,,
51,66,283,51,66,283,,,0,0,0,,,,,,
54,69,308,54,68,307,,,0,1,1,,,,,,
58,71,332,58,71,332,,,0,0,0,,,,,,
61,74,357,61,74,357,,,0,0,0,,,,,,
65,77,382,65,77,382,,,0,0,0,,,,,,
68,80,407,68,80,407,,,0,0,0,,,,,,
72,83,432,72,83,432,,,0,0,0,,,,,,
75,87,457,75,86,457,,,0,1,0,,,,,,
79,90,482,79,90,482,,,0,0,0,,,,,,
83,93,507,82,93,507,,,1,0,0,,,,,,
86,97,532,86,97,532,,,0,0,0,,,,,,
90,100,558,90,100,557,,,0,0,1,,,,,,
94,104,583,94,104,583,,,0,0,0,,,,,,
97,107,608,97,107,608,,,0,0,0,,,,,,
101,111,633,101,111,633,,,0,0,0,,,,,,
105,114,659,105,114,658,,,0,0,1,,,,,,
109,118,684,109,118,684,,,0,0,0,,,,,,
113,122,710,113,121,709,,,0,1,1,,,,,,
117,125,735,117,125,735,,,0,0,0,,,,,,
120,129,761,120,129,760,,,0,0,1,,,,,,
43,77,20,43,77,20,,,0,0,0,,,,,,
43,77,29,43,77,20,,,0,0,9,,,,,,
43,77,47,43,77,48,,,0,0,-1,,,,,,
44,77,69,44,77,69,,,0,0,0,,,,,,
44,78,92,45,78,91,,,-1,0,1,,,,,,
46,78,115,46,78,115,,,0,0,0,,,,,,
47,79,138,47,79,138,,,0,0,0,,,,,,
49,80,162,49,80,162,,,0,0,0,,,,,,
51,81,186,51,82,186,,,0,-1,0,,,,,,
53,82,210,53,83,210,,,0,-1,0,,,,,,
55,84,235,56,85,234,,,-1,-1,1,,,,,,
57,86,259,58,87,259,,,-1,-1,0,,,,,,
60,87,283,61,89,283,,,-1,-2,0,,,,,,
63,89,308,64,91,308,,,-1,-2,0,,,,,,
66,91,333,67,93,332,,,-1,-2,1,,,,,,
69,94,357,70,95,357,,,-1,-1,0,,,,,,
72,96,382,73,97,382,,,-1,-1,0,,,,,,
75,98,407,76,100,407,,,-1,-2,0,,,,,,
78,101,432,79,102,432,,,-1,-1,0,,,,,,
81,103,457,82,105,457,,,-1,-2,0,,,,,,
85,106,482,86,108,482,,,-1,-2,0,,,,,,
88,109,507,89,111,507,,,-1,-2,0,,,,,,
92,112,532,92,114,532,,,0,-2,0,,,,,,
95,115,558,96,117,557,,,-1,-2,1,,,,,,
99,118,583,99,120,583,,,0,-2,0,,,,,,
102,121,608,103,123,608,,,-1,-2,0,,,,,,
106,124,634,106,126,633,,,0,-2,1,,,,,,
109,127,659,110,129,659,,,-1,-2,0,,,,,,
113,131,684,114,132,684,,,-1,-1,0,,,,,,
117,134,710,117,135,710,,,0,-1,0,,,,,,
120,137,735,121,139,735,,,-1,-2,0,,,,,,
124,141,761,125,142,761,,,-1,-1,0,,,,,,
58,104,28,58,104,28,,,0,0,0,,,,,,
58,104,34,58,104,28,,,0,0,6,,,,,,
58,104,51,58,104,51,,,0,0,0,,,,,,
58,104,71,58,104,72,,,0,0,-1,,,,,,
59,104,93,59,104,93,,,0,0,0,,,,,,
60,105,116,60,104,116,,,0,1,0,,,,,,
61,105,139,61,105,139,,,0,0,0,,,,,,
62,106,163,62,106,163,,,0,0,0,,,,,,
64,107,187,64,107,187,,,0,0,0,,,,,,
65,108,211,65,108,211,,,0,0,0,,,,,,
67,109,235,67,109,235,,,0,0,0,,,,,,
69,110,259,69,110,259,,,0,0,0,,,,,,
71,112,284,71,112,284,,,0,0,0,,,,,,
73,113,308,73,113,308,,,0,0,0,,,,,,
76,115,333,76,115,333,,,0,0,0,,,,,,
78,116,358,78,116,358,,,0,0,0,,,,,,
81,118,383,81,118,383,,,0,0,0,,,,,,
84,120,407,84,120,407,,,0,0,0,,,,,,
87,122,432,87,122,432,,,0,0,0,,,,,,
90,124,457,90,124,457,,,0,0,0,,,,,,
93,126,482,93,126,482,,,0,0,0,,,,,,
96,129,508,96,128,507,,,0,1,1,,,,,,
99,131,533,99,131,533,,,0,0,0,,,,,,
102,134,558,102,133,558,,,0,1,0,,,,,,
105,136,583,105,136,583,,,0,0,0,,,,,,
109,139,608,108,139,608,,,1,0,0,,,,,,
112,142,634,112,142,634,,,0,0,0,,,,,,
115,144,659,115,144,659,,,0,0,0,,,,,,
119,147,685,119,147,685,,,0,0,0,,,,,,
122,150,710,122,150,710,,,0,0,0,,,,,,
126,153,736,126,153,736,,,0,0,0,,,,,,
129,156,761,129,156,761,,,0,0,0,,,,,,
73,131,35,73,131,35,,,0,0,0,,,,,,
73,131,40,73,131,35,,,0,0,5,,,,,,
73,131,55,73,131,55,,,0,0,0,,,,,,
73,131,74,73,131,75,,,0,0,-1,,,,,,
74,131,95,74,131,95,,,0,0,0,,,,,,
75,132,118,74,131,118,,,1,1,0,,,,,,
75,132,141,75,132,140,,,0,0,1,,,,,,
76,133,164,76,132,164,,,0,1,0,,,,,,
77,133,188,78,133,188,,,-1,0,0,,,,,,
79,134,212,79,134,212,,,0,0,0,,,,,,
80,135,236,80,135,236,,,0,0,0,,,,,,
82,136,260,82,136,260,,,0,0,0,,,,,,
84,137,285,84,137,284,,,0,0,1,,,,,,
86,138,309,86,138,309,,,0,0,0,,,,,,
88,140,334,88,140,333,,,0,0,1,,,,,,
90,141,358,90,141,358,,,0,0,0,,,,,,
92,142,383,92,143,383,,,0,-1,0,,,,,,
95,144,408,95,144,408,,,0,0,0,,,,,,
97,146,433,98,146,432,,,-1,0,1,,,,,,
100,147,458,100,148,457,,,0,-1,1,,,,,,
102,149,483,103,150,482,,,-1,-1,1,,,,,,
105,151,508,105,152,507,,,0,-1,1,,,,,,
108,153,533,108,154,533,,,0,-1,0,,,,,,
111,155,558,111,156,558,,,0,-1,0,,,,,,
114,157,583,114,158,583,,,0,-1,0,,,,,,
117,160,609,117,160,608,,,0,0,1,,,,,,
120,162,634,120,163,634,,,0,-1,0,,,,,,
123,164,659,123,165,659,,,0,-1,0,,,,,,
126,167,685,127,168,685,,,-1,-1,0,,,,,,
130,169,710,130,170,710,,,0,-1,0,,,,,,
133,172,736,133,173,736,,,0,-1,0,,,,,,
136,175,761,137,175,761,,,-1,0,0,,,,,,
88,158,42,88,158,42,,,0,0,0,,,,,,
88,158,46,88,158,42,,,0,0,4,,,,,,
88,158,59,88,158,59,,,0,0,0,,,,,,
89,159,77,88,158,78,,,1,1,-1,,,,,,
89,159,98,89,159,98,,,0,0,0,,,,,,
90,159,120,89,159,120,,,1,0,0,,,,,,
90,159,142,90,159,142,,,0,0,0,,,,,,
91,160,166,91,159,165,,,0,1,1,,,,,,
92,160,189,92,160,189,,,0,0,0,,,,,,
93,161,213,93,161,213,,,0,0,0,,,,,,
94,162,237,94,162,237,,,0,0,0,,,,,,
96,163,261,95,162,261,,,1,1,0,,,,,,
97,163,285,97,163,285,,,0,0,0,,,,,,
99,164,310,99,164,309,,,0,0,1,,,,,,
101,165,334,101,165,334,,,0,0,0,,,,,,
102,167,359,102,166,359,,,0,1,0,,,,,,
104,168,384,104,168,384,,,0,0,0,,,,,,
107,169,408,106,169,408,,,1,0,0,,,,,,
109,170,433,109,170,433,,,0,0,0,,,,,,
111,172,458,111,172,458,,,0,0,0,,,,,,
113,174,483,113,174,483,,,0,0,0,,,,,,
116,175,508,115,175,508,,,1,0,0,,,,,,
118,177,533,118,177,533,,,0,0,0,,,,,,
121,179,559,121,179,558,,,0,0,1,,,,,,
124,181,584,124,181,584,,,0,0,0,,,,,,
127,182,609,126,182,609,,,1,0,0,,,,,,
129,184,634,129,184,634,,,0,0,0,,,,,,
132,187,660,132,186,659,,,0,1,1,,,,,,
135,189,685,135,189,685,,,0,0,0,,,,,,
138,191,711,138,191,710,,,0,0,1,,,,,,
141,193,736,141,193,736,,,0,0,0,,,,,,
145,196,762,144,195,761,,,1,1,1,,,,,,
104,186,50,103,186,49,,,1,0,1,,,,,,
104,186,53,103,186,49,,,1,0,4,,,,,,
104,186,65,103,186,64,,,1,0,1,,,,,,
104,186,81,104,186,83,,,0,0,-2,,,,,,
104,186,101,104,186,101,,,0,0,0,,,,,,
105,187,122,105,186,123,,,0,1,-1,,,,,,
105,187,145,105,187,144,,,0,0,1,,,,,,
106,187,167,106,187,167,,,0,0,0,,,,,,
107,188,191,107,187,190,,,0,1,1,,,,,,
108,188,214,108,188,214,,,0,0,0,,,,,,
109,189,238,109,189,238,,,0,0,0,,,,,,
110,189,262,110,189,262,,,0,0,0,,,,,,
111,190,286,111,190,286,,,0,0,0,,,,,,
113,191,311,113,191,310,,,0,0,1,,,,,,
114,192,335,114,192,335,,,0,0,0,,,,,,
116,193,360,116,193,359,,,0,0,1,,,,,,
118,194,384,117,194,384,,,1,0,0,,,,,,
119,195,409,119,195,409,,,0,0,0,,,,,,
121,196,434,122,196,434,,,-1,0,0,,,,,,
123,198,459,123,198,458,,,0,0,1,,,,,,
125,199,484,125,199,483,,,0,0,1,,,,,,
128,200,509,127,200,508,,,1,0,1,,,,,,
130,202,534,130,202,533,,,0,0,1,,,,,,
132,203,559,132,203,559,,,0,0,0,,,,,,
135,205,584,135,205,584,,,0,0,0,,,,,,
137,207,609,137,207,609,,,0,0,0,,,,,,
140,208,635,140,208,634,,,0,0,1,,,,,,
143,210,660,142,210,660,,,1,0,0,,,,,,
145,212,686,145,213,685,,,0,-1,1,,,,,,
148,214,711,148,214,711,,,0,0,0,,,,,,
151,216,736,151,216,736,,,0,0,0,,,,,,
154,218,762,154,218,762,,,0,0,0,,,,,,
119,214,57,119,214,57,,,0,0,0,,,,,,
119,214,60,119,214,57,,,0,0,3,,,,,,
119,214,70,119,214,70,,,0,0,0,,,,,,
119,214,86,119,214,87,,,0,0,-1,,,,,,
120,214,105,120,214,105,,,0,0,0,,,,,,
120,214,125,120,214,126,,,0,0,-1,,,,,,
121,215,147,121,215,147,,,0,0,0,,,,,,
121,215,169,121,215,169,,,0,0,0,,,,,,
122,215,192,122,215,192,,,0,0,0,,,,,,
123,216,216,123,215,215,,,0,1,1,,,,,,
124,216,239,124,216,239,,,0,0,0,,,,,,
125,217,263,125,216,263,,,0,1,0,,,,,,
126,217,287,126,217,287,,,0,0,0,,,,,,
127,218,312,127,218,311,,,0,0,1,,,,,,
128,219,336,128,219,336,,,0,0,0,,,,,,
130,220,361,129,220,360,,,1,0,1,,,,,,
131,221,385,131,221,385,,,0,0,0,,,,,,
133,222,410,133,222,410,,,0,0,0,,,,,,
135,223,435,135,223,435,,,0,0,0,,,,,,
136,224,459,136,224,459,,,0,0,0,,,,,,
138,225,484,138,225,484,,,0,0,0,,,,,,
140,226,509,140,226,509,,,0,0,0,,,,,,
142,227,534,142,227,534,,,0,0,0,,,,,,
145,229,560,144,228,559,,,1,1,1,,,,,,
147,230,585,147,230,585,,,0,0,0,,,,,,
149,232,610,149,231,610,,,0,1,0,,,,,,
151,233,635,151,233,635,,,0,0,0,,,,,,
154,235,661,153,235,660,,,1,0,1,,,,,,
156,237,686,156,237,686,,,0,0,0,,,,,,
159,238,711,159,238,711,,,0,0,0,,,,,,
162,240,737,162,240,737,,,0,0,0,,,,,,
164,242,762,164,242,762,,,0,0,0,,,,,,
135,242,65,134,242,64,,,1,0,1,,,,,,
135,242,67,134,242,64,,,1,0,3,,,,,,
135,242,76,134,242,76,,,1,0,0,,,,,,
135,242,91,135,242,92,,,0,0,-1,,,,,,
135,242,109,135,242,109,,,0,0,0,,,,,,
136,242,129,135,242,129,,,1,0,0,,,,,,
136,242,150,136,242,150,,,0,0,0,,,,,,
136,243,172,136,242,172,,,0,1,0,,,,,,
137,243,194,137,243,194,,,0,0,0,,,,,,
138,243,218,138,243,217,,,0,0,1,,,,,,
139,244,241,139,244,241,,,0,0,0,,,,,,
139,244,265,139,244,264,,,0,0,1,,,,,,
140,245,289,140,245,288,,,0,0,1,,,,,,
142,246,313,141,245,312,,,1,1,1,,,,,,
143,246,337,143,246,337,,,0,0,0,,,,,,
144,247,362,144,247,361,,,0,0,1,,,,,,
145,248,386,145,248,386,,,0,0,0,,,,,,
147,249,411,147,249,410,,,0,0,1,,,,,,
148,250,435,149,250,435,,,-1,0,0,,,,,,
150,251,460,150,251,460,,,0,0,0,,,,,,
152,252,485,152,252,485,,,0,0,0,,,,,,
154,253,510,153,253,510,,,1,0,0,,,,,,
155,254,535,155,254,535,,,0,0,0,,,,,,
157,255,560,157,255,560,,,0,0,0,,,,,,
159,256,585,160,256,585,,,-1,0,0,,,,,,
162,258,611,162,257,610,,,0,1,1,,,,,,
164,259,636,164,259,635,,,0,0,1,,,,,,
166,260,661,166,260,661,,,0,0,0,,,,,,
168,262,686,168,262,686,,,0,0,0,,,,,,
171,263,712,171,264,712,,,0,-1,0,,,,,,
173,265,737,173,265,737,,,0,0,0,,,,,,
176,267,763,176,267,763,,,0,0,0,,,,,,
150,270,72,150,270,72,,,0,0,0,,,,,,
150,270,74,150,270,72,,,0,0,2,,,,,,
150,270,83,150,270,83,,,0,0,0,,,,,,
151,270,96,150,270,98,,,1,0,-2,,,,,,
151,270,113,151,270,113,,,0,0,0,,,,,,
151,270,132,151,270,133,,,0,0,-1,,,,,,
151,270,153,151,270,153,,,0,0,0,,,,,,
152,271,174,151,270,175,,,1,1,-1,,,,,,
152,271,197,152,271,197,,,0,0,0,,,,,,
153,271,220,153,271,220,,,0,0,0,,,,,,
154,272,243,154,272,243,,,0,0,0,,,,,,
155,272,266,154,272,266,,,1,0,0,,,,,,
155,273,290,155,273,290,,,0,0,0,,,,,,
156,273,314,156,273,314,,,0,0,0,,,,,,
158,274,338,158,274,338,,,0,0,0,,,,,,
159,275,363,159,274,362,,,0,1,1,,,,,,
160,275,387,160,275,387,,,0,0,0,,,,,,
161,276,412,161,276,411,,,0,0,1,,,,,,
163,277,436,163,277,436,,,0,0,0,,,,,,
164,278,461,164,278,461,,,0,0,0,,,,,,
166,279,486,166,279,486,,,0,0,0,,,,,,
167,280,511,167,280,511,,,0,0,0,,,,,,
169,281,536,169,281,536,,,0,0,0,,,,,,
171,282,561,171,282,561,,,0,0,0,,,,,,
173,283,586,173,283,586,,,0,0,0,,,,,,
175,284,611,175,284,611,,,0,0,0,,,,,,
177,285,636,177,285,636,,,0,0,0,,,,,,
179,286,662,179,286,661,,,0,0,1,,,,,,
181,288,687,181,288,687,,,0,0,0,,,,,,
183,289,712,183,289,712,,,0,0,0,,,,,,
185,291,738,185,291,738,,,0,0,0,,,,,,
188,292,763,187,292,763,,,1,0,0,,,,,,
166,298,80,166,298,79,,,0,0,1,,,,,,
166,298,82,166,298,79,,,0,0,3,,,,,,
166,298,89,166,298,89,,,0,0,0,,,,,,
166,298,102,166,298,103,,,0,0,-1,,,,,,
166,298,118,166,298,118,,,0,0,0,,,,,,
167,298,136,166,298,137,,,1,0,-1,,,,,,
167,299,156,167,298,156,,,0,1,0,,,,,,
167,299,177,167,298,178,,,0,1,-1,,,,,,
168,299,199,168,299,199,,,0,0,0,,,,,,
169,299,222,168,299,222,,,1,0,0,,,,,,
169,300,245,169,300,245,,,0,0,0,,,,,,
170,300,268,170,300,268,,,0,0,0,,,,,,
171,301,292,170,301,292,,,1,0,0,,,,,,
172,301,316,171,301,315,,,1,0,1,,,,,,
173,302,340,173,302,339,,,0,0,1,,,,,,
174,302,364,174,302,364,,,0,0,0,,,,,,
175,303,388,175,303,388,,,0,0,0,,,,,,
176,304,413,176,303,413,,,0,1,0,,,,,,
177,304,437,177,304,437,,,0,0,0,,,,,,
178,305,462,178,305,462,,,0,0,0,,,,,,
180,306,487,180,306,487,,,0,0,0,,,,,,
181,307,512,181,307,512,,,0,0,0,,,,,,
183,308,537,183,308,537,,,0,0,0,,,,,,
185,309,562,184,309,562,,,1,0,0,,,,,,
186,310,587,186,310,587,,,0,0,0,,,,,,
188,311,612,188,311,612,,,0,0,0,,,,,,
190,312,637,190,312,637,,,0,0,0,,,,,,
192,313,662,192,313,662,,,0,0,0,,,,,,
194,314,688,194,314,687,,,0,0,1,,,,,,
196,316,713,196,315,713,,,0,1,0,,,,,,
198,317,738,198,317,738,,,0,0,0,,,,,,
200,318,764,200,318,764,,,0,0,0,,,,,,
182,326,87,182,326,87,,,0,0,0,,,,,,
182,326,89,182,326,87,,,0,0,2,,,,,,
182,326,96,182,326,96,,,0,0,0,,,,,,
182,327,108,182,326,109,,,0,1,-1,,,,,,
182,327,123,182,327,123,,,0,0,0,,,,,,
182,327,140,182,327,141,,,0,0,-1,,,,,,
183,327,160,183,327,160,,,0,0,0,,,,,,
183,327,181,183,327,181,,,0,0,0,,,,,,
184,327,202,184,327,202,,,0,0,0,,,,,,
184,328,224,184,327,224,,,0,1,0,,,,,,
185,328,247,185,328,247,,,0,0,0,,,,,,
185,328,270,185,328,270,,,0,0,0,,,,,,
186,329,294,186,329,294,,,0,0,0,,,,,,
187,329,318,187,329,317,,,0,0,1,,,,,,
188,330,341,188,330,341,,,0,0,0,,,,,,
189,330,366,189,330,365,,,0,0,1,,,,,,
190,331,390,190,331,390,,,0,0,0,,,,,,
191,331,414,191,331,414,,,0,0,0,,,,,,
192,332,439,192,332,439,,,0,0,0,,,,,,
193,333,463,193,332,463,,,0,1,0,,,,,,
194,333,488,194,333,488,,,0,0,0,,,,,,
196,334,513,195,334,513,,,1,0,0,,,,,,
197,335,538,197,335,538,,,0,0,0,,,,,,
199,336,563,198,336,563,,,1,0,0,,,,,,
200,337,588,200,337,588,,,0,0,0,,,,,,
202,338,613,202,338,613,,,0,0,0,,,,,,
204,339,638,204,339,638,,,0,0,0,,,,,,
205,340,663,205,340,663,,,0,0,0,,,,,,
207,341,688,207,341,688,,,0,0,0,,,,,,
209,342,714,209,342,713,,,0,0,1,,,,,,
211,343,739,211,343,739,,,0,0,0,,,,,,
213,345,764,213,344,764,,,0,1,0,,,,,,
198,355,95,198,354,94,,,0,1,1,,,,,,
198,355,97,198,354,94,,,0,1,3,,,,,,
198,355,103,198,354,103,,,0,1,0,,,,,,
198,355,114,198,355,115,,,0,0,-1,,,,,,
198,355,128,198,355,128,,,0,0,0,,,,,,
198,355,145,198,355,146,,,0,0,-1,,,,,,
198,355,164,198,355,164,,,0,0,0,,,,,,
199,355,184,199,355,184,,,0,0,0,,,,,,
199,356,205,199,355,205,,,0,1,0,,,,,,
200,356,227,200,356,227,,,0,0,0,,,,,,
200,356,250,200,356,249,,,0,0,1,,,,,,
201,357,273,201,356,272,,,0,1,1,,,,,,
201,357,296,201,357,296,,,0,0,0,,,,,,
202,357,319,202,357,319,,,0,0,0,,,,,,
203,358,343,203,358,343,,,0,0,0,,,,,,
204,358,367,204,358,367,,,0,0,0,,,,,,
205,359,391,205,359,391,,,0,0,0,,,,,,
206,359,416,206,359,415,,,0,0,1,,,,,,
207,360,440,207,360,440,,,0,0,0,,,,,,
208,361,465,208,360,464,,,0,1,1,,,,,,
209,361,489,209,361,489,,,0,0,0,,,,,,
210,362,514,210,362,514,,,0,0,0,,,,,,
212,363,539,212,363,539,,,0,0,0,,,,,,
213,364,564,213,363,564,,,0,1,0,,,,,,
215,364,589,214,364,589,,,1,0,0,,,,,,
216,365,614,216,365,614,,,0,0,0,,,,,,
218,366,639,218,366,639,,,0,0,0,,,,,,
219,367,664,219,367,664,,,0,0,0,,,,,,
221,368,689,221,368,689,,,0,0,0,,,,,,
223,369,714,223,369,714,,,0,0,0,,,,,,
225,370,740,225,370,740,,,0,0,0,,,,,,
227,372,765,226,371,765,,,1,1,0,,,,,,
214,383,102,214,383,102,,,0,0,0,,,,,,
214,383,104,214,383,102,,,0,0,2,,,,,,
214,383,110,214,383,110,,,0,0,0,,,,,,
214,383,120,214,383,122,,,0,0,-2,,,,,,
214,384,134,214,384,134,,,0,0,0,,,,,,
214,384,150,214,384,151,,,0,0,-1,,,,,,
214,384,168,214,384,168,,,0,0,0,,,,,,
215,384,188,214,384,188,,,1,0,0,,,,,,
215,384,209,215,384,209,,,0,0,0,,,,,,
215,384,230,215,384,230,,,0,0,0,,,,,,
216,385,252,216,385,252,,,0,0,0,,,,,,
216,385,275,216,385,275,,,0,0,0,,,,,,
217,385,298,217,385,298,,,0,0,0,,,,,,
218,386,321,217,385,321,,,1,1,0,,,,,,
218,386,345,218,386,345,,,0,0,0,,,,,,
219,387,369,219,386,369,,,0,1,0,,,,,,
220,387,393,220,387,393,,,0,0,0,,,,,,
221,388,417,221,387,417,,,0,1,0,,,,,,
222,388,441,222,388,441,,,0,0,0,,,,,,
223,389,466,223,388,465,,,0,1,1,,,,,,
224,389,490,224,389,490,,,0,0,0,,,,,,
225,390,515,225,390,515,,,0,0,0,,,,,,
227,391,540,227,391,540,,,0,0,0,,,,,,
228,391,565,228,391,565,,,0,0,0,,,,,,
229,392,590,229,392,590,,,0,0,0,,,,,,
231,393,615,230,393,615,,,1,0,0,,,,,,
232,394,640,232,394,640,,,0,0,0,,,,,,
234,395,665,233,395,665,,,1,0,0,,,,,,
235,396,690,235,396,690,,,0,0,0,,,,,,
237,397,715,237,397,715,,,0,0,0,,,,,,
239,398,741,239,398,741,,,0,0,0,,,,,,
240,399,766,240,399,766,,,0,0,0,,,,,,
229,412,110,229,412,110,,,0,0,0,,,,,,
229,412,112,229,412,110,,,0,0,2,,,,,,
230,412,117,230,412,117,,,0,0,0,,,,,,
230,412,127,230,412,128,,,0,0,-1,,,,,,
230,412,139,230,412,139,,,0,0,0,,,,,,
230,412,155,230,412,156,,,0,0,-1,,,,,,
230,412,173,230,412,172,,,0,0,1,,,,,,
230,412,192,230,412,192,,,0,0,0,,,,,,
231,413,212,231,412,212,,,0,1,0,,,,,,
231,413,233,231,413,233,,,0,0,0,,,,,,
232,413,255,231,413,255,,,1,0,0,,,,,,
232,413,278,232,413,277,,,0,0,1,,,,,,
233,414,300,232,413,300,,,1,1,0,,,,,,
233,414,324,233,414,323,,,0,0,1,,,,,,
234,414,347,234,414,347,,,0,0,0,,,,,,
235,415,371,234,415,371,,,1,0,0,,,,,,
236,415,395,235,415,395,,,1,0,0,,,,,,
236,416,419,236,416,419,,,0,0,0,,,,,,
237,416,443,237,416,443,,,0,0,0,,,,,,
238,417,467,238,417,467,,,0,0,0,,,,,,
239,417,492,239,417,491,,,0,0,1,,,,,,
240,418,516,240,418,516,,,0,0,0,,,,,,
242,419,541,242,419,541,,,0,0,0,,,,,,
243,419,566,243,419,566,,,0,0,0,,,,,,
244,420,591,244,420,591,,,0,0,0,,,,,,
245,421,616,245,421,616,,,0,0,0,,,,,,
247,422,641,247,422,641,,,0,0,0,,,,,,
248,423,666,248,422,666,,,0,1,0,,,,,,
250,423,691,249,423,691,,,1,0,0,,,,,,
251,424,716,251,424,716,,,0,0,0,,,,,,
253,425,741,253,425,741,,,0,0,0,,,,,,
254,426,767,254,426,766,,,0,0,1,,,,,,
245,441,118,245,441,118,,,0,0,0,,,,,,
245,441,119,245,441,118,,,0,0,1,,,,,,
246,441,124,246,441,124,,,0,0,0,,,,,,
246,441,133,246,441,134,,,0,0,-1,,,,,,
246,441,145,246,441,145,,,0,0,0,,,,,,
246,441,160,246,441,161,,,0,0,-1,,,,,,
246,441,177,246,441,177,,,0,0,0,,,,,,
246,441,196,246,441,196,,,0,0,0,,,,,,
247,441,216,247,441,216,,,0,0,0,,,,,,
247,441,237,247,441,237,,,0,0,0,,,,,,
247,442,258,247,442,258,,,0,0,0,,,,,,
248,442,280,247,442,280,,,1,0,0,,,,,,
248,442,303,248,442,303,,,0,0,0,,,,,,
249,443,326,249,442,326,,,0,1,0,,,,,,
250,443,349,250,443,349,,,0,0,0,,,,,,
250,443,373,250,443,373,,,0,0,0,,,,,,
251,444,397,251,444,397,,,0,0,0,,,,,,
252,444,421,252,444,421,,,0,0,0,,,,,,
253,445,445,253,445,445,,,0,0,0,,,,,,
254,445,469,254,445,469,,,0,0,0,,,,,,
255,446,493,255,446,493,,,0,0,0,,,,,,
256,446,518,256,446,517,,,0,0,1,,,,,,
257,447,542,257,447,542,,,0,0,0,,,,,,
258,448,567,258,447,567,,,0,1,0,,,,,,
259,448,592,259,448,592,,,0,0,0,,,,,,
260,449,617,260,449,617,,,0,0,0,,,,,,
262,450,642,262,450,642,,,0,0,0,,,,,,
263,450,667,263,450,667,,,0,0,0,,,,,,
264,451,692,264,451,692,,,0,0,0,,,,,,
266,452,717,265,452,717,,,1,0,0,,,,,,
267,453,742,267,453,742,,,0,0,0,,,,,,
269,454,768,268,454,767,,,1,0,1,,,,,,
261,469,125,261,469,125,,,0,0,0,,,,,,
261,469,127,261,469,125,,,0,0,2,,,,,,
262,469,131,262,469,131,,,0,0,0,,,,,,
262,469,140,262,469,141,,,0,0,-1,,,,,,
262,469,152,262,469,151,,,0,0,1,,,,,,
262,470,166,262,469,167,,,0,1,-1,,,,,,
262,470,182,262,469,182,,,0,1,0,,,,,,
262,470,201,262,469,201,,,0,1,0,,,,,,
263,470,220,263,470,220,,,0,0,0,,,,,,
263,470,240,263,470,240,,,0,0,0,,,,,,
263,470,262,263,470,261,,,0,0,1,,,,,,
264,471,284,263,470,283,,,1,1,1,,,,,,
264,471,306,264,471,306,,,0,0,0,,,,,,
265,471,329,264,471,328,,,1,0,1,,,,,,
265,472,352,265,471,351,,,0,1,1,,,,,,
266,472,375,266,472,375,,,0,0,0,,,,,,
267,472,399,266,472,399,,,1,0,0,,,,,,
267,473,422,267,473,422,,,0,0,0,,,,,,
268,473,446,268,473,446,,,0,0,0,,,,,,
269,474,471,269,474,470,,,0,0,1,,,,,,
270,474,495,270,474,495,,,0,0,0,,,,,,
271,475,519,271,475,519,,,0,0,0,,,,,,
272,475,544,272,475,543,,,0,0,1,,,,,,
273,476,569,273,476,568,,,0,0,1,,,,,,
274,476,593,274,476,593,,,0,0,0,,,,,,
275,477,618,275,477,618,,,0,0,0,,,,,,
277,478,643,277,478,643,,,0,0,0,,,,,,
278,479,668,278,478,668,,,0,1,0,,,,,,
279,479,693,279,479,693,,,0,0,0,,,,,,
280,480,718,280,480,718,,,0,0,0,,,,,,
282,481,743,282,481,743,,,0,0,0,,,,,,
283,482,769,283,482,768,,,0,0,1,,,,,,
278,498,133,278,498,133,,,0,0,0,,,,,,
278,498,134,278,498,133,,,0,0,1,,,,,,
278,498,139,278,498,139,,,0,0,0,,,,,,
278,498,147,278,498,148,,,0,0,-1,,,,,,
278,498,158,278,498,158,,,0,0,0,,,,,,
278,498,172,278,498,173,,,0,0,-1,,,,,,
278,498,188,278,498,188,,,0,0,0,,,,,,
278,499,205,278,498,206,,,0,1,-1,,,,,,
279,499,224,279,499,224,,,0,0,0,,,,,,
279,499,244,279,499,244,,,0,0,0,,,,,,
279,499,265,279,499,265,,,0,0,0,,,,,,
280,499,287,279,499,287,,,1,0,0,,,,,,
280,500,309,280,500,309,,,0,0,0,,,,,,
281,500,331,280,500,331,,,1,0,0,,,,,,
281,500,354,281,500,354,,,0,0,0,,,,,,
282,501,377,281,500,377,,,1,1,0,,,,,,
282,501,401,282,501,401,,,0,0,0,,,,,,
283,501,425,283,501,424,,,0,0,1,,,,,,
284,502,448,284,502,448,,,0,0,0,,,,,,
285,502,472,285,502,472,,,0,0,0,,,,,,
286,503,497,286,503,497,,,0,0,0,,,,,,
286,503,521,286,503,521,,,0,0,0,,,,,,
287,504,545,287,504,545,,,0,0,0,,,,,,
288,504,570,288,504,570,,,0,0,0,,,,,,
289,505,595,289,505,595,,,0,0,0,,,,,,
291,505,620,290,505,619,,,1,0,1,,,,,,
292,506,644,292,506,644,,,0,0,0,,,,,,
293,507,669,293,506,669,,,0,1,0,,,,,,
294,507,694,294,507,694,,,0,0,0,,,,,,
295,508,719,295,508,719,,,0,0,0,,,,,,
297,509,745,297,509,745,,,0,0,0,,,,,,
298,510,770,298,510,770,,,0,0,0,,,,,,
294,527,141,294,527,141,,,0,0,0,,,,,,
294,527,142,294,527,141,,,0,0,1,,,,,,
294,527,146,294,527,146,,,0,0,0,,,,,,
294,527,154,294,527,155,,,0,0,-1,,,,,,
294,527,164,294,527,164,,,0,0,0,,,,,,
294,527,178,294,527,178,,,0,0,0,,,,,,
294,527,193,294,527,193,,,0,0,0,,,,,,
294,527,210,294,527,210,,,0,0,0,,,,,,
295,528,229,295,527,228,,,0,1,1,,,,,,
295,528,248,295,527,248,,,0,1,0,,,,,,
295,528,269,295,528,269,,,0,0,0,,,,,,
296,528,290,295,528,290,,,1,0,0,,,,,,
296,528,312,296,528,312,,,0,0,0,,,,,,
297,529,334,296,528,334,,,1,1,0,,,,,,
297,529,357,297,529,357,,,0,0,0,,,,,,
298,529,380,297,529,380,,,1,0,0,,,,,,
298,530,403,298,529,403,,,0,1,0,,,,,,
299,530,427,298,530,427,,,1,0,0,,,,,,
300,530,450,299,530,450,,,1,0,0,,,,,,
300,531,474,300,531,474,,,0,0,0,,,,,,
301,531,498,301,531,498,,,0,0,0,,,,,,
302,532,523,302,532,522,,,0,0,1,,,,,,
303,532,547,302,532,547,,,1,0,0,,,,,,
304,533,572,303,533,571,,,1,0,1,,,,,,
305,533,596,304,533,596,,,1,0,0,,,,,,
306,534,621,305,534,621,,,1,0,0,,,,,,
307,534,646,307,534,645,,,0,0,1,,,,,,
308,535,671,308,535,670,,,0,0,1,,,,,,
309,536,696,309,535,695,,,0,1,1,,,,,,
310,536,721,310,536,720,,,0,0,1,,,,,,
312,537,746,312,537,746,,,0,0,0,,,,,,
313,538,771,313,538,771,,,0,0,0,,,,,,
310,556,149,310,556,149,,,0,0,0,,,,,,
310,556,150,310,556,149,,,0,0,1,,,,,,
310,556,154,310,556,154,,,0,0,0,,,,,,
310,556,161,310,556,162,,,0,0,-1,,,,,,
310,556,171,310,556,171,,,0,0,0,,,,,,
310,556,184,310,556,184,,,0,0,0,,,,,,
310,556,198,310,556,198,,,0,0,0,,,,,,
310,556,215,310,556,215,,,0,0,0,,,,,,
311,556,233,311,556,233,,,0,0,0,,,,,,
311,557,252,311,556,253,,,0,1,-1,,,,,,
311,557,273,311,557,273,,,0,0,0,,,,,,
312,557,294,311,557,294,,,1,0,0,,,,,,
312,557,315,312,557,315,,,0,0,0,,,,,,
312,557,337,312,557,337,,,0,0,0,,,,,,
313,558,360,313,558,360,,,0,0,0,,,,,,
314,558,382,313,558,383,,,1,0,-1,,,,,,
314,558,406,314,558,406,,,0,0,0,,,,,,
315,559,429,314,558,429,,,1,1,0,,,,,,
315,559,453,315,559,453,,,0,0,0,,,,,,
316,559,476,316,559,476,,,0,0,0,,,,,,
317,560,500,317,560,500,,,0,0,0,,,,,,
318,560,525,317,560,524,,,1,0,1,,,,,,
318,561,549,318,561,549,,,0,0,0,,,,,,
319,561,573,319,561,573,,,0,0,0,,,,,,
320,562,598,320,562,598,,,0,0,0,,,,,,
321,562,622,321,562,622,,,0,0,0,,,,,,
322,563,647,322,563,647,,,0,0,0,,,,,,
323,564,672,323,563,672,,,0,1,0,,,,,,
324,564,697,324,564,697,,,0,0,0,,,,,,
326,565,722,325,565,722,,,1,0,0,,,,,,
327,566,747,327,566,747,,,0,0,0,,,,,,
328,566,772,328,566,772,,,0,0,0,,,,,,
326,585,156,326,585,156,,,0,0,0,,,,,,
326,585,157,326,585,156,,,0,0,1,,,,,,
326,585,161,326,585,161,,,0,0,0,,,,,,
326,585,168,326,585,169,,,0,0,-1,,,,,,
326,585,178,326,585,177,,,0,0,1,,,,,,
326,585,190,326,585,190,,,0,0,0,,,,,,
326,585,204,326,585,204,,,0,0,0,,,,,,
327,585,220,326,585,221,,,1,0,-1,,,,,,
327,585,238,327,585,238,,,0,0,0,,,,,,
327,586,257,327,585,257,,,0,1,0,,,,,,
327,586,277,327,586,277,,,0,0,0,,,,,,
328,586,297,327,586,297,,,1,0,0,,,,,,
328,586,319,328,586,318,,,0,0,1,,,,,,
328,586,340,328,586,340,,,0,0,0,,,,,,
329,587,363,329,587,363,,,0,0,0,,,,,,
329,587,385,329,587,385,,,0,0,0,,,,,,
330,587,408,330,587,408,,,0,0,0,,,,,,
331,588,431,330,587,431,,,1,1,0,,,,,,
331,588,455,331,588,455,,,0,0,0,,,,,,
332,588,479,331,588,478,,,1,0,1,,,,,,
333,589,502,332,589,502,,,1,0,0,,,,,,
333,589,527,333,589,526,,,0,0,1,,,,,,
334,590,551,334,589,551,,,0,1,0,,,,,,
335,590,575,335,590,575,,,0,0,0,,,,,,
336,591,600,336,590,599,,,0,1,1,,,,,,
337,591,624,336,591,624,,,1,0,0,,,,,,
338,592,649,337,591,648,,,1,1,1,,,,,,
339,592,673,338,592,673,,,1,0,0,,,,,,
340,593,698,339,592,698,,,1,1,0,,,,,,
341,593,723,340,593,723,,,1,0,0,,,,,,
342,594,748,342,594,748,,,0,0,0,,,,,,
343,595,773,343,595,773,,,0,0,0,,,,,,
342,614,164,342,614,164,,,0,0,0,,,,,,
342,614,165,342,614,164,,,0,0,1,,,,,,
342,614,169,342,614,169,,,0,0,0,,,,,,
342,614,175,342,614,176,,,0,0,-1,,,,,,
342,614,184,342,614,184,,,0,0,0,,,,,,
342,614,196,342,614,197,,,0,0,-1,,,,,,
343,614,210,343,614,210,,,0,0,0,,,,,,
343,614,226,343,614,226,,,0,0,0,,,,,,
343,614,243,343,614,243,,,0,0,0,,,,,,
343,615,261,343,614,262,,,0,1,-1,,,,,,
343,615,281,343,615,281,,,0,0,0,,,,,,
344,615,301,343,615,301,,,1,0,0,,,,,,
344,615,322,344,615,322,,,0,0,0,,,,,,
345,615,344,344,615,344,,,1,0,0,,,,,,
345,616,366,345,616,366,,,0,0,0,,,,,,
345,616,388,345,616,388,,,0,0,0,,,,,,
346,616,411,346,616,411,,,0,0,0,,,,,,
347,616,434,346,616,434,,,1,0,0,,,,,,
347,617,457,347,617,457,,,0,0,0,,,,,,
348,617,481,347,617,481,,,1,0,0,,,,,,
348,618,505,348,618,505,,,0,0,0,,,,,,
349,618,529,349,618,529,,,0,0,0,,,,,,
350,618,553,350,618,553,,,0,0,0,,,,,,
351,619,577,351,618,577,,,0,1,0,,,,,,
352,619,601,352,619,601,,,0,0,0,,,,,,
352,620,626,352,619,625,,,0,1,1,,,,,,
353,620,650,353,620,650,,,0,0,0,,,,,,
354,621,675,354,620,675,,,0,1,0,,,,,,
355,621,700,355,621,700,,,0,0,0,,,,,,
356,622,725,356,622,725,,,0,0,0,,,,,,
357,623,750,357,623,750,,,0,0,0,,,,,,
359,623,775,358,623,775,,,1,0,0,,,,,,
358,643,172,358,643,172,,,0,0,0,,,,,,
358,643,173,358,643,172,,,0,0,1,,,,,,
358,643,176,358,643,176,,,0,0,0,,,,,,
358,643,182,358,643,183,,,0,0,-1,,,,,,
358,643,191,358,643,191,,,0,0,0,,,,,,
359,643,202,358,643,203,,,1,0,-1,,,,,,
359,643,216,359,643,216,,,0,0,0,,,,,,
359,643,231,359,643,232,,,0,0,-1,,,,,,
359,644,248,359,643,248,,,0,1,0,,,,,,
359,644,266,359,643,266,,,0,1,0,,,,,,
360,644,285,359,644,285,,,1,0,0,,,,,,
360,644,305,359,644,305,,,1,0,0,,,,,,
360,644,326,360,644,326,,,0,0,0,,,,,,
361,644,347,360,644,347,,,1,0,0,,,,,,
361,645,369,361,645,369,,,0,0,0,,,,,,
362,645,391,361,645,391,,,1,0,0,,,,,,
362,645,414,362,645,414,,,0,0,0,,,,,,
363,645,437,362,645,437,,,1,0,0,,,,,,
363,646,460,363,646,460,,,0,0,0,,,,,,
364,646,483,363,646,483,,,1,0,0,,,,,,
364,646,507,364,646,507,,,0,0,0,,,,,,
365,647,531,365,646,531,,,0,1,0,,,,,,
366,647,555,366,647,555,,,0,0,0,,,,,,
367,648,579,366,647,579,,,1,1,0,,,,,,
367,648,603,367,648,603,,,0,0,0,,,,,,
368,649,628,368,648,627,,,0,1,1,,,,,,
369,649,652,369,649,652,,,0,0,0,,,,,,
370,650,677,370,649,676,,,0,1,1,,,,,,
371,650,701,371,650,701,,,0,0,0,,,,,,
372,651,726,371,650,726,,,1,1,0,,,,,,
373,651,751,372,651,751,,,1,0,0,,,,,,
374,652,776,374,652,776,,,0,0,0,,,,,,
375,672,180,375,672,180,,,0,0,0,,,,,,
375,672,180,375,672,180,,,0,0,0,,,,,,
375,672,184,375,672,184,,,0,0,0,,,,,,
375,672,190,375,672,191,,,0,0,-1,,,,,,
375,672,198,375,672,198,,,0,0,0,,,,,,
375,672,209,375,672,210,,,0,0,-1,,,,,,
375,672,222,375,672,222,,,0,0,0,,,,,,
375,673,237,375,672,237,,,0,1,0,,,,,,
375,673,253,375,673,253,,,0,0,0,,,,,,
376,673,271,375,673,271,,,1,0,0,,,,,,
376,673,290,376,673,290,,,0,0,0,,,,,,
376,673,309,376,673,310,,,0,0,-1,,,,,,
376,673,330,376,673,330,,,0,0,0,,,,,,
377,674,351,376,673,351,,,1,1,0,,,,,,
377,674,372,377,674,372,,,0,0,0,,,,,,
378,674,394,377,674,394,,,1,0,0,,,,,,
378,674,417,378,674,417,,,0,0,0,,,,,,
379,675,440,378,674,440,,,1,1,0,,,,,,
379,675,463,379,675,463,,,0,0,0,,,,,,
380,675,486,379,675,486,,,1,0,0,,,,,,
380,675,509,380,675,509,,,0,0,0,,,,,,
381,676,533,381,675,533,,,0,1,0,,,,,,
382,676,557,382,676,557,,,0,0,0,,,,,,
382,677,581,382,676,581,,,0,1,0,,,,,,
383,677,605,383,677,605,,,0,0,0,,,,,,
384,677,629,384,677,629,,,0,0,0,,,,,,
385,678,654,385,678,654,,,0,0,0,,,,,,
386,678,678,386,678,678,,,0,0,0,,,,,,
387,679,703,387,679,703,,,0,0,0,,,,,,
388,680,728,387,679,728,,,1,1,0,,,,,,
388,680,753,388,680,753,,,0,0,0,,,,,,
390,681,778,389,680,778,,,1,1,0,,,,,,
391,701,187,391,701,187,,,0,0,0,,,,,,
391,701,188,391,701,187,,,0,0,1,,,,,,
391,701,191,391,701,191,,,0,0,0,,,,,,
391,702,197,391,701,198,,,0,1,-1,,,,,,
391,702,205,391,701,205,,,0,1,0,,,,,,
391,702,216,391,701,216,,,0,1,0,,,,,,
391,702,228,391,701,228,,,0,1,0,,,,,,
391,702,243,391,701,243,,,0,1,0,,,,,,
392,702,259,391,702,258,,,1,0,1,,,,,,
392,702,276,391,702,276,,,1,0,0,,,,,,
392,702,294,392,702,294,,,0,0,0,,,,,,
392,702,314,392,702,314,,,0,0,0,,,,,,
393,702,334,392,702,334,,,1,0,0,,,,,,
393,703,355,392,702,355,,,1,1,0,,,,,,
393,703,376,393,703,376,,,0,0,0,,,,,,
394,703,398,393,703,398,,,1,0,0,,,,,,
394,703,420,394,703,420,,,0,0,0,,,,,,
395,704,442,394,703,442,,,1,1,0,,,,,,
395,704,465,395,704,465,,,0,0,0,,,,,,
396,704,488,395,704,488,,,1,0,0,,,,,,
396,705,512,396,704,511,,,0,1,1,,,,,,
397,705,535,397,704,535,,,0,1,0,,,,,,
398,705,559,398,705,559,,,0,0,0,,,,,,
398,706,583,398,705,583,,,0,1,0,,,,,,
399,706,607,399,706,607,,,0,0,0,,,,,,
400,706,631,399,706,631,,,1,0,0,,,,,,
401,707,656,400,707,656,,,1,0,0,,,,,,
401,707,680,401,707,680,,,0,0,0,,,,,,
402,708,705,402,708,705,,,0,0,0,,,,,,
403,708,730,403,708,729,,,0,0,1,,,,,,
404,709,754,404,709,754,,,0,0,0,,,,,,
405,709,779,405,709,779,,,0,0,0,,,,,,
407,731,195,407,731,195,,,0,0,0,,,,,,
407,731,196,407,731,195,,,0,0,1,,,,,,
407,731,199,407,731,199,,,0,0,0,,,,,,
407,731,204,407,731,205,,,0,0,-1,,,,,,
407,731,212,407,731,212,,,0,0,0,,,,,,
407,731,222,407,731,223,,,0,0,-1,,,,,,
407,731,235,407,731,235,,,0,0,0,,,,,,
408,731,249,407,731,249,,,1,0,0,,,,,,
408,731,264,408,731,264,,,0,0,0,,,,,,
408,731,281,408,731,281,,,0,0,0,,,,,,
408,731,299,408,731,299,,,0,0,0,,,,,,
408,732,318,408,731,318,,,0,1,0,,,,,,
409,732,338,409,732,338,,,0,0,0,,,,,,
409,732,358,409,732,359,,,0,0,-1,,,,,,
409,732,380,409,732,380,,,0,0,0,,,,,,
410,732,401,409,732,401,,,1,0,0,,,,,,
410,733,423,410,733,423,,,0,0,0,,,,,,
411,733,446,410,733,445,,,1,0,1,,,,,,
411,733,468,411,733,468,,,0,0,0,,,,,,
412,733,491,411,733,491,,,1,0,0,,,,,,
412,734,514,412,734,514,,,0,0,0,,,,,,
413,734,538,413,734,538,,,0,0,0,,,,,,
414,734,562,414,734,562,,,0,0,0,,,,,,
414,735,585,414,734,585,,,0,1,0,,,,,,
415,735,609,415,735,609,,,0,0,0,,,,,,
416,735,633,415,735,633,,,1,0,0,,,,,,
416,736,658,416,736,658,,,0,0,0,,,,,,
417,736,682,417,736,682,,,0,0,0,,,,,,
418,737,707,418,737,707,,,0,0,0,,,,,,
419,737,731,419,737,731,,,0,0,0,,,,,,
420,738,756,420,738,756,,,0,0,0,,,,,,
421,738,781,421,738,781,,,0,0,0,,,,,,
423,760,203,423,760,203,,,0,0,0,,,,,,
423,760,204,423,760,203,,,0,0,1,,,,,,
423,760,207,423,760,206,,,0,0,1,,,,,,
423,760,212,423,760,213,,,0,0,-1,,,,,,
424,760,219,423,760,219,,,1,0,0,,,,,,
424,760,229,423,760,230,,,1,0,-1,,,,,,
424,760,241,423,760,241,,,1,0,0,,,,,,
424,760,255,423,760,255,,,1,0,0,,,,,,
424,760,270,424,760,270,,,0,0,0,,,,,,
424,761,286,424,760,287,,,0,1,-1,,,,,,
424,761,304,424,760,304,,,0,1,0,,,,,,
425,761,323,424,760,323,,,1,1,0,,,,,,
425,761,342,425,761,342,,,0,0,0,,,,,,
425,761,363,425,761,363,,,0,0,0,,,,,,
426,761,383,425,761,383,,,1,0,0,,,,,,
426,762,405,426,761,405,,,0,1,0,,,,,,
427,762,426,426,762,426,,,1,0,0,,,,,,
427,762,449,427,762,448,,,0,0,1,,,,,,
427,762,471,427,762,471,,,0,0,0,,,,,,
428,763,494,428,762,494,,,0,1,0,,,,,,
428,763,517,428,763,517,,,0,0,0,,,,,,
429,763,540,429,763,540,,,0,0,0,,,,,,
430,763,564,430,763,564,,,0,0,0,,,,,,
430,764,588,430,763,588,,,0,1,0,,,,,,
431,764,612,431,764,611,,,0,0,1,,,,,,
432,765,636,431,764,635,,,1,1,1,,,,,,
432,765,660,432,765,660,,,0,0,0,,,,,,
433,765,684,433,765,684,,,0,0,0,,,,,,
434,766,709,434,766,709,,,0,0,0,,,,,,
435,766,733,435,766,733,,,0,0,0,,,,,,
436,767,758,436,767,758,,,0,0,0,,,,,,
437,767,782,436,767,782,,,1,0,0,,,,,,
440,789,211,440,789,211,,,0,0,0,,,,,,
440,789,212,440,789,211,,,0,0,1,,,,,,
440,789,214,440,789,214,,,0,0,0,,,,,,
440,789,219,440,789,220,,,0,0,-1,,,,,,
440,789,227,440,789,227,,,0,0,0,,,,,,
440,789,236,440,789,237,,,0,0,-1,,,,,,
440,790,248,440,790,248,,,0,0,0,,,,,,
440,790,261,440,790,262,,,0,0,-1,,,,,,
440,790,276,440,790,276,,,0,0,0,,,,,,
441,790,292,440,790,292,,,1,0,0,,,,,,
441,790,309,441,790,309,,,0,0,0,,,,,,
441,790,328,441,790,328,,,0,0,0,,,,,,
441,790,347,441,790,347,,,0,0,0,,,,,,
442,790,367,441,790,367,,,1,0,0,,,,,,
442,791,387,442,791,387,,,0,0,0,,,,,,
442,791,408,442,791,408,,,0,0,0,,,,,,
443,791,430,443,791,430,,,0,0,0,,,,,,
443,791,452,443,791,452,,,0,0,0,,,,,,
444,791,474,444,791,474,,,0,0,0,,,,,,
444,792,497,444,791,497,,,0,1,0,,,,,,
445,792,520,445,792,520,,,0,0,0,,,,,,
445,792,543,445,792,543,,,0,0,0,,,,,,
446,793,567,446,793,567,,,0,0,0,,,,,,
446,793,590,446,793,590,,,0,0,0,,,,,,
447,793,614,447,793,614,,,0,0,0,,,,,,
448,794,638,447,793,638,,,1,1,0,,,,,,
448,794,662,448,794,662,,,0,0,0,,,,,,
449,795,686,449,794,686,,,0,1,0,,,,,,
450,795,711,450,795,711,,,0,0,0,,,,,,
451,795,735,451,795,735,,,0,0,0,,,,,,
452,796,760,452,796,760,,,0,0,0,,,,,,
452,796,784,452,796,784,,,0,0,0,,,,,,
456,819,219,456,818,219,,,0,1,0,,,,,,
456,819,219,456,818,219,,,0,1,0,,,,,,
456,819,222,456,818,222,,,0,1,0,,,,,,
456,819,227,456,818,228,,,0,1,-1,,,,,,
456,819,234,456,818,234,,,0,1,0,,,,,,
456,819,243,456,818,244,,,0,1,-1,,,,,,
456,819,254,456,819,254,,,0,0,0,,,,,,
457,819,267,456,819,268,,,1,0,-1,,,,,,
457,819,281,456,819,281,,,1,0,0,,,,,,
457,819,297,456,819,298,,,1,0,-1,,,,,,
457,819,314,457,819,314,,,0,0,0,,,,,,
457,819,332,457,819,333,,,0,0,-1,,,,,,
458,820,351,457,819,351,,,1,1,0,,,,,,
458,820,371,458,819,371,,,0,1,0,,,,,,
458,820,391,458,820,391,,,0,0,0,,,,,,
459,820,412,458,820,412,,,1,0,0,,,,,,
459,820,434,459,820,433,,,0,0,1,,,,,,
459,821,455,459,820,455,,,0,1,0,,,,,,
460,821,478,460,820,477,,,0,1,1,,,,,,
460,821,500,460,821,500,,,0,0,0,,,,,,
461,821,523,461,821,523,,,0,0,0,,,,,,
461,822,546,461,821,546,,,0,1,0,,,,,,
462,822,569,462,822,569,,,0,0,0,,,,,,
462,822,593,462,822,593,,,0,0,0,,,,,,
463,823,616,463,822,616,,,0,1,0,,,,,,
464,823,640,463,823,640,,,1,0,0,,,,,,
464,823,664,464,823,664,,,0,0,0,,,,,,
465,824,688,465,823,688,,,0,1,0,,,,,,
466,824,713,466,824,713,,,0,0,0,,,,,,
467,825,737,466,824,737,,,1,1,0,,,,,,
467,825,761,467,825,761,,,0,0,0,,,,,,
468,825,786,468,825,786,,,0,0,0,,,,,,
473,848,227,473,848,227,,,0,0,0,,,,,,
473,848,227,473,848,227,,,0,0,0,,,,,,
473,848,230,473,848,230,,,0,0,0,,,,,,
473,848,234,473,848,235,,,0,0,-1,,,,,,
473,848,241,473,848,241,,,0,0,0,,,,,,
473,848,250,473,848,251,,,0,0,-1,,,,,,
473,848,261,473,848,261,,,0,0,0,,,,,,
473,848,273,473,848,274,,,0,0,-1,,,,,,
473,849,287,473,849,287,,,0,0,0,,,,,,
473,849,303,473,849,303,,,0,0,0,,,,,,
473,849,320,473,849,320,,,0,0,0,,,,,,
474,849,337,473,849,338,,,1,0,-1,,,,,,
474,849,356,474,849,356,,,0,0,0,,,,,,
474,849,375,474,849,375,,,0,0,0,,,,,,
475,849,395,475,849,395,,,0,0,0,,,,,,
475,849,416,475,849,416,,,0,0,0,,,,,,
475,850,437,475,850,437,,,0,0,0,,,,,,
476,850,459,475,850,459,,,1,0,0,,,,,,
476,850,481,476,850,481,,,0,0,0,,,,,,
477,850,503,476,850,503,,,1,0,0,,,,,,
477,851,526,477,851,526,,,0,0,0,,,,,,
477,851,549,477,851,549,,,0,0,0,,,,,,
478,851,572,478,851,572,,,0,0,0,,,,,,
479,852,595,478,851,595,,,1,1,0,,,,,,
479,852,619,479,852,619,,,0,0,0,,,,,,
480,852,643,479,852,643,,,1,0,0,,,,,,
480,853,667,480,853,667,,,0,0,0,,,,,,
481,853,691,481,853,691,,,0,0,0,,,,,,
482,853,715,482,853,715,,,0,0,0,,,,,,
483,854,739,482,853,739,,,1,1,0,,,,,,
483,854,763,483,854,763,,,0,0,0,,,,,,
484,855,788,484,854,788,,,0,1,0,,,,,,
489,878,234,489,877,234,,,0,1,0,,,,,,
489,878,235,489,877,234,,,0,1,1,,,,,,
489,878,238,489,877,237,,,0,1,1,,,,,,
489,878,242,489,877,243,,,0,1,-1,,,,,,
489,878,249,489,877,248,,,0,1,1,,,,,,
489,878,257,489,877,258,,,0,1,-1,,,,,,
489,878,268,489,877,267,,,0,1,1,,,,,,
489,878,280,489,877,280,,,0,1,0,,,,,,
489,878,294,489,878,293,,,0,0,1,,,,,,
490,878,309,489,878,309,,,1,0,0,,,,,,
490,878,325,489,878,325,,,1,0,0,,,,,,
490,878,342,490,878,343,,,0,0,-1,,,,,,
490,878,361,490,878,361,,,0,0,0,,,,,,
491,879,380,490,878,380,,,1,1,0,,,,,,
491,879,400,491,878,399,,,0,1,1,,,,,,
491,879,420,491,879,420,,,0,0,0,,,,,,
492,879,441,491,879,441,,,1,0,0,,,,,,
492,879,463,492,879,462,,,0,0,1,,,,,,
492,880,484,492,879,484,,,0,1,0,,,,,,
493,880,507,493,879,506,,,0,1,1,,,,,,
493,880,529,493,880,529,,,0,0,0,,,,,,
494,880,552,493,880,552,,,1,0,0,,,,,,
494,881,575,494,880,575,,,0,1,0,,,,,,
495,881,598,494,881,598,,,1,0,0,,,,,,
495,881,622,495,881,621,,,0,0,1,,,,,,
496,882,645,496,881,645,,,0,1,0,,,,,,
497,882,669,496,882,669,,,1,0,0,,,,,,
497,882,693,497,882,693,,,0,0,0,,,,,,
498,883,717,498,882,717,,,0,1,0,,,,,,
499,883,741,498,883,741,,,1,0,0,,,,,,
499,883,766,499,883,765,,,0,0,1,,,,,,
500,884,790,500,884,790,,,0,0,0,,,,,,
23,6,3,0,0,0,,,23,6,3,,,,,,
23,7,21,0,0,0,,,23,7,21,,,,,,
24,9,43,7,7,43,,,17,2,0,,,,,,
25,12,66,10,10,66,,,15,2,0,,,,,,
26,15,90,14,14,90,,,12,1,0,,,,,,
28,19,113,17,18,113,,,11,1,0,,,,,,
31,23,137,21,22,137,,,10,1,0,,,,,,
33,26,161,25,25,161,,,8,1,0,,,,,,
36,30,185,29,29,185,,,7,1,0,,,,,,
39,34,210,32,33,209,,,7,1,1,,,,,,
42,38,234,36,37,234,,,6,1,0,,,,,,
45,41,258,40,41,258,,,5,0,0,,,,,,
49,45,283,44,45,283,,,5,0,0,,,,,,
52,49,308,47,49,307,,,5,0,1,,,,,,
56,53,332,51,53,332,,,5,0,0,,,,,,
59,57,357,55,57,357,,,4,0,0,,,,,,
63,61,382,59,61,382,,,4,0,0,,,,,,
66,65,407,63,65,407,,,3,0,0,,,,,,
70,69,432,67,69,432,,,3,0,0,,,,,,
74,73,457,71,72,457,,,3,1,0,,,,,,
77,77,482,75,76,482,,,2,1,0,,,,,,
81,81,507,78,80,507,,,3,1,0,,,,,,
85,85,532,82,84,532,,,3,1,0,,,,,,
89,89,557,86,88,557,,,3,1,0,,,,,,
93,93,583,90,92,583,,,3,1,0,,,,,,
96,97,608,94,96,608,,,2,1,0,,,,,,
100,101,633,98,101,633,,,2,0,0,,,,,,
104,105,659,102,105,658,,,2,0,1,,,,,,
108,109,684,106,109,684,,,2,0,0,,,,,,
112,113,710,110,113,709,,,2,0,1,,,,,,
116,117,735,114,117,735,,,2,0,0,,,,,,
120,121,761,118,121,760,,,2,0,1,,,,,,
26,25,7,0,0,0,,,26,25,7,,,,,,
26,25,22,0,0,0,,,26,25,22,,,,,,
27,25,44,7,7,43,,,20,18,1,,,,,,
28,26,67,10,10,66,,,18,16,1,,,,,,
29,28,90,14,14,90,,,15,14,0,,,,,,
31,30,114,17,18,113,,,14,12,1,,,,,,
33,32,137,21,22,137,,,12,10,0,,,,,,
35,35,161,25,25,161,,,10,10,0,,,,,,
38,38,185,29,29,185,,,9,9,0,,,,,,
41,41,210,32,33,209,,,9,8,1,,,,,,
44,44,234,36,37,234,,,8,7,0,,,,,,
47,47,258,40,41,258,,,7,6,0,,,,,,
50,50,283,44,45,283,,,6,5,0,,,,,,
54,54,308,47,49,307,,,7,5,1,,,,,,
57,57,332,51,53,332,,,6,4,0,,,,,,
60,61,357,55,57,357,,,5,4,0,,,,,,
64,65,382,59,61,382,,,5,4,0,,,,,,
67,68,407,63,65,407,,,4,3,0,,,,,,
71,72,432,67,69,432,,,4,3,0,,,,,,
75,76,457,71,72,457,,,4,4,0,,,,,,
78,80,482,75,76,482,,,3,4,0,,,,,,
82,84,507,78,80,507,,,4,4,0,,,,,,
86,87,532,82,84,532,,,4,3,0,,,,,,
89,91,557,86,88,557,,,3,3,0,,,,,,
93,95,583,90,92,583,,,3,3,0,,,,,,
97,99,608,94,96,608,,,3,3,0,,,,,,
101,103,633,98,101,633,,,3,2,0,,,,,,
105,107,659,102,105,658,,,3,2,1,,,,,,
108,111,684,106,109,684,,,2,2,0,,,,,,
112,115,710,110,113,709,,,2,2,1,,,,,,
116,119,735,114,117,735,,,2,2,0,,,,,,
120,123,761,118,121,760,,,2,2,1,,,,,,
35,50,14,28,50,13,,,7,0,1,,,,,,
35,50,24,28,50,13,,,7,0,11,,,,,,
36,51,45,28,50,45,,,8,1,0,,,,,,
37,51,67,29,51,67,,,8,0,0,,,,,,
38,52,91,31,52,90,,,7,0,1,,,,,,
39,53,114,32,53,114,,,7,0,0,,,,,,
41,54,138,34,54,138,,,7,0,0,,,,,,
43,56,162,36,55,162,,,7,1,0,,,,,,
45,57,186,39,57,186,,,6,0,0,,,,,,
47,59,210,42,59,210,,,5,0,0,,,,,,
50,61,234,45,61,234,,,5,0,0,,,,,,
52,64,259,48,63,258,,,4,1,1,,,,,,
55,66,283,51,66,283,,,4,0,0,,,,,,
58,69,308,54,68,307,,,4,1,1,,,,,,
61,71,332,58,71,332,,,3,0,0,,,,,,
65,74,357,61,74,357,,,4,0,0,,,,,,
68,77,382,65,77,382,,,3,0,0,,,,,,
71,80,407,68,80,407,,,3,0,0,,,,,,
75,83,432,72,83,432,,,3,0,0,,,,,,
78,87,457,75,86,457,,,3,1,0,,,,,,
82,90,482,79,90,482,,,3,0,0,,,,,,
85,93,507,82,93,507,,,3,0,0,,,,,,
89,97,532,86,97,532,,,3,0,0,,,,,,
92,100,558,90,100,557,,,2,0,1,,,,,,
96,104,583,94,104,583,,,2,0,0,,,,,,
100,107,608,97,107,608,,,3,0,0,,,,,,
103,111,633,101,111,633,,,2,0,0,,,,,,
107,115,659,105,114,658,,,2,1,1,,,,,,
111,118,684,109,118,684,,,2,0,0,,,,,,
114,122,710,113,121,709,,,1,1,1,,,,,,
118,126,735,117,125,735,,,1,1,0,,,,,,
122,129,761,120,129,760,,,2,0,1,,,,,,
48,77,21,43,77,20,,,5,0,1,,,,,,
48,77,29,43,77,20,,,5,0,9,,,,,,
48,77,47,43,77,48,,,5,0,-1,,,,,,
49,77,69,44,77,69,,,5,0,0,,,,,,
49,78,92,45,78,91,,,4,0,1,,,,,,
50,78,115,46,78,115,,,4,0,0,,,,,,
52,79,138,47,79,138,,,5,0,0,,,,,,
53,80,162,49,80,162,,,4,0,0,,,,,,
55,81,186,51,82,186,,,4,-1,0,,,,,,
57,83,210,53,83,210,,,4,0,0,,,,,,
59,84,235,56,85,234,,,3,-1,1,,,,,,
61,86,259,58,87,259,,,3,-1,0,,,,,,
64,88,283,61,89,283,,,3,-1,0,,,,,,
66,89,308,64,91,308,,,2,-2,0,,,,,,
69,92,333,67,93,332,,,2,-1,1,,,,,,
72,94,357,70,95,357,,,2,-1,0,,,,,,
75,96,382,73,97,382,,,2,-1,0,,,,,,
78,98,407,76,100,407,,,2,-2,0,,,,,,
81,101,432,79,102,432,,,2,-1,0,,,,,,
84,104,457,82,105,457,,,2,-1,0,,,,,,
87,106,482,86,108,482,,,1,-2,0,,,,,,
90,109,507,89,111,507,,,1,-2,0,,,,,,
94,112,532,92,114,532,,,2,-2,0,,,,,,
97,115,558,96,117,557,,,1,-2,1,,,,,,
101,118,583,99,120,583,,,2,-2,0,,,,,,
104,121,608,103,123,608,,,1,-2,0,,,,,,
108,124,634,106,126,633,,,2,-2,1,,,,,,
111,127,659,110,129,659,,,1,-2,0,,,,,,
115,131,684,114,132,684,,,1,-1,0,,,,,,
118,134,710,117,135,710,,,1,-1,0,,,,,,
122,137,735,121,139,735,,,1,-2,0,,,,,,
126,141,761,125,142,761,,,1,-1,0,,,,,,
61,104,28,58,104,28,,,3,0,0,,,,,,
61,104,34,58,104,28,,,3,0,6,,,,,,
62,104,51,58,104,51,,,4,0,0,,,,,,
62,104,71,58,104,72,,,4,0,-1,,,,,,
63,104,93,59,104,93,,,4,0,0,,,,,,
63,105,116,60,104,116,,,3,1,0,,,,,,
64,105,139,61,105,139,,,3,0,0,,,,,,
66,106,163,62,106,163,,,4,0,0,,,,,,
67,107,187,64,107,187,,,3,0,0,,,,,,
68,108,211,65,108,211,,,3,0,0,,,,,,
70,109,235,67,109,235,,,3,0,0,,,,,,
72,110,259,69,110,259,,,3,0,0,,,,,,
74,112,284,71,112,284,,,3,0,0,,,,,,
76,113,308,73,113,308,,,3,0,0,,,,,,
79,115,333,76,115,333,,,3,0,0,,,,,,
81,116,358,78,116,358,,,3,0,0,,,,,,
84,118,383,81,118,383,,,3,0,0,,,,,,
86,120,407,84,120,407,,,2,0,0,,,,,,
89,122,432,87,122,432,,,2,0,0,,,,,,
92,124,457,90,124,457,,,2,0,0,,,,,,
95,127,482,93,126,482,,,2,1,0,,,,,,
98,129,508,96,128,507,,,2,1,1,,,,,,
101,131,533,99,131,533,,,2,0,0,,,,,,
104,134,558,102,133,558,,,2,1,0,,,,,,
107,136,583,105,136,583,,,2,0,0,,,,,,
111,139,608,108,139,608,,,3,0,0,,,,,,
114,142,634,112,142,634,,,2,0,0,,,,,,
117,144,659,115,144,659,,,2,0,0,,,,,,
121,147,685,119,147,685,,,2,0,0,,,,,,
124,150,710,122,150,710,,,2,0,0,,,,,,
128,153,736,126,153,736,,,2,0,0,,,,,,
131,156,761,129,156,761,,,2,0,0,,,,,,
76,131,35,73,131,35,,,3,0,0,,,,,,
76,131,40,73,131,35,,,3,0,5,,,,,,
76,131,55,73,131,55,,,3,0,0,,,,,,
76,131,74,73,131,75,,,3,0,-1,,,,,,
77,131,95,74,131,95,,,3,0,0,,,,,,
77,132,118,74,131,118,,,3,1,0,,,,,,
78,132,141,75,132,140,,,3,0,1,,,,,,
79,133,164,76,132,164,,,3,1,0,,,,,,
80,133,188,78,133,188,,,2,0,0,,,,,,
81,134,212,79,134,212,,,2,0,0,,,,,,
83,135,236,80,135,236,,,3,0,0,,,,,,
84,136,260,82,136,260,,,2,0,0,,,,,,
86,137,285,84,137,284,,,2,0,1,,,,,,
88,138,309,86,138,309,,,2,0,0,,,,,,
90,140,334,88,140,333,,,2,0,1,,,,,,
92,141,358,90,141,358,,,2,0,0,,,,,,
94,142,383,92,143,383,,,2,-1,0,,,,,,
97,144,408,95,144,408,,,2,0,0,,,,,,
99,146,433,98,146,432,,,1,0,1,,,,,,
102,147,458,100,148,457,,,2,-1,1,,,,,,
104,149,483,103,150,482,,,1,-1,1,,,,,,
107,151,508,105,152,507,,,2,-1,1,,,,,,
110,153,533,108,154,533,,,2,-1,0,,,,,,
113,155,558,111,156,558,,,2,-1,0,,,,,,
116,158,583,114,158,583,,,2,0,0,,,,,,
119,160,609,117,160,608,,,2,0,1,,,,,,
122,162,634,120,163,634,,,2,-1,0,,,,,,
125,165,659,123,165,659,,,2,0,0,,,,,,
128,167,685,127,168,685,,,1,-1,0,,,,,,
131,170,710,130,170,710,,,1,0,0,,,,,,
134,172,736,133,173,736,,,1,-1,0,,,,,,
138,175,761,137,175,761,,,1,0,0,,,,,,
91,158,42,88,158,42,,,3,0,0,,,,,,
91,158,47,88,158,42,,,3,0,5,,,,,,
91,158,59,88,158,59,,,3,0,0,,,,,,
91,159,77,88,158,78,,,3,1,-1,,,,,,
91,159,98,89,159,98,,,2,0,0,,,,,,
92,159,120,89,159,120,,,3,0,0,,,,,,
93,159,142,90,159,142,,,3,0,0,,,,,,
93,160,166,91,159,165,,,2,1,1,,,,,,
94,160,189,92,160,189,,,2,0,0,,,,,,
95,161,213,93,161,213,,,2,0,0,,,,,,
96,162,237,94,162,237,,,2,0,0,,,,,,
98,163,261,95,162,261,,,3,1,0,,,,,,
99,163,285,97,163,285,,,2,0,0,,,,,,
101,164,310,99,164,309,,,2,0,1,,,,,,
103,165,334,101,165,334,,,2,0,0,,,,,,
104,167,359,102,166,359,,,2,1,0,,,,,,
106,168,384,104,168,384,,,2,0,0,,,,,,
108,169,408,106,169,408,,,2,0,0,,,,,,
111,171,433,109,170,433,,,2,1,0,,,,,,
113,172,458,111,172,458,,,2,0,0,,,,,,
115,174,483,113,174,483,,,2,0,0,,,,,,
118,175,508,115,175,508,,,3,0,0,,,,,,
120,177,533,118,177,533,,,2,0,0,,,,,,
123,179,559,121,179,558,,,2,0,1,,,,,,
125,181,584,124,181,584,,,1,0,0,,,,,,
128,183,609,126,182,609,,,2,1,0,,,,,,
131,185,634,129,184,634,,,2,1,0,,,,,,
134,187,660,132,186,659,,,2,1,1,,,,,,
137,189,685,135,189,685,,,2,0,0,,,,,,
140,191,711,138,191,710,,,2,0,1,,,,,,
143,193,736,141,193,736,,,2,0,0,,,,,,
146,196,762,144,195,761,,,2,1,1,,,,,,
106,186,50,103,186,49,,,3,0,1,,,,,,
106,186,53,103,186,49,,,3,0,4,,,,,,
106,186,65,103,186,64,,,3,0,1,,,,,,
106,186,81,104,186,83,,,2,0,-2,,,,,,
106,186,101,104,186,101,,,2,0,0,,,,,,
107,187,122,105,186,123,,,2,1,-1,,,,,,
107,187,145,105,187,144,,,2,0,1,,,,,,
108,187,167,106,187,167,,,2,0,0,,,,,,
109,188,191,107,187,190,,,2,1,1,,,,,,
110,188,214,108,188,214,,,2,0,0,,,,,,
111,189,238,109,189,238,,,2,0,0,,,,,,
112,190,262,110,189,262,,,2,1,0,,,,,,
113,190,286,111,190,286,,,2,0,0,,,,,,
114,191,311,113,191,310,,,1,0,1,,,,,,
116,192,335,114,192,335,,,2,0,0,,,,,,
118,193,360,116,193,359,,,2,0,1,,,,,,
119,194,384,117,194,384,,,2,0,0,,,,,,
121,195,409,119,195,409,,,2,0,0,,,,,,
123,196,434,122,196,434,,,1,0,0,,,,,,
125,198,459,123,198,458,,,2,0,1,,,,,,
127,199,484,125,199,483,,,2,0,1,,,,,,
129,200,509,127,200,508,,,2,0,1,,,,,,
132,202,534,130,202,533,,,2,0,1,,,,,,
134,203,559,132,203,559,,,2,0,0,,,,,,
136,205,584,135,205,584,,,1,0,0,,,,,,
139,207,609,137,207,609,,,2,0,0,,,,,,
141,208,635,140,208,634,,,1,0,1,,,,,,
144,210,660,142,210,660,,,2,0,0,,,,,,
147,212,686,145,213,685,,,2,-1,1,,,,,,
150,214,711,148,214,711,,,2,0,0,,,,,,
152,216,736,151,216,736,,,1,0,0,,,,,,
155,218,762,154,218,762,,,1,0,0,,,,,,
121,214,57,119,214,57,,,2,0,0,,,,,,
121,214,60,119,214,57,,,2,0,3,,,,,,
121,214,70,119,214,70,,,2,0,0,,,,,,
121,214,86,119,214,87,,,2,0,-1,,,,,,
121,214,105,120,214,105,,,1,0,0,,,,,,
122,214,125,120,214,126,,,2,0,-1,,,,,,
122,215,147,121,215,147,,,1,0,0,,,,,,
123,215,169,121,215,169,,,2,0,0,,,,,,
123,215,192,122,215,192,,,1,0,0,,,,,,
124,216,216,123,215,215,,,1,1,1,,,,,,
125,216,239,124,216,239,,,1,0,0,,,,,,
126,217,263,125,216,263,,,1,1,0,,,,,,
127,218,287,126,217,287,,,1,1,0,,,,,,
128,218,312,127,218,311,,,1,0,1,,,,,,
130,219,336,128,219,336,,,2,0,0,,,,,,
131,220,361,129,220,360,,,2,0,1,,,,,,
133,221,385,131,221,385,,,2,0,0,,,,,,
134,222,410,133,222,410,,,1,0,0,,,,,,
136,223,435,135,223,435,,,1,0,0,,,,,,
138,224,459,136,224,459,,,2,0,0,,,,,,
140,225,484,138,225,484,,,2,0,0,,,,,,
142,226,509,140,226,509,,,2,0,0,,,,,,
144,228,534,142,227,534,,,2,1,0,,,,,,
146,229,560,144,228,559,,,2,1,1,,,,,,
148,230,585,147,230,585,,,1,0,0,,,,,,
150,232,610,149,231,610,,,1,1,0,,,,,,
153,233,635,151,233,635,,,2,0,0,,,,,,
155,235,661,153,235,660,,,2,0,1,,,,,,
158,237,686,156,237,686,,,2,0,0,,,,,,
160,238,711,159,238,711,,,1,0,0,,,,,,
163,240,737,162,240,737,,,1,0,0,,,,,,
166,242,762,164,242,762,,,2,0,0,,,,,,
136,242,65,134,242,64,,,2,0,1,,,,,,
136,242,67,134,242,64,,,2,0,3,,,,,,
136,242,77,134,242,76,,,2,0,1,,,,,,
136,242,91,135,242,92,,,1,0,-1,,,,,,
137,242,109,135,242,109,,,2,0,0,,,,,,
137,242,129,135,242,129,,,2,0,0,,,,,,
137,243,150,136,242,150,,,1,1,0,,,,,,
138,243,172,136,242,172,,,2,1,0,,,,,,
139,243,195,137,243,194,,,2,0,1,,,,,,
139,244,218,138,243,217,,,1,1,1,,,,,,
140,244,241,139,244,241,,,1,0,0,,,,,,
141,244,265,139,244,264,,,2,0,1,,,,,,
142,245,289,140,245,288,,,2,0,1,,,,,,
143,246,313,141,245,312,,,2,1,1,,,,,,
144,246,337,143,246,337,,,1,0,0,,,,,,
145,247,362,144,247,361,,,1,0,1,,,,,,
147,248,386,145,248,386,,,2,0,0,,,,,,
148,249,411,147,249,410,,,1,0,1,,,,,,
150,250,435,149,250,435,,,1,0,0,,,,,,
151,251,460,150,251,460,,,1,0,0,,,,,,
153,252,485,152,252,485,,,1,0,0,,,,,,
155,253,510,153,253,510,,,2,0,0,,,,,,
157,254,535,155,254,535,,,2,0,0,,,,,,
159,255,560,157,255,560,,,2,0,0,,,,,,
161,256,585,160,256,585,,,1,0,0,,,,,,
163,258,611,162,257,610,,,1,1,1,,,,,,
165,259,636,164,259,635,,,1,0,1,,,,,,
167,260,661,166,260,661,,,1,0,0,,,,,,
169,262,686,168,262,686,,,1,0,0,,,,,,
172,263,712,171,264,712,,,1,-1,0,,,,,,
174,265,737,173,265,737,,,1,0,0,,,,,,
177,267,763,176,267,763,,,1,0,0,,,,,,
152,270,72,150,270,72,,,2,0,0,,,,,,
152,270,75,150,270,72,,,2,0,3,,,,,,
152,270,83,150,270,83,,,2,0,0,,,,,,
152,270,96,150,270,98,,,2,0,-2,,,,,,
152,270,113,151,270,113,,,1,0,0,,,,,,
152,270,132,151,270,133,,,1,0,-1,,,,,,
153,271,153,151,270,153,,,2,1,0,,,,,,
153,271,174,151,270,175,,,2,1,-1,,,,,,
154,271,197,152,271,197,,,2,0,0,,,,,,
154,271,220,153,271,220,,,1,0,0,,,,,,
155,272,243,154,272,243,,,1,0,0,,,,,,
156,272,266,154,272,266,,,2,0,0,,,,,,
157,273,290,155,273,290,,,2,0,0,,,,,,
158,273,314,156,273,314,,,2,0,0,,,,,,
159,274,338,158,274,338,,,1,0,0,,,,,,
160,275,363,159,274,362,,,1,1,1,,,,,,
161,275,387,160,275,387,,,1,0,0,,,,,,
162,276,412,161,276,411,,,1,0,1,,,,,,
164,277,436,163,277,436,,,1,0,0,,,,,,
165,278,461,164,278,461,,,1,0,0,,,,,,
167,279,486,166,279,486,,,1,0,0,,,,,,
168,280,511,167,280,511,,,1,0,0,,,,,,
170,281,536,169,281,536,,,1,0,0,,,,,,
172,282,561,171,282,561,,,1,0,0,,,,,,
174,283,586,173,283,586,,,1,0,0,,,,,,
176,284,611,175,284,611,,,1,0,0,,,,,,
178,285,636,177,285,636,,,1,0,0,,,,,,
180,287,662,179,286,661,,,1,1,1,,,,,,
182,288,687,181,288,687,,,1,0,0,,,,,,
184,289,712,183,289,712,,,1,0,0,,,,,,
186,291,738,185,291,738,,,1,0,0,,,,,,
189,292,763,187,292,763,,,2,0,0,,,,,,
167,298,80,166,298,79,,,1,0,1,,,,,,
167,298,82,166,298,79,,,1,0,3,,,,,,
167,298,89,166,298,89,,,1,0,0,,,,,,
167,298,102,166,298,103,,,1,0,-1,,,,,,
168,298,118,166,298,118,,,2,0,0,,,,,,
168,298,136,166,298,137,,,2,0,-1,,,,,,
168,299,156,167,298,156,,,1,1,0,,,,,,
169,299,177,167,298,178,,,2,1,-1,,,,,,
169,299,199,168,299,199,,,1,0,0,,,,,,
170,299,222,168,299,222,,,2,0,0,,,,,,
170,300,245,169,300,245,,,1,0,0,,,,,,
171,300,268,170,300,268,,,1,0,0,,,,,,
172,301,292,170,301,292,,,2,0,0,,,,,,
173,301,316,171,301,315,,,2,0,1,,,,,,
174,302,340,173,302,339,,,1,0,1,,,,,,
175,302,364,174,302,364,,,1,0,0,,,,,,
176,303,388,175,303,388,,,1,0,0,,,,,,
177,304,413,176,303,413,,,1,1,0,,,,,,
178,304,437,177,304,437,,,1,0,0,,,,,,
180,305,462,178,305,462,,,2,0,0,,,,,,
181,306,487,180,306,487,,,1,0,0,,,,,,
182,307,512,181,307,512,,,1,0,0,,,,,,
184,308,537,183,308,537,,,1,0,0,,,,,,
186,309,562,184,309,562,,,2,0,0,,,,,,
187,310,587,186,310,587,,,1,0,0,,,,,,
189,311,612,188,311,612,,,1,0,0,,,,,,
191,312,637,190,312,637,,,1,0,0,,,,,,
193,313,662,192,313,662,,,1,0,0,,,,,,
195,314,688,194,314,687,,,1,0,1,,,,,,
197,316,713,196,315,713,,,1,1,0,,,,,,
199,317,738,198,317,738,,,1,0,0,,,,,,
201,318,764,200,318,764,,,1,0,0,,,,,,
183,326,87,182,326,87,,,1,0,0,,,,,,
183,326,89,182,326,87,,,1,0,2,,,,,,
183,326,96,182,326,96,,,1,0,0,,,,,,
183,327,108,182,326,109,,,1,1,-1,,,,,,
183,327,123,182,327,123,,,1,0,0,,,,,,
184,327,141,182,327,141,,,2,0,0,,,,,,
184,327,160,183,327,160,,,1,0,0,,,,,,
184,327,181,183,327,181,,,1,0,0,,,,,,
185,327,202,184,327,202,,,1,0,0,,,,,,
185,328,224,184,327,224,,,1,1,0,,,,,,
186,328,247,185,328,247,,,1,0,0,,,,,,
186,328,270,185,328,270,,,1,0,0,,,,,,
187,329,294,186,329,294,,,1,0,0,,,,,,
188,329,318,187,329,317,,,1,0,1,,,,,,
189,330,341,188,330,341,,,1,0,0,,,,,,
190,330,366,189,330,365,,,1,0,1,,,,,,
191,331,390,190,331,390,,,1,0,0,,,,,,
192,331,414,191,331,414,,,1,0,0,,,,,,
193,332,439,192,332,439,,,1,0,0,,,,,,
194,333,463,193,332,463,,,1,1,0,,,,,,
195,334,488,194,333,488,,,1,1,0,,,,,,
197,334,513,195,334,513,,,2,0,0,,,,,,
198,335,538,197,335,538,,,1,0,0,,,,,,
200,336,563,198,336,563,,,2,0,0,,,,,,
201,337,588,200,337,588,,,1,0,0,,,,,,
203,338,613,202,338,613,,,1,0,0,,,,,,
205,339,638,204,339,638,,,1,0,0,,,,,,
206,340,663,205,340,663,,,1,0,0,,,,,,
208,341,688,207,341,688,,,1,0,0,,,,,,
210,342,714,209,342,713,,,1,0,1,,,,,,
212,343,739,211,343,739,,,1,0,0,,,,,,
214,345,764,213,344,764,,,1,1,0,,,,,,
199,355,95,198,354,94,,,1,1,1,,,,,,
199,355,97,198,354,94,,,1,1,3,,,,,,
199,355,103,198,354,103,,,1,1,0,,,,,,
199,355,114,198,355,115,,,1,0,-1,,,,,,
199,355,128,198,355,128,,,1,0,0,,,,,,
199,355,145,198,355,146,,,1,0,-1,,,,,,
199,355,164,198,355,164,,,1,0,0,,,,,,
200,356,184,199,355,184,,,1,1,0,,,,,,
200,356,205,199,355,205,,,1,1,0,,,,,,
201,356,227,200,356,227,,,1,0,0,,,,,,
201,356,250,200,356,249,,,1,0,1,,,,,,
202,357,273,201,356,272,,,1,1,1,,,,,,
202,357,296,201,357,296,,,1,0,0,,,,,,
203,357,319,202,357,319,,,1,0,0,,,,,,
204,358,343,203,358,343,,,1,0,0,,,,,,
205,358,367,204,358,367,,,1,0,0,,,,,,
206,359,391,205,359,391,,,1,0,0,,,,,,
207,359,416,206,359,415,,,1,0,1,,,,,,
208,360,440,207,360,440,,,1,0,0,,,,,,
209,361,465,208,360,464,,,1,1,1,,,,,,
210,361,489,209,361,489,,,1,0,0,,,,,,
211,362,514,210,362,514,,,1,0,0,,,,,,
213,363,539,212,363,539,,,1,0,0,,,,,,
214,364,564,213,363,564,,,1,1,0,,,,,,
216,364,589,214,364,589,,,2,0,0,,,,,,
217,365,614,216,365,614,,,1,0,0,,,,,,
219,366,639,218,366,639,,,1,0,0,,,,,,
220,367,664,219,367,664,,,1,0,0,,,,,,
222,368,689,221,368,689,,,1,0,0,,,,,,
224,369,714,223,369,714,,,1,0,0,,,,,,
226,370,740,225,370,740,,,1,0,0,,,,,,
227,372,765,226,371,765,,,1,1,0,,,,,,
214,383,102,214,383,102,,,0,0,0,,,,,,
214,383,104,214,383,102,,,0,0,2,,,,,,
215,383,110,214,383,110,,,1,0,0,,,,,,
215,383,120,214,383,122,,,1,0,-2,,,,,,
215,384,134,214,384,134,,,1,0,0,,,,,,
215,384,150,214,384,151,,,1,0,-1,,,,,,
215,384,168,214,384,168,,,1,0,0,,,,,,
216,384,188,214,384,188,,,2,0,0,,,,,,
216,384,209,215,384,209,,,1,0,0,,,,,,
216,384,230,215,384,230,,,1,0,0,,,,,,
217,385,252,216,385,252,,,1,0,0,,,,,,
217,385,275,216,385,275,,,1,0,0,,,,,,
218,385,298,217,385,298,,,1,0,0,,,,,,
219,386,321,217,385,321,,,2,1,0,,,,,,
219,386,345,218,386,345,,,1,0,0,,,,,,
220,387,369,219,386,369,,,1,1,0,,,,,,
221,387,393,220,387,393,,,1,0,0,,,,,,
222,388,417,221,387,417,,,1,1,0,,,,,,
223,388,441,222,388,441,,,1,0,0,,,,,,
224,389,466,223,388,465,,,1,1,1,,,,,,
225,389,490,224,389,490,,,1,0,0,,,,,,
226,390,515,225,390,515,,,1,0,0,,,,,,
227,391,540,227,391,540,,,0,0,0,,,,,,
229,391,565,228,391,565,,,1,0,0,,,,,,
230,392,590,229,392,590,,,1,0,0,,,,,,
231,393,615,230,393,615,,,1,0,0,,,,,,
233,394,640,232,394,640,,,1,0,0,,,,,,
234,395,665,233,395,665,,,1,0,0,,,,,,
236,396,690,235,396,690,,,1,0,0,,,,,,
238,397,715,237,397,715,,,1,0,0,,,,,,
239,398,741,239,398,741,,,0,0,0,,,,,,
241,399,766,240,399,766,,,1,0,0,,,,,,
230,412,110,229,412,110,,,1,0,0,,,,,,
230,412,112,229,412,110,,,1,0,2,,,,,,
230,412,117,230,412,117,,,0,0,0,,,,,,
230,412,127,230,412,128,,,0,0,-1,,,,,,
231,412,139,230,412,139,,,1,0,0,,,,,,
231,412,155,230,412,156,,,1,0,-1,,,,,,
231,412,173,230,412,172,,,1,0,1,,,,,,
231,412,192,230,412,192,,,1,0,0,,,,,,
232,413,212,231,412,212,,,1,1,0,,,,,,
232,413,233,231,413,233,,,1,0,0,,,,,,
232,413,255,231,413,255,,,1,0,0,,,,,,
233,413,278,232,413,277,,,1,0,1,,,,,,
234,414,301,232,413,300,,,2,1,1,,,,,,
234,414,324,233,414,323,,,1,0,1,,,,,,
235,414,347,234,414,347,,,1,0,0,,,,,,
236,415,371,234,415,371,,,2,0,0,,,,,,
236,415,395,235,415,395,,,1,0,0,,,,,,
237,416,419,236,416,419,,,1,0,0,,,,,,
238,416,443,237,416,443,,,1,0,0,,,,,,
239,417,467,238,417,467,,,1,0,0,,,,,,
240,417,492,239,417,491,,,1,0,1,,,,,,
241,418,516,240,418,516,,,1,0,0,,,,,,
242,419,541,242,419,541,,,0,0,0,,,,,,
244,419,566,243,419,566,,,1,0,0,,,,,,
245,420,591,244,420,591,,,1,0,0,,,,,,
246,421,616,245,421,616,,,1,0,0,,,,,,
247,422,641,247,422,641,,,0,0,0,,,,,,
249,423,666,248,422,666,,,1,1,0,,,,,,
250,423,691,249,423,691,,,1,0,0,,,,,,
252,424,716,251,424,716,,,1,0,0,,,,,,
254,425,741,253,425,741,,,1,0,0,,,,,,
255,426,767,254,426,766,,,1,0,1,,,,,,
246,441,118,245,441,118,,,1,0,0,,,,,,
246,441,119,245,441,118,,,1,0,1,,,,,,
246,441,124,246,441,124,,,0,0,0,,,,,,
246,441,133,246,441,134,,,0,0,-1,,,,,,
246,441,145,246,441,145,,,0,0,0,,,,,,
247,441,160,246,441,161,,,1,0,-1,,,,,,
247,441,177,246,441,177,,,1,0,0,,,,,,
247,441,196,246,441,196,,,1,0,0,,,,,,
247,441,216,247,441,216,,,0,0,0,,,,,,
248,442,237,247,441,237,,,1,1,0,,,,,,
248,442,258,247,442,258,,,1,0,0,,,,,,
249,442,281,247,442,280,,,2,0,1,,,,,,
249,442,303,248,442,303,,,1,0,0,,,,,,
250,443,326,249,442,326,,,1,1,0,,,,,,
250,443,349,250,443,349,,,0,0,0,,,,,,
251,443,373,250,443,373,,,1,0,0,,,,,,
252,444,397,251,444,397,,,1,0,0,,,,,,
253,444,421,252,444,421,,,1,0,0,,,,,,
253,445,445,253,445,445,,,0,0,0,,,,,,
254,445,469,254,445,469,,,0,0,0,,,,,,
255,446,493,255,446,493,,,0,0,0,,,,,,
256,446,518,256,446,517,,,0,0,1,,,,,,
257,447,542,257,447,542,,,0,0,0,,,,,,
259,448,567,258,447,567,,,1,1,0,,,,,,
260,448,592,259,448,592,,,1,0,0,,,,,,
261,449,617,260,449,617,,,1,0,0,,,,,,
262,450,642,262,450,642,,,0,0,0,,,,,,
264,450,667,263,450,667,,,1,0,0,,,,,,
265,451,692,264,451,692,,,1,0,0,,,,,,
266,452,717,265,452,717,,,1,0,0,,,,,,
268,453,742,267,453,742,,,1,0,0,,,,,,
269,454,768,268,454,767,,,1,0,1,,,,,,
262,469,125,261,469,125,,,1,0,0,,,,,,
262,469,127,261,469,125,,,1,0,2,,,,,,
262,469,132,262,469,131,,,0,0,1,,,,,,
262,469,140,262,469,141,,,0,0,-1,,,,,,
262,469,152,262,469,151,,,0,0,1,,,,,,
263,470,166,262,469,167,,,1,1,-1,,,,,,
263,470,182,262,469,182,,,1,1,0,,,,,,
263,470,201,262,469,201,,,1,1,0,,,,,,
263,470,220,263,470,220,,,0,0,0,,,,,,
264,470,240,263,470,240,,,1,0,0,,,,,,
264,470,262,263,470,261,,,1,0,1,,,,,,
264,471,284,263,470,283,,,1,1,1,,,,,,
265,471,306,264,471,306,,,1,0,0,,,,,,
266,471,329,264,471,328,,,2,0,1,,,,,,
266,472,352,265,471,351,,,1,1,1,,,,,,
267,472,375,266,472,375,,,1,0,0,,,,,,
267,472,399,266,472,399,,,1,0,0,,,,,,
268,473,422,267,473,422,,,1,0,0,,,,,,
269,473,446,268,473,446,,,1,0,0,,,,,,
270,474,471,269,474,470,,,1,0,1,,,,,,
271,474,495,270,474,495,,,1,0,0,,,,,,
272,475,519,271,475,519,,,1,0,0,,,,,,
273,475,544,272,475,543,,,1,0,1,,,,,,
274,476,569,273,476,568,,,1,0,1,,,,,,
275,476,593,274,476,593,,,1,0,0,,,,,,
276,477,618,275,477,618,,,1,0,0,,,,,,
277,478,643,277,478,643,,,0,0,0,,,,,,
278,479,668,278,478,668,,,0,1,0,,,,,,
280,479,693,279,479,693,,,1,0,0,,,,,,
281,480,718,280,480,718,,,1,0,0,,,,,,
283,481,743,282,481,743,,,1,0,0,,,,,,
284,482,769,283,482,768,,,1,0,1,,,,,,
278,498,133,278,498,133,,,0,0,0,,,,,,
278,498,134,278,498,133,,,0,0,1,,,,,,
278,498,139,278,498,139,,,0,0,0,,,,,,
278,498,147,278,498,148,,,0,0,-1,,,,,,
278,498,158,278,498,158,,,0,0,0,,,,,,
279,498,172,278,498,173,,,1,0,-1,,,,,,
279,498,188,278,498,188,,,1,0,0,,,,,,
279,499,205,278,498,206,,,1,1,-1,,,,,,
279,499,224,279,499,224,,,0,0,0,,,,,,
280,499,244,279,499,244,,,1,0,0,,,,,,
280,499,265,279,499,265,,,1,0,0,,,,,,
280,499,287,279,499,287,,,1,0,0,,,,,,
281,500,309,280,500,309,,,1,0,0,,,,,,
281,500,331,280,500,331,,,1,0,0,,,,,,
282,500,354,281,500,354,,,1,0,0,,,,,,
282,501,377,281,500,377,,,1,1,0,,,,,,
283,501,401,282,501,401,,,1,0,0,,,,,,
284,501,425,283,501,424,,,1,0,1,,,,,,
285,502,448,284,502,448,,,1,0,0,,,,,,
285,502,472,285,502,472,,,0,0,0,,,,,,
286,503,497,286,503,497,,,0,0,0,,,,,,
287,503,521,286,503,521,,,1,0,0,,,,,,
288,504,545,287,504,545,,,1,0,0,,,,,,
289,504,570,288,504,570,,,1,0,0,,,,,,
290,505,595,289,505,595,,,1,0,0,,,,,,
291,505,620,290,505,619,,,1,0,1,,,,,,
292,506,644,292,506,644,,,0,0,0,,,,,,
293,507,669,293,506,669,,,0,1,0,,,,,,
295,507,694,294,507,694,,,1,0,0,,,,,,
296,508,719,295,508,719,,,1,0,0,,,,,,
297,509,745,297,509,745,,,0,0,0,,,,,,
299,510,770,298,510,770,,,1,0,0,,,,,,
294,527,141,294,527,141,,,0,0,0,,,,,,
294,527,142,294,527,141,,,0,0,1,,,,,,
294,527,146,294,527,146,,,0,0,0,,,,,,
294,527,154,294,527,155,,,0,0,-1,,,,,,
294,527,164,294,527,164,,,0,0,0,,,,,,
295,527,178,294,527,178,,,1,0,0,,,,,,
295,527,193,294,527,193,,,1,0,0,,,,,,
295,527,210,294,527,210,,,1,0,0,,,,,,
295,528,229,295,527,228,,,0,1,1,,,,,,
296,528,248,295,527,248,,,1,1,0,,,,,,
296,528,269,295,528,269,,,1,0,0,,,,,,
296,528,290,295,528,290,,,1,0,0,,,,,,
297,528,312,296,528,312,,,1,0,0,,,,,,
297,529,334,296,528,334,,,1,1,0,,,,,,
298,529,357,297,529,357,,,1,0,0,,,,,,
298,529,380,297,529,380,,,1,0,0,,,,,,
299,530,403,298,529,403,,,1,1,0,,,,,,
300,530,427,298,530,427,,,2,0,0,,,,,,
300,530,450,299,530,450,,,1,0,0,,,,,,
301,531,474,300,531,474,,,1,0,0,,,,,,
302,531,499,301,531,498,,,1,0,1,,,,,,
303,532,523,302,532,522,,,1,0,1,,,,,,
303,532,547,302,532,547,,,1,0,0,,,,,,
304,533,572,303,533,571,,,1,0,1,,,,,,
305,533,596,304,533,596,,,1,0,0,,,,,,
306,534,621,305,534,621,,,1,0,0,,,,,,
308,534,646,307,534,645,,,1,0,1,,,,,,
309,535,671,308,535,670,,,1,0,1,,,,,,
310,536,696,309,535,695,,,1,1,1,,,,,,
311,536,721,310,536,720,,,1,0,1,,,,,,
312,537,746,312,537,746,,,0,0,0,,,,,,
314,538,771,313,538,771,,,1,0,0,,,,,,
310,556,149,310,556,149,,,0,0,0,,,,,,
310,556,150,310,556,149,,,0,0,1,,,,,,
310,556,154,310,556,154,,,0,0,0,,,,,,
310,556,161,310,556,162,,,0,0,-1,,,,,,
311,556,171,310,556,171,,,1,0,0,,,,,,
311,556,184,310,556,184,,,1,0,0,,,,,,
311,556,198,310,556,198,,,1,0,0,,,,,,
311,556,215,310,556,215,,,1,0,0,,,,,,
311,557,233,311,556,233,,,0,1,0,,,,,,
312,557,253,311,556,253,,,1,1,0,,,,,,
312,557,273,311,557,273,,,1,0,0,,,,,,
312,557,294,311,557,294,,,1,0,0,,,,,,
313,557,315,312,557,315,,,1,0,0,,,,,,
313,558,337,312,557,337,,,1,1,0,,,,,,
314,558,360,313,558,360,,,1,0,0,,,,,,
314,558,382,313,558,383,,,1,0,-1,,,,,,
315,558,406,314,558,406,,,1,0,0,,,,,,
315,559,429,314,558,429,,,1,1,0,,,,,,
316,559,453,315,559,453,,,1,0,0,,,,,,
317,560,476,316,559,476,,,1,1,0,,,,,,
317,560,500,317,560,500,,,0,0,0,,,,,,
318,560,525,317,560,524,,,1,0,1,,,,,,
319,561,549,318,561,549,,,1,0,0,,,,,,
320,561,573,319,561,573,,,1,0,0,,,,,,
321,562,598,320,562,598,,,1,0,0,,,,,,
322,562,622,321,562,622,,,1,0,0,,,,,,
323,563,647,322,563,647,,,1,0,0,,,,,,
324,564,672,323,563,672,,,1,1,0,,,,,,
325,564,697,324,564,697,,,1,0,0,,,,,,
326,565,722,325,565,722,,,1,0,0,,,,,,
327,566,747,327,566,747,,,0,0,0,,,,,,
329,566,772,328,566,772,,,1,0,0,,,,,,
326,585,156,326,585,156,,,0,0,0,,,,,,
326,585,157,326,585,156,,,0,0,1,,,,,,
326,585,161,326,585,161,,,0,0,0,,,,,,
327,585,168,326,585,169,,,1,0,-1,,,,,,
327,585,178,326,585,177,,,1,0,1,,,,,,
327,585,190,326,585,190,,,1,0,0,,,,,,
327,585,204,326,585,204,,,1,0,0,,,,,,
327,585,220,326,585,221,,,1,0,-1,,,,,,
327,585,238,327,585,238,,,0,0,0,,,,,,
328,586,257,327,585,257,,,1,1,0,,,,,,
328,586,277,327,586,277,,,1,0,0,,,,,,
328,586,297,327,586,297,,,1,0,0,,,,,,
329,586,319,328,586,318,,,1,0,1,,,,,,
329,586,340,328,586,340,,,1,0,0,,,,,,
330,587,363,329,587,363,,,1,0,0,,,,,,
330,587,385,329,587,385,,,1,0,0,,,,,,
331,587,408,330,587,408,,,1,0,0,,,,,,
331,588,431,330,587,431,,,1,1,0,,,,,,
332,588,455,331,588,455,,,1,0,0,,,,,,
332,588,479,331,588,478,,,1,0,1,,,,,,
333,589,503,332,589,502,,,1,0,1,,,,,,
334,589,527,333,589,526,,,1,0,1,,,,,,
335,590,551,334,589,551,,,1,1,0,,,,,,
336,590,575,335,590,575,,,1,0,0,,,,,,
336,591,600,336,590,599,,,0,1,1,,,,,,
337,591,624,336,591,624,,,1,0,0,,,,,,
338,592,649,337,591,648,,,1,1,1,,,,,,
339,592,673,338,592,673,,,1,0,0,,,,,,
340,593,698,339,592,698,,,1,1,0,,,,,,
341,593,723,340,593,723,,,1,0,0,,,,,,
343,594,748,342,594,748,,,1,0,0,,,,,,
344,595,773,343,595,773,,,1,0,0,,,,,,
343,614,164,342,614,164,,,1,0,0,,,,,,
343,614,165,342,614,164,,,1,0,1,,,,,,
343,614,169,342,614,169,,,1,0,0,,,,,,
343,614,175,342,614,176,,,1,0,-1,,,,,,
343,614,184,342,614,184,,,1,0,0,,,,,,
343,614,196,342,614,197,,,1,0,-1,,,,,,
343,614,210,343,614,210,,,0,0,0,,,,,,
343,614,226,343,614,226,,,0,0,0,,,,,,
343,614,243,343,614,243,,,0,0,0,,,,,,
344,615,261,343,614,262,,,1,1,-1,,,,,,
344,615,281,343,615,281,,,1,0,0,,,,,,
344,615,301,343,615,301,,,1,0,0,,,,,,
345,615,322,344,615,322,,,1,0,0,,,,,,
345,615,344,344,615,344,,,1,0,0,,,,,,
346,616,366,345,616,366,,,1,0,0,,,,,,
346,616,388,345,616,388,,,1,0,0,,,,,,
347,616,411,346,616,411,,,1,0,0,,,,,,
347,617,434,346,616,434,,,1,1,0,,,,,,
348,617,457,347,617,457,,,1,0,0,,,,,,
348,617,481,347,617,481,,,1,0,0,,,,,,
349,618,505,348,618,505,,,1,0,0,,,,,,
350,618,529,349,618,529,,,1,0,0,,,,,,
350,618,553,350,618,553,,,0,0,0,,,,,,
351,619,577,351,618,577,,,0,1,0,,,,,,
352,619,601,352,619,601,,,0,0,0,,,,,,
353,620,626,352,619,625,,,1,1,1,,,,,,
354,620,650,353,620,650,,,1,0,0,,,,,,
355,621,675,354,620,675,,,1,1,0,,,,,,
356,621,700,355,621,700,,,1,0,0,,,,,,
357,622,725,356,622,725,,,1,0,0,,,,,,
358,623,750,357,623,750,,,1,0,0,,,,,,
359,623,775,358,623,775,,,1,0,0,,,,,,
359,643,172,358,643,172,,,1,0,0,,,,,,
359,643,173,358,643,172,,,1,0,1,,,,,,
359,643,176,358,643,176,,,1,0,0,,,,,,
359,643,182,358,643,183,,,1,0,-1,,,,,,
359,643,191,358,643,191,,,1,0,0,,,,,,
359,643,202,358,643,203,,,1,0,-1,,,,,,
359,643,216,359,643,216,,,0,0,0,,,,,,
359,643,231,359,643,232,,,0,0,-1,,,,,,
360,644,248,359,643,248,,,1,1,0,,,,,,
360,644,266,359,643,266,,,1,1,0,,,,,,
360,644,285,359,644,285,,,1,0,0,,,,,,
360,644,305,359,644,305,,,1,0,0,,,,,,
361,644,326,360,644,326,,,1,0,0,,,,,,
361,644,347,360,644,347,,,1,0,0,,,,,,
362,645,369,361,645,369,,,1,0,0,,,,,,
362,645,391,361,645,391,,,1,0,0,,,,,,
362,645,414,362,645,414,,,0,0,0,,,,,,
363,645,437,362,645,437,,,1,0,0,,,,,,
364,646,460,363,646,460,,,1,0,0,,,,,,
364,646,483,363,646,483,,,1,0,0,,,,,,
365,646,507,364,646,507,,,1,0,0,,,,,,
366,647,531,365,646,531,,,1,1,0,,,,,,
366,647,555,366,647,555,,,0,0,0,,,,,,
367,648,579,366,647,579,,,1,1,0,,,,,,
368,648,603,367,648,603,,,1,0,0,,,,,,
369,649,628,368,648,627,,,1,1,1,,,,,,
370,649,652,369,649,652,,,1,0,0,,,,,,
370,650,677,370,649,676,,,0,1,1,,,,,,
371,650,701,371,650,701,,,0,0,0,,,,,,
372,651,726,371,650,726,,,1,1,0,,,,,,
373,651,751,372,651,751,,,1,0,0,,,,,,
374,652,776,374,652,776,,,0,0,0,,,,,,
375,672,180,375,672,180,,,0,0,0,,,,,,
375,672,181,375,672,180,,,0,0,1,,,,,,
375,672,184,375,672,184,,,0,0,0,,,,,,
375,672,190,375,672,191,,,0,0,-1,,,,,,
375,672,198,375,672,198,,,0,0,0,,,,,,
375,672,209,375,672,210,,,0,0,-1,,,,,,
375,673,222,375,672,222,,,0,1,0,,,,,,
376,673,237,375,672,237,,,1,1,0,,,,,,
376,673,253,375,673,253,,,1,0,0,,,,,,
376,673,271,375,673,271,,,1,0,0,,,,,,
376,673,290,376,673,290,,,0,0,0,,,,,,
377,673,309,376,673,310,,,1,0,-1,,,,,,
377,673,330,376,673,330,,,1,0,0,,,,,,
377,674,351,376,673,351,,,1,1,0,,,,,,
378,674,372,377,674,372,,,1,0,0,,,,,,
378,674,394,377,674,394,,,1,0,0,,,,,,
379,674,417,378,674,417,,,1,0,0,,,,,,
379,675,440,378,674,440,,,1,1,0,,,,,,
380,675,463,379,675,463,,,1,0,0,,,,,,
380,675,486,379,675,486,,,1,0,0,,,,,,
381,675,509,380,675,509,,,1,0,0,,,,,,
381,676,533,381,675,533,,,0,1,0,,,,,,
382,676,557,382,676,557,,,0,0,0,,,,,,
383,677,581,382,676,581,,,1,1,0,,,,,,
384,677,605,383,677,605,,,1,0,0,,,,,,
384,678,629,384,677,629,,,0,1,0,,,,,,
385,678,654,385,678,654,,,0,0,0,,,,,,
386,678,678,386,678,678,,,0,0,0,,,,,,
387,679,703,387,679,703,,,0,0,0,,,,,,
388,680,728,387,679,728,,,1,1,0,,,,,,
389,680,753,388,680,753,,,1,0,0,,,,,,
390,681,778,389,680,778,,,1,1,0,,,,,,
391,701,187,391,701,187,,,0,0,0,,,,,,
391,701,188,391,701,187,,,0,0,1,,,,,,
391,702,191,391,701,191,,,0,1,0,,,,,,
391,702,197,391,701,198,,,0,1,-1,,,,,,
391,702,205,391,701,205,,,0,1,0,,,,,,
391,702,216,391,701,216,,,0,1,0,,,,,,
392,702,228,391,701,228,,,1,1,0,,,,,,
392,702,243,391,701,243,,,1,1,0,,,,,,
392,702,259,391,702,258,,,1,0,1,,,,,,
392,702,276,391,702,276,,,1,0,0,,,,,,
392,702,294,392,702,294,,,0,0,0,,,,,,
393,702,314,392,702,314,,,1,0,0,,,,,,
393,702,334,392,702,334,,,1,0,0,,,,,,
393,703,355,392,702,355,,,1,1,0,,,,,,
394,703,376,393,703,376,,,1,0,0,,,,,,
394,703,398,393,703,398,,,1,0,0,,,,,,
395,703,420,394,703,420,,,1,0,0,,,,,,
395,704,442,394,703,442,,,1,1,0,,,,,,
396,704,465,395,704,465,,,1,0,0,,,,,,
396,704,488,395,704,488,,,1,0,0,,,,,,
397,705,512,396,704,511,,,1,1,1,,,,,,
397,705,535,397,704,535,,,0,1,0,,,,,,
398,705,559,398,705,559,,,0,0,0,,,,,,
399,706,583,398,705,583,,,1,1,0,,,,,,
399,706,607,399,706,607,,,0,0,0,,,,,,
400,706,631,399,706,631,,,1,0,0,,,,,,
401,707,656,400,707,656,,,1,0,0,,,,,,
402,707,680,401,707,680,,,1,0,0,,,,,,
403,708,705,402,708,705,,,1,0,0,,,,,,
404,708,730,403,708,729,,,1,0,1,,,,,,
405,709,754,404,709,754,,,1,0,0,,,,,,
406,709,779,405,709,779,,,1,0,0,,,,,,
408,731,195,407,731,195,,,1,0,0,,,,,,
408,731,196,407,731,195,,,1,0,1,,,,,,
408,731,199,407,731,199,,,1,0,0,,,,,,
408,731,204,407,731,205,,,1,0,-1,,,,,,
408,731,212,407,731,212,,,1,0,0,,,,,,
408,731,222,407,731,223,,,1,0,-1,,,,,,
408,731,235,407,731,235,,,1,0,0,,,,,,
408,731,249,407,731,249,,,1,0,0,,,,,,
408,731,264,408,731,264,,,0,0,0,,,,,,
408,731,281,408,731,281,,,0,0,0,,,,,,
409,731,299,408,731,299,,,1,0,0,,,,,,
409,732,318,408,731,318,,,1,1,0,,,,,,
409,732,338,409,732,338,,,0,0,0,,,,,,
410,732,358,409,732,359,,,1,0,-1,,,,,,
410,732,380,409,732,380,,,1,0,0,,,,,,
410,732,401,409,732,401,,,1,0,0,,,,,,
411,733,423,410,733,423,,,1,0,0,,,,,,
411,733,446,410,733,445,,,1,0,1,,,,,,
412,733,468,411,733,468,,,1,0,0,,,,,,
412,733,491,411,733,491,,,1,0,0,,,,,,
413,734,514,412,734,514,,,1,0,0,,,,,,
413,734,538,413,734,538,,,0,0,0,,,,,,
414,734,562,414,734,562,,,0,0,0,,,,,,
415,735,585,414,734,585,,,1,1,0,,,,,,
415,735,609,415,735,609,,,0,0,0,,,,,,
416,736,633,415,735,633,,,1,1,0,,,,,,
417,736,658,416,736,658,,,1,0,0,,,,,,
418,736,682,417,736,682,,,1,0,0,,,,,,
419,737,707,418,737,707,,,1,0,0,,,,,,
419,737,731,419,737,731,,,0,0,0,,,,,,
420,738,756,420,738,756,,,0,0,0,,,,,,
421,738,781,421,738,781,,,0,0,0,,,,,,
424,760,203,423,760,203,,,1,0,0,,,,,,
424,760,204,423,760,203,,,1,0,1,,,,,,
424,760,207,423,760,206,,,1,0,1,,,,,,
424,760,212,423,760,213,,,1,0,-1,,,,,,
424,760,219,423,760,219,,,1,0,0,,,,,,
424,760,229,423,760,230,,,1,0,-1,,,,,,
424,760,241,423,760,241,,,1,0,0,,,,,,
424,760,255,423,760,255,,,1,0,0,,,,,,
424,760,270,424,760,270,,,0,0,0,,,,,,
425,761,286,424,760,287,,,1,1,-1,,,,,,
425,761,304,424,760,304,,,1,1,0,,,,,,
425,761,323,424,760,323,,,1,1,0,,,,,,
425,761,342,425,761,342,,,0,0,0,,,,,,
426,761,363,425,761,363,,,1,0,0,,,,,,
426,761,383,425,761,383,,,1,0,0,,,,,,
427,762,405,426,761,405,,,1,1,0,,,,,,
427,762,427,426,762,426,,,1,0,1,,,,,,
427,762,449,427,762,448,,,0,0,1,,,,,,
428,762,471,427,762,471,,,1,0,0,,,,,,
428,763,494,428,762,494,,,0,1,0,,,,,,
429,763,517,428,763,517,,,1,0,0,,,,,,
429,763,540,429,763,540,,,0,0,0,,,,,,
430,763,564,430,763,564,,,0,0,0,,,,,,
431,764,588,430,763,588,,,1,1,0,,,,,,
431,764,612,431,764,611,,,0,0,1,,,,,,
432,765,636,431,764,635,,,1,1,1,,,,,,
433,765,660,432,765,660,,,1,0,0,,,,,,
434,765,684,433,765,684,,,1,0,0,,,,,,
434,766,709,434,766,709,,,0,0,0,,,,,,
435,766,733,435,766,733,,,0,0,0,,,,,,
436,767,758,436,767,758,,,0,0,0,,,,,,
437,767,782,436,767,782,,,1,0,0,,,,,,
440,789,211,440,789,211,,,0,0,0,,,,,,
440,789,212,440,789,211,,,0,0,1,,,,,,
440,789,214,440,789,214,,,0,0,0,,,,,,
440,789,219,440,789,220,,,0,0,-1,,,,,,
440,789,227,440,789,227,,,0,0,0,,,,,,
440,790,236,440,789,237,,,0,1,-1,,,,,,
440,790,248,440,790,248,,,0,0,0,,,,,,
441,790,261,440,790,262,,,1,0,-1,,,,,,
441,790,276,440,790,276,,,1,0,0,,,,,,
441,790,292,440,790,292,,,1,0,0,,,,,,
441,790,309,441,790,309,,,0,0,0,,,,,,
441,790,328,441,790,328,,,0,0,0,,,,,,
442,790,347,441,790,347,,,1,0,0,,,,,,
442,790,367,441,790,367,,,1,0,0,,,,,,
442,791,387,442,791,387,,,0,0,0,,,,,,
443,791,408,442,791,408,,,1,0,0,,,,,,
443,791,430,443,791,430,,,0,0,0,,,,,,
444,791,452,443,791,452,,,1,0,0,,,,,,
444,792,474,444,791,474,,,0,1,0,,,,,,
444,792,497,444,791,497,,,0,1,0,,,,,,
445,792,520,445,792,520,,,0,0,0,,,,,,
446,792,543,445,792,543,,,1,0,0,,,,,,
446,793,567,446,793,567,,,0,0,0,,,,,,
447,793,590,446,793,590,,,1,0,0,,,,,,
447,793,614,447,793,614,,,0,0,0,,,,,,
448,794,638,447,793,638,,,1,1,0,,,,,,
449,794,662,448,794,662,,,1,0,0,,,,,,
449,795,686,449,794,686,,,0,1,0,,,,,,
450,795,711,450,795,711,,,0,0,0,,,,,,
451,795,735,451,795,735,,,0,0,0,,,,,,
452,796,760,452,796,760,,,0,0,0,,,,,,
453,796,784,452,796,784,,,1,0,0,,,,,,
456,819,219,456,818,219,,,0,1,0,,,,,,
457,819,219,456,818,219,,,1,1,0,,,,,,
457,819,222,456,818,222,,,1,1,0,,,,,,
457,819,227,456,818,228,,,1,1,-1,,,,,,
457,819,234,456,818,234,,,1,1,0,,,,,,
457,819,243,456,818,244,,,1,1,-1,,,,,,
457,819,254,456,819,254,,,1,0,0,,,,,,
457,819,267,456,819,268,,,1,0,-1,,,,,,
457,819,281,456,819,281,,,1,0,0,,,,,,
457,819,297,456,819,298,,,1,0,-1,,,,,,
458,819,314,457,819,314,,,1,0,0,,,,,,
458,819,332,457,819,333,,,1,0,-1,,,,,,
458,820,351,457,819,351,,,1,1,0,,,,,,
458,820,371,458,819,371,,,0,1,0,,,,,,
459,820,391,458,820,391,,,1,0,0,,,,,,
459,820,412,458,820,412,,,1,0,0,,,,,,
459,820,434,459,820,433,,,0,0,1,,,,,,
460,821,455,459,820,455,,,1,1,0,,,,,,
460,821,478,460,820,477,,,0,1,1,,,,,,
461,821,500,460,821,500,,,1,0,0,,,,,,
461,821,523,461,821,523,,,0,0,0,,,,,,
462,822,546,461,821,546,,,1,1,0,,,,,,
462,822,569,462,822,569,,,0,0,0,,,,,,
463,822,593,462,822,593,,,1,0,0,,,,,,
463,823,616,463,822,616,,,0,1,0,,,,,,
464,823,640,463,823,640,,,1,0,0,,,,,,
465,823,664,464,823,664,,,1,0,0,,,,,,
465,824,688,465,823,688,,,0,1,0,,,,,,
466,824,713,466,824,713,,,0,0,0,,,,,,
467,825,737,466,824,737,,,1,1,0,,,,,,
468,825,761,467,825,761,,,1,0,0,,,,,,
469,826,786,468,825,786,,,1,1,0,,,,,,
473,848,227,473,848,227,,,0,0,0,,,,,,
473,848,227,473,848,227,,,0,0,0,,,,,,
473,848,230,473,848,230,,,0,0,0,,,,,,
473,848,234,473,848,235,,,0,0,-1,,,,,,
473,848,241,473,848,241,,,0,0,0,,,,,,
473,848,250,473,848,251,,,0,0,-1,,,,,,
473,848,261,473,848,261,,,0,0,0,,,,,,
473,848,273,473,848,274,,,0,0,-1,,,,,,
473,849,287,473,849,287,,,0,0,0,,,,,,
474,849,303,473,849,303,,,1,0,0,,,,,,
474,849,320,473,849,320,,,1,0,0,,,,,,
474,849,337,473,849,338,,,1,0,-1,,,,,,
474,849,356,474,849,356,,,0,0,0,,,,,,
475,849,375,474,849,375,,,1,0,0,,,,,,
475,849,395,475,849,395,,,0,0,0,,,,,,
475,850,416,475,849,416,,,0,1,0,,,,,,
476,850,437,475,850,437,,,1,0,0,,,,,,
476,850,459,475,850,459,,,1,0,0,,,,,,
476,850,481,476,850,481,,,0,0,0,,,,,,
477,850,503,476,850,503,,,1,0,0,,,,,,
477,851,526,477,851,526,,,0,0,0,,,,,,
478,851,549,477,851,549,,,1,0,0,,,,,,
478,851,572,478,851,572,,,0,0,0,,,,,,
479,852,595,478,851,595,,,1,1,0,,,,,,
480,852,619,479,852,619,,,1,0,0,,,,,,
480,852,643,479,852,643,,,1,0,0,,,,,,
481,853,667,480,853,667,,,1,0,0,,,,,,
482,853,691,481,853,691,,,1,0,0,,,,,,
482,853,715,482,853,715,,,0,0,0,,,,,,
483,854,739,482,853,739,,,1,1,0,,,,,,
484,854,763,483,854,763,,,1,0,0,,,,,,
485,855,788,484,854,788,,,1,1,0,,,,,,
489,878,235,489,877,234,,,0,1,1,,,,,,
489,878,235,489,877,234,,,0,1,1,,,,,,
489,878,238,489,877,237,,,0,1,1,,,,,,
489,878,242,489,877,243,,,0,1,-1,,,,,,
489,878,249,489,877,248,,,0,1,1,,,,,,
489,878,257,489,877,258,,,0,1,-1,,,,,,
490,878,268,489,877,267,,,1,1,1,,,,,,
490,878,280,489,877,280,,,1,1,0,,,,,,
490,878,294,489,878,293,,,1,0,1,,,,,,
490,878,309,489,878,309,,,1,0,0,,,,,,
490,878,325,489,878,325,,,1,0,0,,,,,,
490,878,342,490,878,343,,,0,0,-1,,,,,,
491,878,361,490,878,361,,,1,0,0,,,,,,
491,879,380,490,878,380,,,1,1,0,,,,,,
491,879,400,491,878,399,,,0,1,1,,,,,,
492,879,420,491,879,420,,,1,0,0,,,,,,
492,879,441,491,879,441,,,1,0,0,,,,,,
492,879,463,492,879,462,,,0,0,1,,,,,,
493,880,484,492,879,484,,,1,1,0,,,,,,
493,880,507,493,879,506,,,0,1,1,,,,,,
494,880,529,493,880,529,,,1,0,0,,,,,,
494,880,552,493,880,552,,,1,0,0,,,,,,
495,881,575,494,880,575,,,1,1,0,,,,,,
495,881,598,494,881,598,,,1,0,0,,,,,,
496,881,622,495,881,621,,,1,0,1,,,,,,
496,882,645,496,881,645,,,0,1,0,,,,,,
497,882,669,496,882,669,,,1,0,0,,,,,,
498,882,693,497,882,693,,,1,0,0,,,,,,
498,883,717,498,882,717,,,0,1,0,,,,,,
499,883,741,498,883,741,,,1,0,0,,,,,,
500,883,766,499,883,765,,,1,0,1,,,,,,
501,884,790,500,884,790,,,1,0,0,,,,,,
48,13,7,48,13,7,,,0,0,0,,,,,,
48,14,22,48,13,7,,,0,1,15,,,,,,
48,15,44,48,15,44,,,0,0,0,,,,,,
49,17,67,48,17,67,,,1,0,0,,,,,,
49,19,90,49,19,90,,,0,0,0,,,,,,
50,22,114,50,22,113,,,0,0,1,,,,,,
52,25,137,52,25,137,,,0,0,0,,,,,,
53,28,161,53,28,161,,,0,0,0,,,,,,
55,32,185,55,32,185,,,0,0,0,,,,,,
57,35,210,57,35,209,,,0,0,1,,,,,,
59,39,234,59,39,234,,,0,0,0,,,,,,
61,43,258,61,42,258,,,0,1,0,,,,,,
64,46,283,64,46,283,,,0,0,0,,,,,,
66,50,308,66,50,307,,,0,0,1,,,,,,
69,54,332,69,54,332,,,0,0,0,,,,,,
72,58,357,72,58,357,,,0,0,0,,,,,,
75,62,382,75,62,382,,,0,0,0,,,,,,
78,66,407,78,66,407,,,0,0,0,,,,,,
81,70,432,81,70,432,,,0,0,0,,,,,,
84,73,457,84,73,457,,,0,0,0,,,,,,
87,77,482,87,77,482,,,0,0,0,,,,,,
91,81,507,90,81,507,,,1,0,0,,,,,,
94,85,532,94,85,532,,,0,0,0,,,,,,
97,89,557,97,89,557,,,0,0,0,,,,,,
101,93,583,101,93,583,,,0,0,0,,,,,,
104,97,608,104,97,608,,,0,0,0,,,,,,
108,101,633,108,101,633,,,0,0,0,,,,,,
111,105,659,111,105,658,,,0,0,1,,,,,,
115,109,684,115,109,684,,,0,0,0,,,,,,
118,113,710,118,113,709,,,0,0,1,,,,,,
122,117,735,122,117,735,,,0,0,0,,,,,,
126,121,761,125,121,760,,,1,0,1,,,,,,
49,27,9,48,13,7,,,1,14,2,,,,,,
49,27,22,48,13,7,,,1,14,15,,,,,,
50,28,44,48,15,44,,,2,13,0,,,,,,
50,29,67,48,17,67,,,2,12,0,,,,,,
51,30,90,49,19,90,,,2,11,0,,,,,,
52,32,114,50,22,113,,,2,10,1,,,,,,
53,34,137,52,25,137,,,1,9,0,,,,,,
55,36,161,53,28,161,,,2,8,0,,,,,,
56,39,185,55,32,185,,,1,7,0,,,,,,
58,42,210,57,35,209,,,1,7,1,,,,,,
60,45,234,59,39,234,,,1,6,0,,,,,,
62,48,258,61,42,258,,,1,6,0,,,,,,
65,52,283,64,46,283,,,1,6,0,,,,,,
67,55,308,66,50,307,,,1,5,1,,,,,,
70,58,332,69,54,332,,,1,4,0,,,,,,
73,62,357,72,58,357,,,1,4,0,,,,,,
76,66,382,75,62,382,,,1,4,0,,,,,,
79,69,407,78,66,407,,,1,3,0,,,,,,
82,73,432,81,70,432,,,1,3,0,,,,,,
85,77,457,84,73,457,,,1,4,0,,,,,,
88,80,482,87,77,482,,,1,3,0,,,,,,
91,84,507,90,81,507,,,1,3,0,,,,,,
95,88,532,94,85,532,,,1,3,0,,,,,,
98,92,558,97,89,557,,,1,3,1,,,,,,
101,96,583,101,93,583,,,0,3,0,,,,,,
105,100,608,104,97,608,,,1,3,0,,,,,,
108,103,633,108,101,633,,,0,2,0,,,,,,
112,107,659,111,105,658,,,1,2,1,,,,,,
115,111,684,115,109,684,,,0,2,0,,,,,,
119,115,710,118,113,709,,,1,2,1,,,,,,
123,119,735,122,117,735,,,1,2,0,,,,,,
126,123,761,125,121,760,,,1,2,1,,,,,,
54,51,15,54,51,15,,,0,0,0,,,,,,
55,51,25,54,51,15,,,1,0,10,,,,,,
55,52,45,55,52,45,,,0,0,0,,,,,,
55,52,68,55,52,68,,,0,0,0,,,,,,
56,53,91,56,53,91,,,0,0,0,,,,,,
57,54,114,57,54,114,,,0,0,0,,,,,,
58,55,138,58,55,138,,,0,0,0,,,,,,
59,57,162,59,56,162,,,0,1,0,,,,,,
61,58,186,61,58,186,,,0,0,0,,,,,,
62,60,210,62,60,210,,,0,0,0,,,,,,
64,62,234,64,62,234,,,0,0,0,,,,,,
66,65,259,66,64,258,,,0,1,1,,,,,,
69,67,283,69,67,283,,,0,0,0,,,,,,
71,70,308,71,69,308,,,0,1,0,,,,,,
74,72,333,74,72,333,,,0,0,0,,,,,,
76,75,357,76,75,357,,,0,0,0,,,,,,
79,78,382,79,78,382,,,0,0,0,,,,,,
82,81,407,82,81,407,,,0,0,0,,,,,,
85,84,432,85,84,432,,,0,0,0,,,,,,
88,87,457,88,87,457,,,0,0,0,,,,,,
91,91,482,91,91,482,,,0,0,0,,,,,,
94,94,507,94,94,507,,,0,0,0,,,,,,
97,97,532,97,97,532,,,0,0,0,,,,,,
100,101,558,100,100,557,,,0,1,1,,,,,,
104,104,583,104,104,583,,,0,0,0,,,,,,
107,108,608,107,107,608,,,0,1,0,,,,,,
111,111,634,111,111,634,,,0,0,0,,,,,,
114,115,659,114,115,659,,,0,0,0,,,,,,
118,119,684,118,119,684,,,0,0,0,,,,,,
121,122,710,121,122,709,,,0,0,1,,,,,,
125,126,735,125,126,735,,,0,0,0,,,,,,
128,130,761,128,129,760,,,0,1,1,,,,,,
63,77,21,64,77,21,,,-1,0,0,,,,,,
63,77,29,64,77,21,,,-1,0,8,,,,,,
63,78,48,64,78,48,,,-1,0,0,,,,,,
64,78,69,65,78,70,,,-1,0,-1,,,,,,
64,78,92,65,79,92,,,-1,-1,0,,,,,,
65,79,115,66,79,115,,,-1,0,0,,,,,,
66,80,138,67,80,138,,,-1,0,0,,,,,,
67,81,162,68,81,162,,,-1,0,0,,,,,,
68,82,186,69,82,186,,,-1,0,0,,,,,,
70,83,210,71,84,210,,,-1,-1,0,,,,,,
71,85,235,72,86,234,,,-1,-1,1,,,,,,
73,86,259,74,87,259,,,-1,-1,0,,,,,,
75,88,284,76,89,283,,,-1,-1,1,,,,,,
78,90,308,78,91,308,,,0,-1,0,,,,,,
80,92,333,81,93,333,,,-1,-1,0,,,,,,
82,94,358,83,96,357,,,-1,-2,1,,,,,,
85,97,382,86,98,382,,,-1,-1,0,,,,,,
87,99,407,88,101,407,,,-1,-2,0,,,,,,
90,101,432,91,103,432,,,-1,-2,0,,,,,,
93,104,457,94,106,457,,,-1,-2,0,,,,,,
96,107,482,97,109,482,,,-1,-2,0,,,,,,
99,110,507,99,111,507,,,0,-1,0,,,,,,
102,112,533,102,114,532,,,0,-2,1,,,,,,
105,115,558,105,117,557,,,0,-2,1,,,,,,
108,118,583,109,120,583,,,-1,-2,0,,,,,,
111,122,608,112,123,608,,,-1,-1,0,,,,,,
115,125,634,115,126,634,,,0,-1,0,,,,,,
118,128,659,119,130,659,,,-1,-2,0,,,,,,
121,131,684,122,133,684,,,-1,-2,0,,,,,,
125,134,710,125,136,710,,,0,-2,0,,,,,,
128,138,735,129,140,735,,,-1,-2,0,,,,,,
132,141,761,132,143,761,,,0,-2,0,,,,,,
74,104,28,74,104,28,,,0,0,0,,,,,,
74,104,35,74,104,28,,,0,0,7,,,,,,
74,104,51,74,104,51,,,0,0,0,,,,,,
74,105,71,74,104,72,,,0,1,-1,,,,,,
75,105,93,75,105,93,,,0,0,0,,,,,,
75,105,116,75,105,116,,,0,0,0,,,,,,
76,106,139,76,106,139,,,0,0,0,,,,,,
77,107,163,77,106,163,,,0,1,0,,,,,,
78,107,187,78,107,187,,,0,0,0,,,,,,
79,108,211,79,108,211,,,0,0,0,,,,,,
81,110,235,81,110,235,,,0,0,0,,,,,,
83,111,260,82,111,259,,,1,0,1,,,,,,
84,112,284,84,112,284,,,0,0,0,,,,,,
86,114,309,86,113,308,,,0,1,1,,,,,,
88,115,333,88,115,333,,,0,0,0,,,,,,
90,117,358,90,117,358,,,0,0,0,,,,,,
93,119,383,93,119,383,,,0,0,0,,,,,,
95,121,408,95,121,407,,,0,0,1,,,,,,
98,123,432,98,123,432,,,0,0,0,,,,,,
100,125,457,100,125,457,,,0,0,0,,,,,,
103,127,482,103,127,482,,,0,0,0,,,,,,
106,129,508,105,129,507,,,1,0,1,,,,,,
108,132,533,108,132,533,,,0,0,0,,,,,,
111,134,558,111,134,558,,,0,0,0,,,,,,
114,137,583,114,137,583,,,0,0,0,,,,,,
117,139,608,117,139,608,,,0,0,0,,,,,,
120,142,634,120,142,634,,,0,0,0,,,,,,
124,145,659,123,145,659,,,1,0,0,,,,,,
127,148,685,127,148,685,,,0,0,0,,,,,,
130,151,710,130,151,710,,,0,0,0,,,,,,
133,154,736,133,154,736,,,0,0,0,,,,,,
137,157,761,136,157,761,,,1,0,0,,,,,,
86,131,36,86,131,35,,,0,0,1,,,,,,
86,131,40,86,131,35,,,0,0,5,,,,,,
86,131,55,86,131,55,,,0,0,0,,,,,,
86,132,74,87,131,75,,,-1,1,-1,,,,,,
87,132,95,87,132,95,,,0,0,0,,,,,,
87,132,118,88,132,118,,,-1,0,0,,,,,,
88,133,141,88,133,141,,,0,0,0,,,,,,
89,133,164,89,133,164,,,0,0,0,,,,,,
90,134,188,90,134,188,,,0,0,0,,,,,,
91,135,212,91,135,212,,,0,0,0,,,,,,
92,135,236,92,136,236,,,0,-1,0,,,,,,
93,136,260,94,137,260,,,-1,-1,0,,,,,,
95,138,285,95,138,284,,,0,0,1,,,,,,
97,139,309,97,139,309,,,0,0,0,,,,,,
98,140,334,99,140,333,,,-1,0,1,,,,,,
100,141,358,101,142,358,,,-1,-1,0,,,,,,
102,143,383,103,143,383,,,-1,0,0,,,,,,
105,144,408,105,145,408,,,0,-1,0,,,,,,
107,146,433,107,147,432,,,0,-1,1,,,,,,
109,148,458,110,148,457,,,-1,0,1,,,,,,
112,150,483,112,150,482,,,0,0,1,,,,,,
114,152,508,114,152,507,,,0,0,1,,,,,,
117,154,533,117,154,533,,,0,0,0,,,,,,
119,156,558,119,156,558,,,0,0,0,,,,,,
122,158,583,122,159,583,,,0,-1,0,,,,,,
125,160,609,125,161,608,,,0,-1,1,,,,,,
128,162,634,128,163,634,,,0,-1,0,,,,,,
131,165,659,131,166,659,,,0,-1,0,,,,,,
134,167,685,134,168,685,,,0,-1,0,,,,,,
137,170,710,137,171,710,,,0,-1,0,,,,,,
140,172,736,140,174,736,,,0,-2,0,,,,,,
143,175,761,143,176,761,,,0,-1,0,,,,,,
99,159,43,99,159,43,,,0,0,0,,,,,,
99,159,47,99,159,43,,,0,0,4,,,,,,
99,159,60,99,159,60,,,0,0,0,,,,,,
99,159,78,99,159,79,,,0,0,-1,,,,,,
100,159,98,100,159,98,,,0,0,0,,,,,,
100,159,120,100,159,120,,,0,0,0,,,,,,
101,160,143,101,160,143,,,0,0,0,,,,,,
101,160,166,101,160,166,,,0,0,0,,,,,,
102,161,189,102,161,189,,,0,0,0,,,,,,
103,161,213,103,161,213,,,0,0,0,,,,,,
104,162,237,104,162,237,,,0,0,0,,,,,,
106,163,261,105,163,261,,,1,0,0,,,,,,
107,164,285,107,164,285,,,0,0,0,,,,,,
108,165,310,108,165,309,,,0,0,1,,,,,,
110,166,334,110,166,334,,,0,0,0,,,,,,
112,167,359,111,167,359,,,1,0,0,,,,,,
113,168,384,113,168,384,,,0,0,0,,,,,,
115,169,408,115,169,408,,,0,0,0,,,,,,
117,171,433,117,171,433,,,0,0,0,,,,,,
119,172,458,119,172,458,,,0,0,0,,,,,,
122,174,483,122,174,483,,,0,0,0,,,,,,
124,176,508,124,175,508,,,0,1,0,,,,,,
126,177,533,126,177,533,,,0,0,0,,,,,,
129,179,559,128,179,558,,,1,0,1,,,,,,
131,181,584,131,181,584,,,0,0,0,,,,,,
134,183,609,134,183,609,,,0,0,0,,,,,,
137,185,634,137,185,634,,,0,0,0,,,,,,
139,187,660,139,187,659,,,0,0,1,,,,,,
142,189,685,142,189,685,,,0,0,0,,,,,,
145,191,711,145,191,710,,,0,0,1,,,,,,
148,194,736,148,194,736,,,0,0,0,,,,,,
151,196,762,151,196,761,,,0,0,1,,,,,,
113,186,50,113,186,50,,,0,0,0,,,,,,
113,186,54,113,186,50,,,0,0,4,,,,,,
113,186,65,113,186,65,,,0,0,0,,,,,,
113,186,82,113,186,83,,,0,0,-1,,,,,,
113,187,101,114,186,101,,,-1,1,0,,,,,,
114,187,122,114,187,123,,,0,0,-1,,,,,,
114,187,145,114,187,145,,,0,0,0,,,,,,
115,188,167,115,188,168,,,0,0,-1,,,,,,
116,188,191,116,188,191,,,0,0,0,,,,,,
116,189,214,116,189,214,,,0,0,0,,,,,,
117,189,238,117,189,238,,,0,0,0,,,,,,
118,190,262,118,190,262,,,0,0,0,,,,,,
120,191,286,120,191,286,,,0,0,0,,,,,,
121,191,311,121,191,310,,,0,0,1,,,,,,
122,192,335,123,192,335,,,-1,0,0,,,,,,
124,193,360,124,193,359,,,0,0,1,,,,,,
126,194,384,125,194,384,,,1,0,0,,,,,,
127,195,409,127,195,409,,,0,0,0,,,,,,
129,197,434,129,197,434,,,0,0,0,,,,,,
131,198,459,131,198,458,,,0,0,1,,,,,,
133,199,484,133,199,483,,,0,0,1,,,,,,
135,201,509,135,201,508,,,0,0,1,,,,,,
137,202,534,137,202,533,,,0,0,1,,,,,,
139,204,559,139,204,559,,,0,0,0,,,,,,
142,205,584,142,206,584,,,0,-1,0,,,,,,
144,207,610,144,207,609,,,0,0,1,,,,,,
147,209,635,147,209,634,,,0,0,1,,,,,,
149,210,660,149,211,660,,,0,-1,0,,,,,,
152,212,686,152,213,685,,,0,-1,1,,,,,,
154,214,711,154,215,711,,,0,-1,0,,,,,,
157,216,736,157,217,736,,,0,-1,0,,,,,,
160,218,762,160,219,762,,,0,-1,0,,,,,,
127,214,57,127,214,57,,,0,0,0,,,,,,
127,214,61,127,214,57,,,0,0,4,,,,,,
127,214,71,127,214,71,,,0,0,0,,,,,,
127,214,86,127,214,88,,,0,0,-2,,,,,,
128,214,105,128,214,105,,,0,0,0,,,,,,
128,215,125,128,214,126,,,0,1,-1,,,,,,
128,215,147,128,215,147,,,0,0,0,,,,,,
129,215,170,129,215,170,,,0,0,0,,,,,,
130,216,193,130,216,193,,,0,0,0,,,,,,
130,216,216,130,216,216,,,0,0,0,,,,,,
131,217,240,131,217,240,,,0,0,0,,,,,,
132,217,263,132,217,263,,,0,0,0,,,,,,
133,218,287,133,218,287,,,0,0,0,,,,,,
134,218,312,134,218,311,,,0,0,1,,,,,,
136,219,336,136,219,336,,,0,0,0,,,,,,
137,220,361,137,220,360,,,0,0,1,,,,,,
138,221,385,138,221,385,,,0,0,0,,,,,,
140,222,410,140,222,410,,,0,0,0,,,,,,
142,223,435,142,223,435,,,0,0,0,,,,,,
143,224,460,143,224,459,,,0,0,1,,,,,,
145,225,484,145,225,484,,,0,0,0,,,,,,
147,226,509,147,226,509,,,0,0,0,,,,,,
149,228,534,149,228,534,,,0,0,0,,,,,,
151,229,560,151,229,559,,,0,0,1,,,,,,
153,231,585,153,231,585,,,0,0,0,,,,,,
155,232,610,155,232,610,,,0,0,0,,,,,,
158,234,635,158,234,635,,,0,0,0,,,,,,
160,235,661,160,235,660,,,0,0,1,,,,,,
162,237,686,162,237,686,,,0,0,0,,,,,,
165,239,711,164,238,711,,,1,1,0,,,,,,
167,240,737,167,240,737,,,0,0,0,,,,,,
170,242,762,170,242,762,,,0,0,0,,,,,,
142,242,65,142,242,64,,,0,0,1,,,,,,
142,242,68,142,242,64,,,0,0,4,,,,,,
142,242,77,142,242,77,,,0,0,0,,,,,,
142,242,91,142,242,93,,,0,0,-2,,,,,,
142,242,109,142,242,109,,,0,0,0,,,,,,
142,242,129,142,242,129,,,0,0,0,,,,,,
143,243,150,143,243,150,,,0,0,0,,,,,,
143,243,172,143,243,172,,,0,0,0,,,,,,
144,243,195,144,243,195,,,0,0,0,,,,,,
145,244,218,145,244,218,,,0,0,0,,,,,,
145,244,241,145,244,241,,,0,0,0,,,,,,
146,245,265,146,245,265,,,0,0,0,,,,,,
147,245,289,147,245,288,,,0,0,1,,,,,,
148,246,313,148,246,312,,,0,0,1,,,,,,
149,247,337,149,246,337,,,0,1,0,,,,,,
150,247,362,150,247,361,,,0,0,1,,,,,,
152,248,386,152,248,386,,,0,0,0,,,,,,
153,249,411,153,249,410,,,0,0,1,,,,,,
155,250,435,155,250,435,,,0,0,0,,,,,,
156,251,460,156,251,460,,,0,0,0,,,,,,
158,252,485,158,252,485,,,0,0,0,,,,,,
160,253,510,159,253,510,,,1,0,0,,,,,,
161,254,535,161,254,535,,,0,0,0,,,,,,
163,255,560,163,255,560,,,0,0,0,,,,,,
165,256,585,165,257,585,,,0,-1,0,,,,,,
167,258,611,167,258,610,,,0,0,1,,,,,,
169,259,636,170,259,635,,,-1,0,1,,,,,,
172,261,661,172,261,661,,,0,0,0,,,,,,
174,262,686,174,262,686,,,0,0,0,,,,,,
176,264,712,176,264,712,,,0,0,0,,,,,,
178,265,737,178,265,737,,,0,0,0,,,,,,
181,267,763,181,267,763,,,0,0,0,,,,,,
157,270,72,157,270,72,,,0,0,0,,,,,,
157,270,75,157,270,72,,,0,0,3,,,,,,
157,270,83,157,270,83,,,0,0,0,,,,,,
157,270,96,157,270,98,,,0,0,-2,,,,,,
157,270,113,157,270,113,,,0,0,0,,,,,,
157,270,132,157,270,133,,,0,0,-1,,,,,,
158,271,153,158,271,153,,,0,0,0,,,,,,
158,271,175,158,271,175,,,0,0,0,,,,,,
159,271,197,159,271,197,,,0,0,0,,,,,,
159,272,220,159,271,220,,,0,1,0,,,,,,
160,272,243,160,272,243,,,0,0,0,,,,,,
161,272,267,160,272,266,,,1,0,1,,,,,,
161,273,290,161,273,290,,,0,0,0,,,,,,
162,273,314,162,273,314,,,0,0,0,,,,,,
163,274,338,163,274,338,,,0,0,0,,,,,,
164,275,363,164,274,362,,,0,1,1,,,,,,
166,275,387,166,275,387,,,0,0,0,,,,,,
167,276,412,167,276,411,,,0,0,1,,,,,,
168,277,436,168,277,436,,,0,0,0,,,,,,
170,278,461,169,278,461,,,1,0,0,,,,,,
171,279,486,171,279,486,,,0,0,0,,,,,,
173,280,511,172,280,511,,,1,0,0,,,,,,
174,281,536,174,281,536,,,0,0,0,,,,,,
176,282,561,176,282,561,,,0,0,0,,,,,,
178,283,586,178,283,586,,,0,0,0,,,,,,
180,284,611,180,284,611,,,0,0,0,,,,,,
182,285,636,182,285,636,,,0,0,0,,,,,,
184,287,662,184,286,661,,,0,1,1,,,,,,
186,288,687,186,288,687,,,0,0,0,,,,,,
188,289,712,188,289,712,,,0,0,0,,,,,,
190,291,738,190,291,738,,,0,0,0,,,,,,
192,292,763,192,292,763,,,0,0,0,,,,,,
172,298,80,172,298,79,,,0,0,1,,,,,,
172,298,82,172,298,79,,,0,0,3,,,,,,
172,298,90,172,298,89,,,0,0,1,,,,,,
172,298,102,172,298,103,,,0,0,-1,,,,,,
172,298,118,172,298,118,,,0,0,0,,,,,,
172,299,136,172,298,137,,,0,1,-1,,,,,,
173,299,156,173,299,156,,,0,0,0,,,,,,
173,299,178,173,299,178,,,0,0,0,,,,,,
173,299,199,174,299,199,,,-1,0,0,,,,,,
174,300,222,174,299,222,,,0,1,0,,,,,,
175,300,245,175,300,245,,,0,0,0,,,,,,
175,300,268,175,300,268,,,0,0,0,,,,,,
176,301,292,176,301,292,,,0,0,0,,,,,,
177,301,316,177,301,315,,,0,0,1,,,,,,
178,302,340,178,302,339,,,0,0,1,,,,,,
179,302,364,179,302,364,,,0,0,0,,,,,,
180,303,388,180,303,388,,,0,0,0,,,,,,
181,304,413,181,303,413,,,0,1,0,,,,,,
182,304,438,182,304,437,,,0,0,1,,,,,,
184,305,462,183,305,462,,,1,0,0,,,,,,
185,306,487,185,306,487,,,0,0,0,,,,,,
186,307,512,186,307,512,,,0,0,0,,,,,,
188,308,537,188,308,537,,,0,0,0,,,,,,
190,309,562,189,309,562,,,1,0,0,,,,,,
191,310,587,191,310,587,,,0,0,0,,,,,,
193,311,612,193,311,612,,,0,0,0,,,,,,
195,312,637,195,312,637,,,0,0,0,,,,,,
197,313,662,197,313,662,,,0,0,0,,,,,,
199,314,688,199,314,687,,,0,0,1,,,,,,
200,316,713,200,316,713,,,0,0,0,,,,,,
203,317,738,202,317,738,,,1,0,0,,,,,,
205,318,764,204,318,764,,,1,0,0,,,,,,
187,327,87,187,327,87,,,0,0,0,,,,,,
187,327,89,187,327,87,,,0,0,2,,,,,,
187,327,96,187,327,96,,,0,0,0,,,,,,
187,327,108,187,327,109,,,0,0,-1,,,,,,
187,327,123,187,327,123,,,0,0,0,,,,,,
187,327,141,187,327,141,,,0,0,0,,,,,,
188,327,160,188,327,160,,,0,0,0,,,,,,
188,327,181,188,327,181,,,0,0,0,,,,,,
189,328,202,189,328,202,,,0,0,0,,,,,,
189,328,225,189,328,224,,,0,0,1,,,,,,
190,328,247,190,328,247,,,0,0,0,,,,,,
190,328,270,190,328,270,,,0,0,0,,,,,,
191,329,294,191,329,294,,,0,0,0,,,,,,
192,329,318,192,329,317,,,0,0,1,,,,,,
193,330,341,193,330,341,,,0,0,0,,,,,,
193,330,366,193,330,365,,,0,0,1,,,,,,
194,331,390,194,331,390,,,0,0,0,,,,,,
196,332,414,195,331,414,,,1,1,0,,,,,,
197,332,439,197,332,439,,,0,0,0,,,,,,
198,333,463,198,333,463,,,0,0,0,,,,,,
199,334,488,199,334,488,,,0,0,0,,,,,,
200,334,513,200,334,513,,,0,0,0,,,,,,
202,335,538,202,335,538,,,0,0,0,,,,,,
203,336,563,203,336,563,,,0,0,0,,,,,,
205,337,588,205,337,588,,,0,0,0,,,,,,
206,338,613,206,338,613,,,0,0,0,,,,,,
208,339,638,208,339,638,,,0,0,0,,,,,,
210,340,663,210,340,663,,,0,0,0,,,,,,
212,341,688,212,341,688,,,0,0,0,,,,,,
213,342,714,213,342,713,,,0,0,1,,,,,,
215,344,739,215,344,739,,,0,0,0,,,,,,
217,345,764,217,345,764,,,0,0,0,,,,,,
202,355,95,202,355,95,,,0,0,0,,,,,,
202,355,97,202,355,95,,,0,0,2,,,,,,
202,355,103,202,355,103,,,0,0,0,,,,,,
202,355,114,202,355,115,,,0,0,-1,,,,,,
203,355,128,202,355,128,,,1,0,0,,,,,,
203,355,145,203,355,146,,,0,0,-1,,,,,,
203,355,164,203,355,164,,,0,0,0,,,,,,
203,356,184,203,355,184,,,0,1,0,,,,,,
204,356,205,204,356,205,,,0,0,0,,,,,,
204,356,227,204,356,227,,,0,0,0,,,,,,
205,356,250,205,356,249,,,0,0,1,,,,,,
205,357,273,205,356,272,,,0,1,1,,,,,,
206,357,296,206,357,296,,,0,0,0,,,,,,
207,358,319,207,357,319,,,0,1,0,,,,,,
207,358,343,208,358,343,,,-1,0,0,,,,,,
208,358,367,208,358,367,,,0,0,0,,,,,,
209,359,391,209,359,391,,,0,0,0,,,,,,
210,360,416,210,359,415,,,0,1,1,,,,,,
211,360,440,211,360,440,,,0,0,0,,,,,,
212,361,465,212,360,464,,,0,1,1,,,,,,
214,361,489,213,361,489,,,1,0,0,,,,,,
215,362,514,215,362,514,,,0,0,0,,,,,,
216,363,539,216,363,539,,,0,0,0,,,,,,
217,364,564,217,363,564,,,0,1,0,,,,,,
219,365,589,219,364,589,,,0,1,0,,,,,,
220,366,614,220,365,614,,,0,1,0,,,,,,
222,366,639,222,366,639,,,0,0,0,,,,,,
224,367,664,223,367,664,,,1,0,0,,,,,,
225,368,689,225,368,689,,,0,0,0,,,,,,
227,369,714,227,369,714,,,0,0,0,,,,,,
229,371,740,228,371,740,,,1,0,0,,,,,,
231,372,765,230,372,765,,,1,0,0,,,,,,
218,383,103,218,383,103,,,0,0,0,,,,,,
218,383,104,218,383,103,,,0,0,1,,,,,,
218,384,110,218,384,110,,,0,0,0,,,,,,
218,384,120,218,384,122,,,0,0,-2,,,,,,
218,384,134,218,384,134,,,0,0,0,,,,,,
218,384,150,218,384,151,,,0,0,-1,,,,,,
219,384,168,219,384,168,,,0,0,0,,,,,,
219,384,188,219,384,188,,,0,0,0,,,,,,
219,384,209,219,384,209,,,0,0,0,,,,,,
220,385,230,219,384,230,,,1,1,0,,,,,,
220,385,252,220,385,252,,,0,0,0,,,,,,
221,385,275,220,385,275,,,1,0,0,,,,,,
221,385,298,221,385,298,,,0,0,0,,,,,,
222,386,321,222,385,321,,,0,1,0,,,,,,
223,386,345,223,386,345,,,0,0,0,,,,,,
223,387,369,223,386,369,,,0,1,0,,,,,,
224,387,393,224,387,393,,,0,0,0,,,,,,
225,388,417,225,387,417,,,0,1,0,,,,,,
226,388,441,226,388,441,,,0,0,0,,,,,,
227,389,466,227,388,465,,,0,1,1,,,,,,
228,389,490,228,389,490,,,0,0,0,,,,,,
229,390,515,229,390,515,,,0,0,0,,,,,,
231,391,540,231,391,540,,,0,0,0,,,,,,
232,392,565,232,391,565,,,0,1,0,,,,,,
233,392,590,233,392,590,,,0,0,0,,,,,,
235,393,615,234,393,615,,,1,0,0,,,,,,
236,394,640,236,394,640,,,0,0,0,,,,,,
237,395,665,237,395,665,,,0,0,0,,,,,,
239,396,690,239,396,690,,,0,0,0,,,,,,
241,397,715,240,397,715,,,1,0,0,,,,,,
242,398,741,242,398,741,,,0,0,0,,,,,,
244,399,766,244,399,766,,,0,0,0,,,,,,
233,412,110,233,412,110,,,0,0,0,,,,,,
233,412,112,233,412,110,,,0,0,2,,,,,,
233,412,117,233,412,117,,,0,0,0,,,,,,
234,412,127,233,412,128,,,1,0,-1,,,,,,
234,412,140,233,412,140,,,1,0,0,,,,,,
234,412,155,234,412,156,,,0,0,-1,,,,,,
234,412,173,234,412,173,,,0,0,0,,,,,,
234,413,192,234,412,192,,,0,1,0,,,,,,
235,413,212,234,412,212,,,1,1,0,,,,,,
235,413,233,235,413,233,,,0,0,0,,,,,,
236,413,255,235,413,255,,,1,0,0,,,,,,
236,414,278,236,413,277,,,0,1,1,,,,,,
237,414,301,236,413,300,,,1,1,1,,,,,,
237,414,324,237,414,323,,,0,0,1,,,,,,
238,415,347,238,414,347,,,0,1,0,,,,,,
239,415,371,238,415,371,,,1,0,0,,,,,,
239,415,395,239,415,395,,,0,0,0,,,,,,
240,416,419,240,416,419,,,0,0,0,,,,,,
241,416,443,241,416,443,,,0,0,0,,,,,,
242,417,467,242,417,467,,,0,0,0,,,,,,
243,418,492,243,417,491,,,0,1,1,,,,,,
244,418,516,244,418,516,,,0,0,0,,,,,,
245,419,541,245,419,541,,,0,0,0,,,,,,
246,420,566,246,419,566,,,0,1,0,,,,,,
248,420,591,247,420,591,,,1,0,0,,,,,,
249,421,616,249,421,616,,,0,0,0,,,,,,
250,422,641,250,422,641,,,0,0,0,,,,,,
252,423,666,252,422,666,,,0,1,0,,,,,,
253,424,691,253,423,691,,,0,1,0,,,,,,
255,424,716,255,424,716,,,0,0,0,,,,,,
256,425,741,256,425,741,,,0,0,0,,,,,,
258,426,767,258,426,766,,,0,0,1,,,,,,
249,441,118,249,441,118,,,0,0,0,,,,,,
249,441,119,249,441,118,,,0,0,1,,,,,,
249,441,124,249,441,124,,,0,0,0,,,,,,
249,441,133,249,441,135,,,0,0,-2,,,,,,
249,441,146,249,441,146,,,0,0,0,,,,,,
250,441,160,249,441,162,,,1,0,-2,,,,,,
250,441,178,250,441,178,,,0,0,0,,,,,,
250,441,196,250,441,197,,,0,0,-1,,,,,,
250,441,216,250,441,216,,,0,0,0,,,,,,
251,442,237,250,441,237,,,1,1,0,,,,,,
251,442,258,251,442,258,,,0,0,0,,,,,,
252,442,281,251,442,280,,,1,0,1,,,,,,
252,442,303,252,442,303,,,0,0,0,,,,,,
253,443,326,252,442,326,,,1,1,0,,,,,,
253,443,349,253,443,349,,,0,0,0,,,,,,
254,443,373,254,443,373,,,0,0,0,,,,,,
255,444,397,255,444,397,,,0,0,0,,,,,,
255,444,421,255,444,421,,,0,0,0,,,,,,
256,445,445,256,445,445,,,0,0,0,,,,,,
257,445,469,257,445,469,,,0,0,0,,,,,,
258,446,493,258,446,493,,,0,0,0,,,,,,
259,446,518,259,446,518,,,0,0,0,,,,,,
260,447,543,260,447,543,,,0,0,0,,,,,,
261,448,567,261,447,567,,,0,1,0,,,,,,
262,448,592,262,448,592,,,0,0,0,,,,,,
264,449,617,263,449,617,,,1,0,0,,,,,,
265,450,642,265,450,642,,,0,0,0,,,,,,
266,451,667,266,450,667,,,0,1,0,,,,,,
268,451,692,268,451,692,,,0,0,0,,,,,,
269,452,717,269,452,717,,,0,0,0,,,,,,
271,453,742,271,453,742,,,0,0,0,,,,,,
272,454,768,272,454,767,,,0,0,1,,,,,,
265,469,126,265,469,125,,,0,0,1,,,,,,
265,469,127,265,469,125,,,0,0,2,,,,,,
265,469,132,265,469,131,,,0,0,1,,,,,,
265,470,140,265,469,141,,,0,1,-1,,,,,,
265,470,152,265,469,152,,,0,1,0,,,,,,
265,470,166,265,469,167,,,0,1,-1,,,,,,
265,470,183,265,470,183,,,0,0,0,,,,,,
266,470,201,265,470,201,,,1,0,0,,,,,,
266,470,220,266,470,220,,,0,0,0,,,,,,
266,470,241,266,470,240,,,0,0,1,,,,,,
267,470,262,266,470,261,,,1,0,1,,,,,,
267,471,284,267,470,283,,,0,1,1,,,,,,
268,471,306,267,471,306,,,1,0,0,,,,,,
268,471,329,268,471,328,,,0,0,1,,,,,,
269,472,352,268,471,351,,,1,1,1,,,,,,
269,472,375,269,472,375,,,0,0,0,,,,,,
270,472,399,270,472,399,,,0,0,0,,,,,,
271,473,423,271,473,422,,,0,0,1,,,,,,
272,473,447,271,473,446,,,1,0,1,,,,,,
272,474,471,272,474,470,,,0,0,1,,,,,,
273,474,495,273,474,495,,,0,0,0,,,,,,
274,475,519,274,475,519,,,0,0,0,,,,,,
275,475,544,275,475,544,,,0,0,0,,,,,,
276,476,569,276,476,569,,,0,0,0,,,,,,
277,477,593,277,476,593,,,0,1,0,,,,,,
279,477,618,278,477,618,,,1,0,0,,,,,,
280,478,643,280,478,643,,,0,0,0,,,,,,
281,479,668,281,478,668,,,0,1,0,,,,,,
282,479,693,282,479,693,,,0,0,0,,,,,,
284,480,718,284,480,718,,,0,0,0,,,,,,
285,481,743,285,481,743,,,0,0,0,,,,,,
286,482,769,286,482,768,,,0,0,1,,,,,,
281,498,133,281,498,133,,,0,0,0,,,,,,
281,498,134,281,498,133,,,0,0,1,,,,,,
281,498,139,281,498,139,,,0,0,0,,,,,,
281,498,147,281,498,148,,,0,0,-1,,,,,,
281,498,158,281,498,158,,,0,0,0,,,,,,
281,498,172,281,498,173,,,0,0,-1,,,,,,
281,499,188,281,499,188,,,0,0,0,,,,,,
281,499,205,281,499,206,,,0,0,-1,,,,,,
282,499,224,282,499,224,,,0,0,0,,,,,,
282,499,244,282,499,244,,,0,0,0,,,,,,
282,499,265,282,499,265,,,0,0,0,,,,,,
283,499,287,282,499,287,,,1,0,0,,,,,,
283,500,309,283,500,309,,,0,0,0,,,,,,
284,500,331,283,500,331,,,1,0,0,,,,,,
284,500,354,284,500,354,,,0,0,0,,,,,,
285,501,377,285,500,377,,,0,1,0,,,,,,
286,501,401,286,501,401,,,0,0,0,,,,,,
286,501,425,286,501,424,,,0,0,1,,,,,,
287,502,448,287,502,448,,,0,0,0,,,,,,
288,502,472,288,502,472,,,0,0,0,,,,,,
289,503,497,289,503,497,,,0,0,0,,,,,,
289,503,521,289,503,521,,,0,0,0,,,,,,
290,504,546,290,504,546,,,0,0,0,,,,,,
291,504,570,291,504,570,,,0,0,0,,,,,,
292,505,595,292,505,595,,,0,0,0,,,,,,
294,506,620,293,505,619,,,1,1,1,,,,,,
295,506,644,295,506,644,,,0,0,0,,,,,,
296,507,669,296,507,669,,,0,0,0,,,,,,
297,508,694,297,508,694,,,0,0,0,,,,,,
298,508,719,298,508,719,,,0,0,0,,,,,,
300,509,745,300,509,745,,,0,0,0,,,,,,
301,510,770,301,510,770,,,0,0,0,,,,,,
297,527,141,297,527,141,,,0,0,0,,,,,,
297,527,142,297,527,141,,,0,0,1,,,,,,
297,527,146,297,527,146,,,0,0,0,,,,,,
297,527,154,297,527,155,,,0,0,-1,,,,,,
297,527,164,297,527,164,,,0,0,0,,,,,,
297,527,178,297,527,179,,,0,0,-1,,,,,,
297,527,193,297,527,193,,,0,0,0,,,,,,
297,528,210,297,527,211,,,0,1,-1,,,,,,
298,528,229,297,528,228,,,1,0,1,,,,,,
298,528,248,297,528,248,,,1,0,0,,,,,,
298,528,269,298,528,269,,,0,0,0,,,,,,
299,528,290,298,528,290,,,1,0,0,,,,,,
299,528,312,299,528,312,,,0,0,0,,,,,,
299,529,334,299,528,334,,,0,1,0,,,,,,
300,529,357,300,529,357,,,0,0,0,,,,,,
301,529,380,300,529,380,,,1,0,0,,,,,,
301,530,403,301,529,403,,,0,1,0,,,,,,
302,530,427,302,530,427,,,0,0,0,,,,,,
303,530,450,302,530,450,,,1,0,0,,,,,,
303,531,474,303,531,474,,,0,0,0,,,,,,
304,531,499,304,531,498,,,0,0,1,,,,,,
305,532,523,305,532,523,,,0,0,0,,,,,,
306,532,547,305,532,547,,,1,0,0,,,,,,
307,533,572,306,533,572,,,1,0,0,,,,,,
308,533,596,307,533,596,,,1,0,0,,,,,,
309,534,621,308,534,621,,,1,0,0,,,,,,
310,535,646,310,534,645,,,0,1,1,,,,,,
311,535,671,311,535,670,,,0,0,1,,,,,,
312,536,696,312,536,695,,,0,0,1,,,,,,
313,537,721,313,536,720,,,0,1,1,,,,,,
314,537,746,314,537,746,,,0,0,0,,,,,,
316,538,771,315,538,771,,,1,0,0,,,,,,
313,556,149,313,556,149,,,0,0,0,,,,,,
313,556,150,313,556,149,,,0,0,1,,,,,,
313,556,154,313,556,154,,,0,0,0,,,,,,
313,556,161,313,556,162,,,0,0,-1,,,,,,
313,556,171,313,556,171,,,0,0,0,,,,,,
313,556,184,313,556,185,,,0,0,-1,,,,,,
313,556,199,313,556,199,,,0,0,0,,,,,,
313,556,215,313,556,216,,,0,0,-1,,,,,,
313,557,233,313,557,233,,,0,0,0,,,,,,
314,557,253,313,557,253,,,1,0,0,,,,,,
314,557,273,314,557,273,,,0,0,0,,,,,,
314,557,294,314,557,294,,,0,0,0,,,,,,
315,557,315,315,557,315,,,0,0,0,,,,,,
315,558,337,315,557,337,,,0,1,0,,,,,,
316,558,360,316,558,360,,,0,0,0,,,,,,
316,558,383,316,558,383,,,0,0,0,,,,,,
317,558,406,317,558,406,,,0,0,0,,,,,,
317,559,429,317,558,429,,,0,1,0,,,,,,
318,559,453,318,559,453,,,0,0,0,,,,,,
319,560,476,319,559,476,,,0,1,0,,,,,,
320,560,500,320,560,500,,,0,0,0,,,,,,
320,560,525,320,560,524,,,0,0,1,,,,,,
321,561,549,321,561,549,,,0,0,0,,,,,,
322,561,573,322,561,573,,,0,0,0,,,,,,
323,562,598,323,562,598,,,0,0,0,,,,,,
324,562,622,324,562,622,,,0,0,0,,,,,,
325,563,647,325,563,647,,,0,0,0,,,,,,
326,564,672,326,563,672,,,0,1,0,,,,,,
327,564,697,327,564,697,,,0,0,0,,,,,,
328,565,722,328,565,722,,,0,0,0,,,,,,
329,566,747,329,566,747,,,0,0,0,,,,,,
331,566,772,330,566,772,,,1,0,0,,,,,,
329,585,156,329,585,156,,,0,0,0,,,,,,
329,585,157,329,585,156,,,0,0,1,,,,,,
329,585,161,329,585,161,,,0,0,0,,,,,,
329,585,168,329,585,169,,,0,0,-1,,,,,,
329,585,178,329,585,177,,,0,0,1,,,,,,
329,585,190,329,585,191,,,0,0,-1,,,,,,
329,585,204,329,585,204,,,0,0,0,,,,,,
329,585,220,329,585,221,,,0,0,-1,,,,,,
329,586,238,329,586,238,,,0,0,0,,,,,,
330,586,257,329,586,257,,,1,0,0,,,,,,
330,586,277,330,586,277,,,0,0,0,,,,,,
330,586,297,330,586,297,,,0,0,0,,,,,,
331,586,319,331,586,318,,,0,0,1,,,,,,
331,586,340,331,586,340,,,0,0,0,,,,,,
332,587,363,331,587,363,,,1,0,0,,,,,,
332,587,385,332,587,385,,,0,0,0,,,,,,
333,587,408,332,587,408,,,1,0,0,,,,,,
333,588,431,333,587,431,,,0,1,0,,,,,,
334,588,455,334,588,455,,,0,0,0,,,,,,
334,588,479,334,588,478,,,0,0,1,,,,,,
335,589,503,335,589,502,,,0,0,1,,,,,,
336,589,527,336,589,526,,,0,0,1,,,,,,
337,590,551,336,589,551,,,1,1,0,,,,,,
338,590,575,337,590,575,,,1,0,0,,,,,,
338,591,600,338,590,599,,,0,1,1,,,,,,
339,591,624,339,591,624,,,0,0,0,,,,,,
340,592,649,340,591,648,,,0,1,1,,,,,,
341,592,674,341,592,673,,,0,0,1,,,,,,
342,593,698,342,592,698,,,0,1,0,,,,,,
343,593,723,343,593,723,,,0,0,0,,,,,,
345,594,748,344,594,748,,,1,0,0,,,,,,
346,595,773,345,595,773,,,1,0,0,,,,,,
345,614,164,345,614,164,,,0,0,0,,,,,,
345,614,165,345,614,164,,,0,0,1,,,,,,
345,614,169,345,614,169,,,0,0,0,,,,,,
345,614,175,345,614,176,,,0,0,-1,,,,,,
345,614,184,345,614,184,,,0,0,0,,,,,,
345,614,196,345,614,197,,,0,0,-1,,,,,,
345,614,210,345,614,210,,,0,0,0,,,,,,
345,614,226,345,614,226,,,0,0,0,,,,,,
345,615,243,345,615,243,,,0,0,0,,,,,,
346,615,261,345,615,262,,,1,0,-1,,,,,,
346,615,281,346,615,281,,,0,0,0,,,,,,
346,615,301,346,615,301,,,0,0,0,,,,,,
347,615,322,347,615,322,,,0,0,0,,,,,,
347,615,344,347,615,344,,,0,0,0,,,,,,
347,616,366,347,616,366,,,0,0,0,,,,,,
348,616,388,347,616,388,,,1,0,0,,,,,,
348,616,411,348,616,411,,,0,0,0,,,,,,
349,617,434,349,616,434,,,0,1,0,,,,,,
350,617,457,350,617,457,,,0,0,0,,,,,,
350,617,481,350,617,481,,,0,0,0,,,,,,
351,618,505,351,618,505,,,0,0,0,,,,,,
352,618,529,351,618,529,,,1,0,0,,,,,,
352,618,553,352,618,553,,,0,0,0,,,,,,
353,619,577,353,618,577,,,0,1,0,,,,,,
354,619,601,354,619,601,,,0,0,0,,,,,,
355,620,626,355,619,625,,,0,1,1,,,,,,
356,620,650,356,620,650,,,0,0,0,,,,,,
357,621,675,357,620,675,,,0,1,0,,,,,,
358,621,700,358,621,700,,,0,0,0,,,,,,
359,622,725,359,622,725,,,0,0,0,,,,,,
360,623,750,360,623,750,,,0,0,0,,,,,,
361,623,775,361,623,775,,,0,0,0,,,,,,
361,643,172,361,643,172,,,0,0,0,,,,,,
361,643,173,361,643,172,,,0,0,1,,,,,,
361,643,176,361,643,176,,,0,0,0,,,,,,
361,643,182,361,643,183,,,0,0,-1,,,,,,
361,643,191,361,643,191,,,0,0,0,,,,,,
361,643,203,361,643,203,,,0,0,0,,,,,,
361,643,216,361,643,216,,,0,0,0,,,,,,
361,644,231,361,643,232,,,0,1,-1,,,,,,
361,644,248,361,644,248,,,0,0,0,,,,,,
362,644,266,361,644,266,,,1,0,0,,,,,,
362,644,285,362,644,285,,,0,0,0,,,,,,
362,644,305,362,644,305,,,0,0,0,,,,,,
363,644,326,363,644,326,,,0,0,0,,,,,,
363,644,347,363,644,347,,,0,0,0,,,,,,
363,645,369,363,645,369,,,0,0,0,,,,,,
364,645,391,363,645,391,,,1,0,0,,,,,,
364,645,414,364,645,414,,,0,0,0,,,,,,
365,646,437,364,645,437,,,1,1,0,,,,,,
365,646,460,365,646,460,,,0,0,0,,,,,,
366,646,483,366,646,483,,,0,0,0,,,,,,
367,647,507,367,647,507,,,0,0,0,,,,,,
367,647,531,367,647,531,,,0,0,0,,,,,,
368,647,555,368,647,555,,,0,0,0,,,,,,
369,648,579,368,647,579,,,1,1,0,,,,,,
370,648,603,369,648,603,,,1,0,0,,,,,,
370,649,628,370,648,627,,,0,1,1,,,,,,
371,649,652,371,649,652,,,0,0,0,,,,,,
372,650,677,372,649,676,,,0,1,1,,,,,,
373,650,701,373,650,701,,,0,0,0,,,,,,
374,651,726,374,650,726,,,0,1,0,,,,,,
375,651,751,375,651,751,,,0,0,0,,,,,,
376,652,776,376,652,776,,,0,0,0,,,,,,
377,672,180,377,672,180,,,0,0,0,,,,,,
377,672,181,377,672,180,,,0,0,1,,,,,,
377,672,184,377,672,184,,,0,0,0,,,,,,
377,672,190,377,672,191,,,0,0,-1,,,,,,
377,672,198,377,672,198,,,0,0,0,,,,,,
377,673,209,377,672,210,,,0,1,-1,,,,,,
377,673,222,377,673,222,,,0,0,0,,,,,,
377,673,237,377,673,237,,,0,0,0,,,,,,
378,673,253,378,673,253,,,0,0,0,,,,,,
378,673,271,378,673,271,,,0,0,0,,,,,,
378,673,290,378,673,290,,,0,0,0,,,,,,
378,673,309,378,673,310,,,0,0,-1,,,,,,
379,673,330,379,673,330,,,0,0,0,,,,,,
379,674,351,379,673,351,,,0,1,0,,,,,,
379,674,372,379,674,372,,,0,0,0,,,,,,
380,674,394,379,674,394,,,1,0,0,,,,,,
380,674,417,380,674,417,,,0,0,0,,,,,,
381,675,440,380,674,440,,,1,1,0,,,,,,
381,675,463,381,675,463,,,0,0,0,,,,,,
382,675,486,382,675,486,,,0,0,0,,,,,,
383,676,509,383,676,509,,,0,0,0,,,,,,
383,676,533,383,676,533,,,0,0,0,,,,,,
384,676,557,384,676,557,,,0,0,0,,,,,,
385,677,581,384,676,581,,,1,1,0,,,,,,
385,677,605,385,677,605,,,0,0,0,,,,,,
386,678,629,386,677,629,,,0,1,0,,,,,,
387,678,654,387,678,654,,,0,0,0,,,,,,
388,679,678,388,678,678,,,0,1,0,,,,,,
389,679,703,389,679,703,,,0,0,0,,,,,,
390,680,728,390,679,728,,,0,1,0,,,,,,
391,680,753,391,680,753,,,0,0,0,,,,,,
392,681,778,392,680,778,,,0,1,0,,,,,,
393,702,188,393,701,187,,,0,1,1,,,,,,
393,702,188,393,701,187,,,0,1,1,,,,,,
393,702,191,393,701,191,,,0,1,0,,,,,,
393,702,197,393,701,198,,,0,1,-1,,,,,,
393,702,205,393,701,205,,,0,1,0,,,,,,
393,702,216,393,701,216,,,0,1,0,,,,,,
393,702,228,393,702,228,,,0,0,0,,,,,,
393,702,243,393,702,243,,,0,0,0,,,,,,
394,702,259,394,702,258,,,0,0,1,,,,,,
394,702,276,394,702,276,,,0,0,0,,,,,,
394,702,294,394,702,294,,,0,0,0,,,,,,
394,702,314,394,702,314,,,0,0,0,,,,,,
395,703,334,395,702,334,,,0,1,0,,,,,,
395,703,355,395,702,355,,,0,1,0,,,,,,
395,703,376,395,703,376,,,0,0,0,,,,,,
396,703,398,395,703,398,,,1,0,0,,,,,,
396,703,420,396,703,420,,,0,0,0,,,,,,
397,704,442,396,703,442,,,1,1,0,,,,,,
397,704,465,397,704,465,,,0,0,0,,,,,,
398,704,488,397,704,488,,,1,0,0,,,,,,
398,705,512,398,705,511,,,0,0,1,,,,,,
399,705,535,399,705,535,,,0,0,0,,,,,,
400,705,559,400,705,559,,,0,0,0,,,,,,
400,706,583,400,705,583,,,0,1,0,,,,,,
401,706,607,401,706,607,,,0,0,0,,,,,,
402,707,631,401,706,631,,,1,1,0,,,,,,
403,707,656,402,707,656,,,1,0,0,,,,,,
404,707,680,403,707,680,,,1,0,0,,,,,,
404,708,705,404,708,705,,,0,0,0,,,,,,
405,708,730,405,708,729,,,0,0,1,,,,,,
406,709,754,406,709,754,,,0,0,0,,,,,,
407,710,779,407,709,779,,,0,1,0,,,,,,
409,731,195,409,731,195,,,0,0,0,,,,,,
409,731,196,409,731,195,,,0,0,1,,,,,,
409,731,199,409,731,199,,,0,0,0,,,,,,
409,731,204,409,731,205,,,0,0,-1,,,,,,
409,731,212,409,731,212,,,0,0,0,,,,,,
409,731,222,409,731,223,,,0,0,-1,,,,,,
410,731,235,410,731,235,,,0,0,0,,,,,,
410,731,249,410,731,249,,,0,0,0,,,,,,
410,731,264,410,731,264,,,0,0,0,,,,,,
410,731,281,410,731,281,,,0,0,0,,,,,,
410,731,299,410,731,299,,,0,0,0,,,,,,
411,732,318,410,731,318,,,1,1,0,,,,,,
411,732,338,411,732,338,,,0,0,0,,,,,,
411,732,359,411,732,359,,,0,0,0,,,,,,
412,732,380,412,732,380,,,0,0,0,,,,,,
412,732,401,412,732,401,,,0,0,0,,,,,,
412,733,423,412,733,423,,,0,0,0,,,,,,
413,733,446,412,733,445,,,1,0,1,,,,,,
413,733,468,413,733,468,,,0,0,0,,,,,,
414,733,491,413,733,491,,,1,0,0,,,,,,
414,734,514,414,734,514,,,0,0,0,,,,,,
415,734,538,415,734,538,,,0,0,0,,,,,,
416,734,562,416,734,562,,,0,0,0,,,,,,
416,735,585,416,734,585,,,0,1,0,,,,,,
417,735,609,417,735,609,,,0,0,0,,,,,,
418,736,634,417,735,633,,,1,1,1,,,,,,
418,736,658,418,736,658,,,0,0,0,,,,,,
419,736,682,419,736,682,,,0,0,0,,,,,,
420,737,707,420,737,707,,,0,0,0,,,,,,
421,737,731,421,737,731,,,0,0,0,,,,,,
422,738,756,422,738,756,,,0,0,0,,,,,,
423,738,781,423,738,781,,,0,0,0,,,,,,
425,760,203,425,760,203,,,0,0,0,,,,,,
425,760,204,425,760,203,,,0,0,1,,,,,,
425,760,207,425,760,206,,,0,0,1,,,,,,
425,760,212,425,760,213,,,0,0,-1,,,,,,
426,760,219,425,760,219,,,1,0,0,,,,,,
426,760,229,425,760,230,,,1,0,-1,,,,,,
426,760,241,426,760,241,,,0,0,0,,,,,,
426,760,255,426,760,255,,,0,0,0,,,,,,
426,760,270,426,760,270,,,0,0,0,,,,,,
426,761,286,426,760,287,,,0,1,-1,,,,,,
426,761,304,426,760,304,,,0,1,0,,,,,,
427,761,323,426,760,323,,,1,1,0,,,,,,
427,761,342,427,761,342,,,0,0,0,,,,,,
427,761,363,427,761,363,,,0,0,0,,,,,,
428,761,383,428,761,383,,,0,0,0,,,,,,
428,762,405,428,761,405,,,0,1,0,,,,,,
428,762,427,428,762,426,,,0,0,1,,,,,,
429,762,449,428,762,448,,,1,0,1,,,,,,
429,762,471,429,762,471,,,0,0,0,,,,,,
430,763,494,429,762,494,,,1,1,0,,,,,,
430,763,517,430,763,517,,,0,0,0,,,,,,
431,763,540,431,763,540,,,0,0,0,,,,,,
432,764,564,432,763,564,,,0,1,0,,,,,,
432,764,588,432,763,588,,,0,1,0,,,,,,
433,764,612,433,764,611,,,0,0,1,,,,,,
434,765,636,433,764,635,,,1,1,1,,,,,,
434,765,660,434,765,660,,,0,0,0,,,,,,
435,765,684,435,765,684,,,0,0,0,,,,,,
436,766,709,436,766,709,,,0,0,0,,,,,,
437,766,733,436,766,733,,,1,0,0,,,,,,
438,767,758,437,767,758,,,1,0,0,,,,,,
438,767,782,438,767,782,,,0,0,0,,,,,,
442,789,211,442,789,211,,,0,0,0,,,,,,
442,789,212,442,789,211,,,0,0,1,,,,,,
442,789,214,442,789,214,,,0,0,0,,,,,,
442,789,219,442,789,220,,,0,0,-1,,,,,,
442,790,227,442,790,227,,,0,0,0,,,,,,
442,790,236,442,790,237,,,0,0,-1,,,,,,
442,790,248,442,790,248,,,0,0,0,,,,,,
442,790,261,442,790,262,,,0,0,-1,,,,,,
442,790,276,442,790,276,,,0,0,0,,,,,,
442,790,292,442,790,292,,,0,0,0,,,,,,
443,790,309,443,790,309,,,0,0,0,,,,,,
443,790,328,443,790,328,,,0,0,0,,,,,,
443,790,347,443,790,347,,,0,0,0,,,,,,
444,790,367,443,790,367,,,1,0,0,,,,,,
444,791,387,444,791,387,,,0,0,0,,,,,,
444,791,408,444,791,408,,,0,0,0,,,,,,
445,791,430,445,791,430,,,0,0,0,,,,,,
445,791,452,445,791,452,,,0,0,0,,,,,,
445,792,474,445,792,474,,,0,0,0,,,,,,
446,792,497,445,792,497,,,1,0,0,,,,,,
446,792,520,446,792,520,,,0,0,0,,,,,,
447,792,543,447,792,543,,,0,0,0,,,,,,
448,793,567,448,793,567,,,0,0,0,,,,,,
448,793,590,448,793,590,,,0,0,0,,,,,,
449,793,614,449,793,614,,,0,0,0,,,,,,
450,794,638,449,793,638,,,1,1,0,,,,,,
450,794,662,450,794,662,,,0,0,0,,,,,,
451,795,686,451,794,686,,,0,1,0,,,,,,
452,795,711,452,795,711,,,0,0,0,,,,,,
453,795,735,452,795,735,,,1,0,0,,,,,,
453,796,760,453,796,760,,,0,0,0,,,,,,
454,796,784,454,796,784,,,0,0,0,,,,,,
458,819,219,458,818,219,,,0,1,0,,,,,,
458,819,220,458,818,219,,,0,1,1,,,,,,
458,819,222,458,818,222,,,0,1,0,,,,,,
458,819,227,458,818,228,,,0,1,-1,,,,,,
458,819,234,458,819,234,,,0,0,0,,,,,,
458,819,243,458,819,244,,,0,0,-1,,,,,,
458,819,254,458,819,254,,,0,0,0,,,,,,
458,819,267,458,819,268,,,0,0,-1,,,,,,
459,819,282,458,819,282,,,1,0,0,,,,,,
459,819,297,458,819,298,,,1,0,-1,,,,,,
459,819,314,459,819,314,,,0,0,0,,,,,,
459,820,332,459,819,333,,,0,1,-1,,,,,,
459,820,351,459,819,351,,,0,1,0,,,,,,
460,820,371,459,819,371,,,1,1,0,,,,,,
460,820,391,460,820,391,,,0,0,0,,,,,,
460,820,412,460,820,412,,,0,0,0,,,,,,
461,820,434,461,820,433,,,0,0,1,,,,,,
461,821,455,461,820,455,,,0,1,0,,,,,,
462,821,478,461,821,477,,,1,0,1,,,,,,
462,821,500,462,821,500,,,0,0,0,,,,,,
463,821,523,462,821,523,,,1,0,0,,,,,,
463,822,546,463,821,546,,,0,1,0,,,,,,
464,822,569,464,822,569,,,0,0,0,,,,,,
464,822,593,464,822,593,,,0,0,0,,,,,,
465,823,616,465,822,616,,,0,1,0,,,,,,
466,823,640,465,823,640,,,1,0,0,,,,,,
466,823,664,466,823,664,,,0,0,0,,,,,,
467,824,688,467,823,688,,,0,1,0,,,,,,
468,824,713,468,824,713,,,0,0,0,,,,,,
468,825,737,468,824,737,,,0,1,0,,,,,,
469,825,762,469,825,762,,,0,0,0,,,,,,
470,826,786,470,825,786,,,0,1,0,,,,,,
474,848,227,474,848,227,,,0,0,0,,,,,,
474,848,227,474,848,227,,,0,0,0,,,,,,
474,848,230,474,848,230,,,0,0,0,,,,,,
474,848,235,474,848,235,,,0,0,0,,,,,,
474,848,241,474,848,241,,,0,0,0,,,,,,
474,848,250,474,848,251,,,0,0,-1,,,,,,
475,848,261,475,848,261,,,0,0,0,,,,,,
475,848,273,475,848,274,,,0,0,-1,,,,,,
475,849,288,475,849,288,,,0,0,0,,,,,,
475,849,303,475,849,304,,,0,0,-1,,,,,,
475,849,320,475,849,320,,,0,0,0,,,,,,
475,849,337,475,849,338,,,0,0,-1,,,,,,
476,849,356,476,849,356,,,0,0,0,,,,,,
476,849,375,476,849,376,,,0,0,-1,,,,,,
476,849,396,476,849,396,,,0,0,0,,,,,,
477,850,416,476,849,416,,,1,1,0,,,,,,
477,850,437,477,850,437,,,0,0,0,,,,,,
477,850,459,477,850,459,,,0,0,0,,,,,,
478,850,481,478,850,481,,,0,0,0,,,,,,
478,850,503,478,850,503,,,0,0,0,,,,,,
479,851,526,479,851,526,,,0,0,0,,,,,,
479,851,549,479,851,549,,,0,0,0,,,,,,
480,851,572,480,851,572,,,0,0,0,,,,,,
480,852,595,480,851,595,,,0,1,0,,,,,,
481,852,619,481,852,619,,,0,0,0,,,,,,
482,852,643,481,852,643,,,1,0,0,,,,,,
482,853,667,482,853,667,,,0,0,0,,,,,,
483,853,691,483,853,691,,,0,0,0,,,,,,
484,853,715,484,853,715,,,0,0,0,,,,,,
484,854,739,484,853,739,,,0,1,0,,,,,,
485,854,764,485,854,764,,,0,0,0,,,,,,
486,855,788,486,854,788,,,0,1,0,,,,,,
491,878,235,490,877,234,,,1,1,1,,,,,,
491,878,235,490,877,234,,,1,1,1,,,,,,
491,878,238,490,877,237,,,1,1,1,,,,,,
491,878,242,490,877,243,,,1,1,-1,,,,,,
491,878,249,490,877,248,,,1,1,1,,,,,,
491,878,257,490,877,258,,,1,1,-1,,,,,,
491,878,268,491,877,267,,,0,1,1,,,,,,
491,878,280,491,878,280,,,0,0,0,,,,,,
491,878,294,491,878,294,,,0,0,0,,,,,,
491,878,309,491,878,309,,,0,0,0,,,,,,
492,878,325,491,878,325,,,1,0,0,,,,,,
492,878,343,491,878,343,,,1,0,0,,,,,,
492,878,361,492,878,361,,,0,0,0,,,,,,
492,879,380,492,878,380,,,0,1,0,,,,,,
493,879,400,492,878,400,,,1,1,0,,,,,,
493,879,420,493,879,420,,,0,0,0,,,,,,
493,879,441,493,879,441,,,0,0,0,,,,,,
494,879,463,493,879,462,,,1,0,1,,,,,,
494,880,484,494,879,484,,,0,1,0,,,,,,
494,880,507,494,880,506,,,0,0,1,,,,,,
495,880,529,495,880,529,,,0,0,0,,,,,,
495,880,552,495,880,552,,,0,0,0,,,,,,
496,881,575,496,880,575,,,0,1,0,,,,,,
496,881,598,496,881,598,,,0,0,0,,,,,,
497,881,622,497,881,621,,,0,0,1,,,,,,
498,882,645,497,881,645,,,1,1,0,,,,,,
498,882,669,498,882,669,,,0,0,0,,,,,,
499,882,693,499,882,693,,,0,0,0,,,,,,
500,883,717,500,882,717,,,0,1,0,,,,,,
500,883,741,500,883,741,,,0,0,0,,,,,,
501,884,766,501,883,766,,,0,1,0,,,,,,
502,884,790,502,884,790,,,0,0,0,,,,,,
73,20,11,73,20,11,,,0,0,0,,,,,,
73,20,23,73,20,11,,,0,0,12,,,,,,
74,21,44,73,21,44,,,1,0,0,,,,,,
74,23,67,74,23,67,,,0,0,0,,,,,,
74,24,90,74,24,90,,,0,0,0,,,,,,
75,27,114,75,27,114,,,0,0,0,,,,,,
76,29,137,76,29,137,,,0,0,0,,,,,,
77,32,161,77,32,161,,,0,0,0,,,,,,
78,35,186,79,35,185,,,-1,0,1,,,,,,
79,38,210,80,38,209,,,-1,0,1,,,,,,
81,42,234,82,42,234,,,-1,0,0,,,,,,
82,45,259,83,45,258,,,-1,0,1,,,,,,
84,49,283,85,49,283,,,-1,0,0,,,,,,
86,52,308,87,52,307,,,-1,0,1,,,,,,
88,56,332,89,56,332,,,-1,0,0,,,,,,
90,60,357,92,60,357,,,-2,0,0,,,,,,
93,63,382,94,64,382,,,-1,-1,0,,,,,,
95,67,407,97,67,407,,,-2,0,0,,,,,,
97,71,432,99,71,432,,,-2,0,0,,,,,,
100,75,457,102,75,457,,,-2,0,0,,,,,,
103,79,482,104,79,482,,,-1,0,0,,,,,,
105,83,507,107,82,507,,,-2,1,0,,,,,,
108,86,532,110,86,532,,,-2,0,0,,,,,,
111,90,558,113,90,557,,,-2,0,1,,,,,,
114,94,583,116,94,583,,,-2,0,0,,,,,,
117,98,608,119,98,608,,,-2,0,0,,,,,,
120,102,633,122,102,633,,,-2,0,0,,,,,,
123,106,659,125,106,658,,,-2,0,1,,,,,,
127,110,684,128,110,684,,,-1,0,0,,,,,,
130,114,710,131,114,709,,,-1,0,1,,,,,,
133,118,735,135,118,735,,,-2,0,0,,,,,,
137,122,761,138,122,760,,,-1,0,1,,,,,,
74,31,13,73,20,11,,,1,11,2,,,,,,
74,31,24,73,20,11,,,1,11,13,,,,,,
74,31,45,73,21,44,,,1,10,1,,,,,,
75,32,67,74,23,67,,,1,9,0,,,,,,
75,33,90,74,24,90,,,1,9,0,,,,,,
76,35,114,75,27,114,,,1,8,0,,,,,,
77,37,138,76,29,137,,,1,8,1,,,,,,
78,39,162,77,32,161,,,1,7,1,,,,,,
79,42,186,79,35,185,,,0,7,1,,,,,,
80,44,210,80,38,209,,,0,6,1,,,,,,
82,47,234,82,42,234,,,0,5,0,,,,,,
83,50,259,83,45,258,,,0,5,1,,,,,,
85,54,283,85,49,283,,,0,5,0,,,,,,
87,57,308,87,52,307,,,0,5,1,,,,,,
89,60,332,89,56,332,,,0,4,0,,,,,,
91,64,357,92,60,357,,,-1,4,0,,,,,,
93,67,382,94,64,382,,,-1,3,0,,,,,,
96,71,407,97,67,407,,,-1,4,0,,,,,,
98,74,432,99,71,432,,,-1,3,0,,,,,,
101,78,457,102,75,457,,,-1,3,0,,,,,,
103,82,482,104,79,482,,,-1,3,0,,,,,,
106,85,507,107,82,507,,,-1,3,0,,,,,,
109,89,532,110,86,532,,,-1,3,0,,,,,,
112,93,558,113,90,557,,,-1,3,1,,,,,,
115,97,583,116,94,583,,,-1,3,0,,,,,,
118,100,608,119,98,608,,,-1,2,0,,,,,,
121,104,633,122,102,633,,,-1,2,0,,,,,,
124,108,659,125,106,658,,,-1,2,1,,,,,,
127,112,684,128,110,684,,,-1,2,0,,,,,,
130,116,710,131,114,709,,,-1,2,1,,,,,,
134,120,735,135,118,735,,,-1,2,0,,,,,,
137,124,761,138,122,760,,,-1,2,1,,,,,,
78,53,17,78,53,17,,,0,0,0,,,,,,
78,53,26,78,53,17,,,0,0,9,,,,,,
78,54,46,78,54,46,,,0,0,0,,,,,,
78,54,68,79,54,68,,,-1,0,0,,,,,,
79,55,91,79,55,91,,,0,0,0,,,,,,
79,56,114,80,56,114,,,-1,0,0,,,,,,
80,57,138,81,57,138,,,-1,0,0,,,,,,
81,58,162,82,59,162,,,-1,-1,0,,,,,,
82,60,186,83,60,186,,,-1,0,0,,,,,,
83,62,210,84,62,210,,,-1,0,0,,,,,,
85,64,234,86,64,234,,,-1,0,0,,,,,,
86,66,259,87,66,258,,,-1,0,1,,,,,,
88,68,283,89,69,283,,,-1,-1,0,,,,,,
90,71,308,91,71,308,,,-1,0,0,,,,,,
92,74,333,93,74,333,,,-1,0,0,,,,,,
94,76,357,95,76,357,,,-1,0,0,,,,,,
96,79,382,97,79,382,,,-1,0,0,,,,,,
98,82,407,100,82,407,,,-2,0,0,,,,,,
101,85,432,102,85,432,,,-1,0,0,,,,,,
103,88,457,105,88,457,,,-2,0,0,,,,,,
106,92,482,107,92,482,,,-1,0,0,,,,,,
108,95,507,110,95,507,,,-2,0,0,,,,,,
111,98,532,113,98,532,,,-2,0,0,,,,,,
114,102,558,116,102,557,,,-2,0,1,,,,,,
117,105,583,119,105,583,,,-2,0,0,,,,,,
120,109,608,122,108,608,,,-2,1,0,,,,,,
123,112,634,125,112,634,,,-2,0,0,,,,,,
126,116,659,128,116,659,,,-2,0,0,,,,,,
129,119,684,131,120,684,,,-2,-1,0,,,,,,
132,123,710,134,123,709,,,-2,0,1,,,,,,
135,127,735,137,127,735,,,-2,0,0,,,,,,
139,130,761,140,130,760,,,-1,0,1,,,,,,
84,79,23,85,79,23,,,-1,0,0,,,,,,
84,79,30,85,79,23,,,-1,0,7,,,,,,
84,79,48,86,79,48,,,-2,0,0,,,,,,
84,79,70,86,80,70,,,-2,-1,0,,,,,,
84,80,92,87,80,92,,,-3,0,0,,,,,,
85,80,115,87,81,115,,,-2,-1,0,,,,,,
86,81,139,88,82,138,,,-2,-1,1,,,,,,
87,82,162,89,83,162,,,-2,-1,0,,,,,,
88,83,186,90,84,186,,,-2,-1,0,,,,,,
89,84,210,91,86,210,,,-2,-2,0,,,,,,
90,86,235,92,87,234,,,-2,-1,1,,,,,,
91,88,259,94,89,259,,,-3,-1,0,,,,,,
93,89,284,95,91,283,,,-2,-2,1,,,,,,
95,91,308,97,93,308,,,-2,-2,0,,,,,,
97,93,333,99,95,333,,,-2,-2,0,,,,,,
99,95,358,101,97,357,,,-2,-2,1,,,,,,
101,98,382,103,99,382,,,-2,-1,0,,,,,,
103,100,407,105,102,407,,,-2,-2,0,,,,,,
105,102,432,108,104,432,,,-3,-2,0,,,,,,
107,105,457,110,107,457,,,-3,-2,0,,,,,,
110,108,482,112,110,482,,,-2,-2,0,,,,,,
113,110,507,115,112,507,,,-2,-2,0,,,,,,
115,113,533,117,115,532,,,-2,-2,1,,,,,,
118,116,558,120,118,557,,,-2,-2,1,,,,,,
121,119,583,123,121,583,,,-2,-2,0,,,,,,
124,122,608,126,124,608,,,-2,-2,0,,,,,,
126,125,634,129,127,634,,,-3,-2,0,,,,,,
129,129,659,132,130,659,,,-3,-1,0,,,,,,
133,132,684,135,134,684,,,-2,-2,0,,,,,,
136,135,710,138,137,710,,,-2,-2,0,,,,,,
139,138,735,141,140,735,,,-2,-2,0,,,,,,
142,142,761,144,144,761,,,-2,-2,0,,,,,,
92,105,29,93,105,29,,,-1,0,0,,,,,,
92,105,35,93,105,29,,,-1,0,6,,,,,,
92,105,51,93,105,51,,,-1,0,0,,,,,,
92,105,72,94,105,72,,,-2,0,0,,,,,,
92,106,94,94,106,93,,,-2,0,1,,,,,,
93,106,116,95,106,116,,,-2,0,0,,,,,,
94,107,140,95,107,139,,,-1,0,1,,,,,,
94,108,163,96,107,163,,,-2,1,0,,,,,,
95,108,187,97,108,187,,,-2,0,0,,,,,,
96,109,211,98,109,211,,,-2,0,0,,,,,,
98,110,235,99,111,235,,,-1,-1,0,,,,,,
99,112,260,100,112,259,,,-1,0,1,,,,,,
100,113,284,102,113,284,,,-2,0,0,,,,,,
102,114,309,103,114,308,,,-1,0,1,,,,,,
104,116,333,105,116,333,,,-1,0,0,,,,,,
105,118,358,107,118,358,,,-2,0,0,,,,,,
107,119,383,109,120,383,,,-2,-1,0,,,,,,
109,121,408,111,122,407,,,-2,-1,1,,,,,,
111,123,433,113,124,432,,,-2,-1,1,,,,,,
114,126,457,115,126,457,,,-1,0,0,,,,,,
116,128,483,118,128,482,,,-2,0,1,,,,,,
118,130,508,120,130,507,,,-2,0,1,,,,,,
121,132,533,122,132,533,,,-1,0,0,,,,,,
124,135,558,125,135,558,,,-1,0,0,,,,,,
126,137,583,128,137,583,,,-2,0,0,,,,,,
129,140,609,130,140,608,,,-1,0,1,,,,,,
132,143,634,133,143,634,,,-1,0,0,,,,,,
135,145,659,136,145,659,,,-1,0,0,,,,,,
138,148,685,139,148,685,,,-1,0,0,,,,,,
140,151,710,142,151,710,,,-2,0,0,,,,,,
144,154,736,145,154,736,,,-1,0,0,,,,,,
147,157,761,148,157,761,,,-1,0,0,,,,,,
101,132,36,104,132,36,,,-3,0,0,,,,,,
101,132,41,104,132,36,,,-3,0,5,,,,,,
102,132,55,104,132,56,,,-2,0,-1,,,,,,
102,132,75,104,132,76,,,-2,0,-1,,,,,,
102,133,96,105,133,96,,,-3,0,0,,,,,,
103,133,118,105,133,118,,,-2,0,0,,,,,,
103,133,141,106,133,141,,,-3,0,0,,,,,,
104,134,164,106,134,164,,,-2,0,0,,,,,,
105,135,188,107,135,188,,,-2,0,0,,,,,,
106,135,212,108,135,212,,,-2,0,0,,,,,,
107,136,236,109,136,236,,,-2,0,0,,,,,,
108,137,260,110,137,260,,,-2,0,0,,,,,,
109,138,285,111,138,284,,,-2,0,1,,,,,,
111,139,309,113,140,309,,,-2,-1,0,,,,,,
112,141,334,115,141,333,,,-3,0,1,,,,,,
114,142,358,116,142,358,,,-2,0,0,,,,,,
116,143,383,118,144,383,,,-2,-1,0,,,,,,
118,145,408,120,146,408,,,-2,-1,0,,,,,,
120,147,433,122,147,432,,,-2,0,1,,,,,,
122,148,458,124,149,457,,,-2,-1,1,,,,,,
124,150,483,126,151,482,,,-2,-1,1,,,,,,
126,152,508,128,153,508,,,-2,-1,0,,,,,,
128,154,533,130,155,533,,,-2,-1,0,,,,,,
131,156,558,133,157,558,,,-2,-1,0,,,,,,
133,158,584,135,159,583,,,-2,-1,1,,,,,,
136,161,609,138,161,608,,,-2,0,1,,,,,,
138,163,634,141,164,634,,,-3,-1,0,,,,,,
141,165,659,143,166,659,,,-2,-1,0,,,,,,
144,168,685,146,169,685,,,-2,-1,0,,,,,,
147,170,710,149,171,710,,,-2,-1,0,,,,,,
150,173,736,152,174,736,,,-2,-1,0,,,,,,
153,176,761,155,177,761,,,-2,-1,0,,,,,,
113,159,43,114,159,43,,,-1,0,0,,,,,,
113,159,48,114,159,43,,,-1,0,5,,,,,,
113,159,60,114,159,60,,,-1,0,0,,,,,,
113,159,78,115,159,79,,,-2,0,-1,,,,,,
113,160,98,115,160,98,,,-2,0,0,,,,,,
114,160,120,116,160,120,,,-2,0,0,,,,,,
114,160,143,116,160,143,,,-2,0,0,,,,,,
115,161,166,117,161,166,,,-2,0,0,,,,,,
116,161,189,117,161,189,,,-1,0,0,,,,,,
116,162,213,118,162,213,,,-2,0,0,,,,,,
117,163,237,119,162,237,,,-2,1,0,,,,,,
118,163,261,120,163,261,,,-2,0,0,,,,,,
120,164,285,121,164,285,,,-1,0,0,,,,,,
121,165,310,123,165,310,,,-2,0,0,,,,,,
122,166,334,124,166,334,,,-2,0,0,,,,,,
124,167,359,125,167,359,,,-1,0,0,,,,,,
125,169,384,127,168,384,,,-2,1,0,,,,,,
127,170,409,128,170,408,,,-1,0,1,,,,,,
129,171,433,130,171,433,,,-1,0,0,,,,,,
131,173,458,132,173,458,,,-1,0,0,,,,,,
133,174,483,135,174,483,,,-2,0,0,,,,,,
135,176,508,137,176,508,,,-2,0,0,,,,,,
137,178,533,139,177,533,,,-2,1,0,,,,,,
139,180,559,141,179,558,,,-2,1,1,,,,,,
142,181,584,143,181,584,,,-1,0,0,,,,,,
144,183,609,146,183,609,,,-2,0,0,,,,,,
147,185,634,148,185,634,,,-1,0,0,,,,,,
149,187,660,151,187,659,,,-2,0,1,,,,,,
152,190,685,153,189,685,,,-1,1,0,,,,,,
154,192,711,156,192,710,,,-2,0,1,,,,,,
157,194,736,159,194,736,,,-2,0,0,,,,,,
160,196,762,161,196,761,,,-1,0,1,,,,,,
125,187,51,127,187,50,,,-2,0,1,,,,,,
125,187,54,127,187,50,,,-2,0,4,,,,,,
125,187,65,127,187,66,,,-2,0,-1,,,,,,
125,187,82,127,187,83,,,-2,0,-1,,,,,,
125,187,102,128,187,101,,,-3,0,1,,,,,,
126,187,123,128,187,123,,,-2,0,0,,,,,,
126,188,145,128,188,145,,,-2,0,0,,,,,,
127,188,168,129,188,168,,,-2,0,0,,,,,,
127,189,191,129,189,191,,,-2,0,0,,,,,,
128,189,214,130,189,214,,,-2,0,0,,,,,,
129,190,238,131,190,238,,,-2,0,0,,,,,,
130,190,262,132,190,262,,,-2,0,0,,,,,,
131,191,286,133,191,286,,,-2,0,0,,,,,,
132,192,311,134,192,310,,,-2,0,1,,,,,,
133,193,335,136,193,335,,,-3,0,0,,,,,,
135,194,360,137,194,359,,,-2,0,1,,,,,,
136,195,384,138,195,384,,,-2,0,0,,,,,,
138,196,409,140,196,409,,,-2,0,0,,,,,,
140,197,434,141,197,434,,,-1,0,0,,,,,,
141,198,459,143,198,458,,,-2,0,1,,,,,,
143,200,484,145,200,483,,,-2,0,1,,,,,,
145,201,509,147,201,508,,,-2,0,1,,,,,,
147,203,534,149,203,534,,,-2,0,0,,,,,,
149,204,559,151,204,559,,,-2,0,0,,,,,,
151,206,584,153,206,584,,,-2,0,0,,,,,,
154,207,610,155,208,609,,,-1,-1,1,,,,,,
156,209,635,158,209,634,,,-2,0,1,,,,,,
158,211,660,160,211,660,,,-2,0,0,,,,,,
161,213,686,162,213,685,,,-1,0,1,,,,,,
163,215,711,165,215,711,,,-2,0,0,,,,,,
166,217,736,168,217,736,,,-2,0,0,,,,,,
168,219,762,170,219,762,,,-2,0,0,,,,,,
138,214,58,139,214,58,,,-1,0,0,,,,,,
138,214,61,139,214,58,,,-1,0,3,,,,,,
138,215,71,139,214,71,,,-1,1,0,,,,,,
138,215,86,140,214,88,,,-2,1,-2,,,,,,
138,215,105,140,214,105,,,-2,1,0,,,,,,
139,215,126,140,215,126,,,-1,0,0,,,,,,
139,215,147,140,215,147,,,-1,0,0,,,,,,
139,216,170,141,216,170,,,-2,0,0,,,,,,
140,216,193,142,216,193,,,-2,0,0,,,,,,
141,216,216,142,217,216,,,-1,-1,0,,,,,,
141,217,240,143,217,240,,,-2,0,0,,,,,,
142,218,264,144,218,263,,,-2,0,1,,,,,,
143,218,288,145,218,287,,,-2,0,1,,,,,,
144,219,312,146,219,311,,,-2,0,1,,,,,,
146,220,336,147,219,336,,,-1,1,0,,,,,,
147,220,361,148,220,360,,,-1,0,1,,,,,,
148,221,385,150,221,385,,,-2,0,0,,,,,,
150,222,410,151,222,410,,,-1,0,0,,,,,,
151,223,435,153,223,435,,,-2,0,0,,,,,,
153,224,460,154,224,459,,,-1,0,1,,,,,,
154,226,484,156,225,484,,,-2,1,0,,,,,,
156,227,509,158,227,509,,,-2,0,0,,,,,,
158,228,535,160,228,534,,,-2,0,1,,,,,,
160,229,560,161,229,559,,,-1,0,1,,,,,,
162,231,585,163,231,585,,,-1,0,0,,,,,,
164,232,610,165,232,610,,,-1,0,0,,,,,,
166,234,635,168,234,635,,,-2,0,0,,,,,,
168,236,661,170,235,660,,,-2,1,1,,,,,,
171,237,686,172,237,686,,,-1,0,0,,,,,,
173,239,711,174,239,711,,,-1,0,0,,,,,,
175,241,737,177,240,737,,,-2,1,0,,,,,,
178,243,762,179,242,762,,,-1,1,0,,,,,,
151,242,65,153,242,65,,,-2,0,0,,,,,,
151,242,68,153,242,65,,,-2,0,3,,,,,,
151,242,77,153,242,77,,,-2,0,0,,,,,,
151,243,91,153,242,93,,,-2,1,-2,,,,,,
152,243,109,154,242,109,,,-2,1,0,,,,,,
152,243,129,154,242,129,,,-2,1,0,,,,,,
152,243,150,154,243,150,,,-2,0,0,,,,,,
153,243,172,154,243,172,,,-1,0,0,,,,,,
153,244,195,155,244,195,,,-2,0,0,,,,,,
154,244,218,156,244,218,,,-2,0,0,,,,,,
155,245,241,156,245,241,,,-1,0,0,,,,,,
155,245,265,157,245,265,,,-2,0,0,,,,,,
156,246,289,158,246,289,,,-2,0,0,,,,,,
157,246,313,159,246,313,,,-2,0,0,,,,,,
158,247,337,160,247,337,,,-2,0,0,,,,,,
159,248,362,161,247,361,,,-2,1,1,,,,,,
161,248,386,162,248,386,,,-1,0,0,,,,,,
162,249,411,164,249,410,,,-2,0,1,,,,,,
163,250,436,165,250,435,,,-2,0,1,,,,,,
165,251,460,166,251,460,,,-1,0,0,,,,,,
166,252,485,168,252,485,,,-2,0,0,,,,,,
168,253,510,170,253,510,,,-2,0,0,,,,,,
170,254,535,171,255,535,,,-1,-1,0,,,,,,
171,256,560,173,256,560,,,-2,0,0,,,,,,
173,257,585,175,257,585,,,-2,0,0,,,,,,
175,258,611,177,258,610,,,-2,0,1,,,,,,
177,260,636,179,259,635,,,-2,1,1,,,,,,
179,261,661,181,261,661,,,-2,0,0,,,,,,
181,262,686,183,263,686,,,-2,-1,0,,,,,,
184,264,712,185,264,712,,,-1,0,0,,,,,,
186,266,737,187,266,737,,,-1,0,0,,,,,,
188,267,763,190,267,763,,,-2,0,0,,,,,,
165,270,73,167,270,72,,,-2,0,1,,,,,,
165,270,75,167,270,72,,,-2,0,3,,,,,,
165,270,83,167,270,83,,,-2,0,0,,,,,,
165,271,97,167,270,98,,,-2,1,-1,,,,,,
166,271,113,167,270,113,,,-1,1,0,,,,,,
166,271,133,167,270,133,,,-1,1,0,,,,,,
166,271,153,168,271,153,,,-2,0,0,,,,,,
167,271,175,168,271,175,,,-1,0,0,,,,,,
167,272,197,169,271,197,,,-2,1,0,,,,,,
168,272,220,169,272,220,,,-1,0,0,,,,,,
168,272,243,170,272,243,,,-2,0,0,,,,,,
169,273,267,170,273,266,,,-1,0,1,,,,,,
170,273,290,171,273,290,,,-1,0,0,,,,,,
171,274,314,172,274,314,,,-1,0,0,,,,,,
172,274,339,173,274,338,,,-1,0,1,,,,,,
173,275,363,174,275,362,,,-1,0,1,,,,,,
174,276,387,175,275,387,,,-1,1,0,,,,,,
175,277,412,176,276,411,,,-1,1,1,,,,,,
176,277,436,177,277,436,,,-1,0,0,,,,,,
178,278,461,179,278,461,,,-1,0,0,,,,,,
179,279,486,180,279,486,,,-1,0,0,,,,,,
181,280,511,182,280,511,,,-1,0,0,,,,,,
182,281,536,183,281,536,,,-1,0,0,,,,,,
184,282,561,185,282,561,,,-1,0,0,,,,,,
185,283,586,187,283,586,,,-2,0,0,,,,,,
187,284,611,189,284,611,,,-2,0,0,,,,,,
189,286,636,191,285,636,,,-2,1,0,,,,,,
191,287,662,192,287,661,,,-1,0,1,,,,,,
193,288,687,194,288,687,,,-1,0,0,,,,,,
195,290,712,196,290,712,,,-1,0,0,,,,,,
197,291,738,198,291,738,,,-1,0,0,,,,,,
199,293,763,200,293,763,,,-1,0,0,,,,,,
179,299,80,181,298,80,,,-2,1,0,,,,,,
179,299,82,181,298,80,,,-2,1,2,,,,,,
179,299,90,181,298,90,,,-2,1,0,,,,,,
180,299,102,181,298,104,,,-1,1,-2,,,,,,
180,299,118,181,298,118,,,-1,1,0,,,,,,
180,299,137,182,299,137,,,-2,0,0,,,,,,
180,299,157,182,299,156,,,-2,0,1,,,,,,
181,299,178,182,299,178,,,-1,0,0,,,,,,
181,300,200,183,299,199,,,-2,1,1,,,,,,
182,300,222,183,300,222,,,-1,0,0,,,,,,
182,300,245,184,300,245,,,-2,0,0,,,,,,
183,301,268,184,301,268,,,-1,0,0,,,,,,
184,301,292,185,301,292,,,-1,0,0,,,,,,
184,302,316,186,301,316,,,-2,1,0,,,,,,
185,302,340,187,302,340,,,-2,0,0,,,,,,
186,303,364,188,302,364,,,-2,1,0,,,,,,
187,303,389,189,303,388,,,-2,0,1,,,,,,
188,304,413,190,304,413,,,-2,0,0,,,,,,
190,305,438,191,305,437,,,-1,0,1,,,,,,
191,306,462,192,305,462,,,-1,1,0,,,,,,
192,306,487,193,306,487,,,-1,0,0,,,,,,
194,307,512,195,307,512,,,-1,0,0,,,,,,
195,308,537,196,308,537,,,-1,0,0,,,,,,
197,309,562,198,309,562,,,-1,0,0,,,,,,
198,310,587,200,310,587,,,-2,0,0,,,,,,
200,311,612,201,311,612,,,-1,0,0,,,,,,
202,312,637,203,312,637,,,-1,0,0,,,,,,
203,314,662,205,313,662,,,-2,1,0,,,,,,
205,315,688,207,315,687,,,-2,0,1,,,,,,
207,316,713,208,316,713,,,-1,0,0,,,,,,
209,317,738,210,317,738,,,-1,0,0,,,,,,
211,319,764,212,319,764,,,-1,0,0,,,,,,
194,327,88,195,327,87,,,-1,0,1,,,,,,
194,327,90,195,327,87,,,-1,0,3,,,,,,
194,327,97,195,327,96,,,-1,0,1,,,,,,
194,327,108,195,327,109,,,-1,0,-1,,,,,,
194,327,123,196,327,123,,,-2,0,0,,,,,,
195,327,141,196,327,141,,,-1,0,0,,,,,,
195,327,160,196,327,160,,,-1,0,0,,,,,,
195,328,181,197,327,181,,,-2,1,0,,,,,,
196,328,202,197,328,202,,,-1,0,0,,,,,,
196,328,225,198,328,225,,,-2,0,0,,,,,,
197,328,247,198,328,247,,,-1,0,0,,,,,,
197,329,271,199,329,270,,,-2,0,1,,,,,,
198,329,294,199,329,294,,,-1,0,0,,,,,,
199,330,318,200,329,317,,,-1,1,1,,,,,,
199,330,342,201,330,341,,,-2,0,1,,,,,,
200,331,366,201,330,365,,,-1,1,1,,,,,,
201,331,390,202,331,390,,,-1,0,0,,,,,,
202,332,414,203,332,414,,,-1,0,0,,,,,,
203,332,439,205,332,439,,,-2,0,0,,,,,,
205,333,463,206,333,463,,,-1,0,0,,,,,,
206,334,488,207,334,488,,,-1,0,0,,,,,,
207,335,513,208,334,513,,,-1,1,0,,,,,,
208,336,538,210,335,538,,,-2,1,0,,,,,,
210,336,563,211,336,563,,,-1,0,0,,,,,,
211,337,588,213,337,588,,,-2,0,0,,,,,,
213,338,613,214,338,613,,,-1,0,0,,,,,,
214,339,638,216,339,638,,,-2,0,0,,,,,,
216,340,663,217,340,663,,,-1,0,0,,,,,,
218,342,688,219,341,688,,,-1,1,0,,,,,,
220,343,714,221,342,713,,,-1,1,1,,,,,,
222,344,739,222,344,739,,,0,0,0,,,,,,
223,345,764,224,345,764,,,-1,0,0,,,,,,
209,355,95,210,355,95,,,-1,0,0,,,,,,
209,355,97,210,355,95,,,-1,0,2,,,,,,
209,355,103,210,355,103,,,-1,0,0,,,,,,
209,355,114,210,355,116,,,-1,0,-2,,,,,,
209,355,128,210,355,128,,,-1,0,0,,,,,,
209,356,145,211,355,146,,,-2,1,-1,,,,,,
210,356,164,211,355,164,,,-1,1,0,,,,,,
210,356,184,211,356,185,,,-1,0,-1,,,,,,
210,356,206,212,356,205,,,-2,0,1,,,,,,
211,356,227,212,356,227,,,-1,0,0,,,,,,
211,357,250,213,356,250,,,-2,1,0,,,,,,
212,357,273,213,357,273,,,-1,0,0,,,,,,
212,357,296,214,357,296,,,-2,0,0,,,,,,
213,358,320,214,357,319,,,-1,1,1,,,,,,
214,358,343,215,358,343,,,-1,0,0,,,,,,
215,359,367,216,358,367,,,-1,1,0,,,,,,
216,359,391,217,359,391,,,-1,0,0,,,,,,
216,360,416,218,360,415,,,-2,0,1,,,,,,
217,360,440,219,360,440,,,-2,0,0,,,,,,
219,361,465,220,361,464,,,-1,0,1,,,,,,
220,362,489,221,361,489,,,-1,1,0,,,,,,
221,362,514,222,362,514,,,-1,0,0,,,,,,
222,363,539,223,363,539,,,-1,0,0,,,,,,
223,364,564,225,364,564,,,-2,0,0,,,,,,
225,365,589,226,365,589,,,-1,0,0,,,,,,
226,366,614,228,366,614,,,-2,0,0,,,,,,
228,367,639,229,367,639,,,-1,0,0,,,,,,
229,368,664,231,367,664,,,-2,1,0,,,,,,
231,369,689,232,368,689,,,-1,1,0,,,,,,
233,370,715,234,369,714,,,-1,1,1,,,,,,
234,371,740,235,371,740,,,-1,0,0,,,,,,
236,372,765,237,372,765,,,-1,0,0,,,,,,
224,384,103,225,383,103,,,-1,1,0,,,,,,
224,384,104,225,383,103,,,-1,1,1,,,,,,
224,384,110,225,384,110,,,-1,0,0,,,,,,
224,384,120,225,384,122,,,-1,0,-2,,,,,,
224,384,134,225,384,134,,,-1,0,0,,,,,,
224,384,150,225,384,151,,,-1,0,-1,,,,,,
225,384,168,226,384,168,,,-1,0,0,,,,,,
225,384,188,226,384,188,,,-1,0,0,,,,,,
225,384,209,226,384,209,,,-1,0,0,,,,,,
226,385,230,227,384,230,,,-1,1,0,,,,,,
226,385,253,227,385,252,,,-1,0,1,,,,,,
227,385,275,228,385,275,,,-1,0,0,,,,,,
227,386,298,228,385,298,,,-1,1,0,,,,,,
228,386,322,229,386,321,,,-1,0,1,,,,,,
228,386,345,230,386,345,,,-2,0,0,,,,,,
229,387,369,230,387,369,,,-1,0,0,,,,,,
230,387,393,231,387,393,,,-1,0,0,,,,,,
231,388,417,232,388,417,,,-1,0,0,,,,,,
232,388,442,233,388,441,,,-1,0,1,,,,,,
233,389,466,234,389,466,,,-1,0,0,,,,,,
234,390,491,235,389,490,,,-1,1,1,,,,,,
235,390,515,236,390,515,,,-1,0,0,,,,,,
236,391,540,237,391,540,,,-1,0,0,,,,,,
237,392,565,238,391,565,,,-1,1,0,,,,,,
239,393,590,240,392,590,,,-1,1,0,,,,,,
240,393,615,241,393,615,,,-1,0,0,,,,,,
242,394,640,243,394,640,,,-1,0,0,,,,,,
243,395,665,244,395,665,,,-1,0,0,,,,,,
245,396,690,245,396,690,,,0,0,0,,,,,,
246,397,715,247,397,715,,,-1,0,0,,,,,,
248,398,741,249,398,741,,,-1,0,0,,,,,,
249,399,766,250,399,766,,,-1,0,0,,,,,,
239,412,110,240,412,110,,,-1,0,0,,,,,,
239,412,112,240,412,110,,,-1,0,2,,,,,,
239,412,117,240,412,117,,,-1,0,0,,,,,,
239,412,127,240,412,128,,,-1,0,-1,,,,,,
239,412,140,240,412,140,,,-1,0,0,,,,,,
239,413,155,240,412,156,,,-1,1,-1,,,,,,
240,413,173,241,412,173,,,-1,1,0,,,,,,
240,413,192,241,412,192,,,-1,1,0,,,,,,
240,413,212,241,413,212,,,-1,0,0,,,,,,
241,413,234,242,413,234,,,-1,0,0,,,,,,
241,413,255,242,413,255,,,-1,0,0,,,,,,
242,414,278,243,413,278,,,-1,1,0,,,,,,
242,414,301,243,414,300,,,-1,0,1,,,,,,
243,414,324,244,414,323,,,-1,0,1,,,,,,
243,415,347,244,415,347,,,-1,0,0,,,,,,
244,415,371,245,415,371,,,-1,0,0,,,,,,
245,416,395,246,415,395,,,-1,1,0,,,,,,
246,416,419,247,416,419,,,-1,0,0,,,,,,
246,417,443,247,416,443,,,-1,1,0,,,,,,
247,417,467,248,417,467,,,-1,0,0,,,,,,
248,418,492,249,417,491,,,-1,1,1,,,,,,
249,418,517,250,418,516,,,-1,0,1,,,,,,
251,419,541,251,419,541,,,0,0,0,,,,,,
252,420,566,253,419,566,,,-1,1,0,,,,,,
253,420,591,254,420,591,,,-1,0,0,,,,,,
254,421,616,255,421,616,,,-1,0,0,,,,,,
256,422,641,257,422,641,,,-1,0,0,,,,,,
257,423,666,258,423,666,,,-1,0,0,,,,,,
258,424,691,259,423,691,,,-1,1,0,,,,,,
260,425,716,261,424,716,,,-1,1,0,,,,,,
261,426,742,262,425,741,,,-1,1,1,,,,,,
263,427,767,264,426,766,,,-1,1,1,,,,,,
254,441,118,255,441,118,,,-1,0,0,,,,,,
254,441,119,255,441,118,,,-1,0,1,,,,,,
254,441,125,255,441,124,,,-1,0,1,,,,,,
254,441,133,255,441,135,,,-1,0,-2,,,,,,
255,441,146,255,441,146,,,0,0,0,,,,,,
255,441,161,256,441,162,,,-1,0,-1,,,,,,
255,441,178,256,441,178,,,-1,0,0,,,,,,
255,441,196,256,441,197,,,-1,0,-1,,,,,,
255,442,216,256,441,216,,,-1,1,0,,,,,,
256,442,237,257,441,237,,,-1,1,0,,,,,,
256,442,259,257,442,258,,,-1,0,1,,,,,,
257,442,281,258,442,280,,,-1,0,1,,,,,,
257,443,303,258,442,303,,,-1,1,0,,,,,,
258,443,326,259,443,326,,,-1,0,0,,,,,,
258,443,349,259,443,349,,,-1,0,0,,,,,,
259,444,373,260,443,373,,,-1,1,0,,,,,,
260,444,397,261,444,397,,,-1,0,0,,,,,,
260,444,421,261,444,421,,,-1,0,0,,,,,,
261,445,445,262,445,445,,,-1,0,0,,,,,,
262,445,469,263,445,469,,,-1,0,0,,,,,,
263,446,493,264,446,493,,,-1,0,0,,,,,,
264,447,518,265,446,518,,,-1,1,0,,,,,,
265,447,543,266,447,543,,,-1,0,0,,,,,,
266,448,567,267,447,567,,,-1,1,0,,,,,,
267,449,592,268,448,592,,,-1,1,0,,,,,,
269,449,617,269,449,617,,,0,0,0,,,,,,
270,450,642,271,450,642,,,-1,0,0,,,,,,
271,451,667,272,450,667,,,-1,1,0,,,,,,
272,452,692,274,451,692,,,-2,1,0,,,,,,
274,452,717,275,452,717,,,-1,0,0,,,,,,
275,453,742,276,453,742,,,-1,0,0,,,,,,
277,454,768,278,454,767,,,-1,0,1,,,,,,
270,470,126,271,469,125,,,-1,1,1,,,,,,
270,470,127,271,469,125,,,-1,1,2,,,,,,
270,470,132,271,469,131,,,-1,1,1,,,,,,
270,470,140,271,469,141,,,-1,1,-1,,,,,,
270,470,152,271,469,152,,,-1,1,0,,,,,,
270,470,166,271,470,167,,,-1,0,-1,,,,,,
270,470,183,271,470,183,,,-1,0,0,,,,,,
271,470,201,271,470,201,,,0,0,0,,,,,,
271,470,220,272,470,220,,,-1,0,0,,,,,,
271,470,241,272,470,241,,,-1,0,0,,,,,,
272,471,262,272,470,261,,,0,1,1,,,,,,
272,471,284,273,471,283,,,-1,0,1,,,,,,
272,471,306,273,471,306,,,-1,0,0,,,,,,
273,471,329,274,471,328,,,-1,0,1,,,,,,
274,472,352,274,472,351,,,0,0,1,,,,,,
274,472,375,275,472,375,,,-1,0,0,,,,,,
275,473,399,276,472,399,,,-1,1,0,,,,,,
276,473,423,276,473,422,,,0,0,1,,,,,,
276,473,447,277,473,446,,,-1,0,1,,,,,,
277,474,471,278,474,470,,,-1,0,1,,,,,,
278,474,495,279,474,495,,,-1,0,0,,,,,,
279,475,519,280,475,519,,,-1,0,0,,,,,,
280,475,544,280,475,544,,,0,0,0,,,,,,
281,476,569,281,476,569,,,0,0,0,,,,,,
282,477,593,283,476,593,,,-1,1,0,,,,,,
283,477,618,284,477,618,,,-1,0,0,,,,,,
284,478,643,285,478,643,,,-1,0,0,,,,,,
286,479,668,286,479,668,,,0,0,0,,,,,,
287,480,693,288,479,693,,,-1,1,0,,,,,,
288,480,718,289,480,718,,,-1,0,0,,,,,,
289,481,743,290,481,743,,,-1,0,0,,,,,,
291,482,769,292,482,768,,,-1,0,1,,,,,,
285,498,133,286,498,133,,,-1,0,0,,,,,,
285,498,135,286,498,133,,,-1,0,2,,,,,,
285,498,139,286,498,139,,,-1,0,0,,,,,,
285,498,147,286,498,148,,,-1,0,-1,,,,,,
285,499,158,286,498,158,,,-1,1,0,,,,,,
286,499,172,286,498,173,,,0,1,-1,,,,,,
286,499,188,287,499,188,,,-1,0,0,,,,,,
286,499,205,287,499,206,,,-1,0,-1,,,,,,
286,499,224,287,499,224,,,-1,0,0,,,,,,
287,499,244,287,499,244,,,0,0,0,,,,,,
287,499,265,288,499,265,,,-1,0,0,,,,,,
287,500,287,288,499,287,,,-1,1,0,,,,,,
288,500,309,288,500,309,,,0,0,0,,,,,,
288,500,331,289,500,331,,,-1,0,0,,,,,,
289,500,354,289,500,354,,,0,0,0,,,,,,
289,501,377,290,500,377,,,-1,1,0,,,,,,
290,501,401,291,501,401,,,-1,0,0,,,,,,
291,502,425,292,501,424,,,-1,1,1,,,,,,
291,502,448,292,502,448,,,-1,0,0,,,,,,
292,502,473,293,502,472,,,-1,0,1,,,,,,
293,503,497,294,503,497,,,-1,0,0,,,,,,
294,503,521,295,503,521,,,-1,0,0,,,,,,
295,504,546,295,504,546,,,0,0,0,,,,,,
296,504,570,296,504,570,,,0,0,0,,,,,,
297,505,595,297,505,595,,,0,0,0,,,,,,
298,506,620,298,505,619,,,0,1,1,,,,,,
299,506,644,300,506,644,,,-1,0,0,,,,,,
300,507,669,301,507,669,,,-1,0,0,,,,,,
301,508,694,302,508,694,,,-1,0,0,,,,,,
303,508,719,303,508,719,,,0,0,0,,,,,,
304,509,745,305,509,745,,,-1,0,0,,,,,,
305,510,770,306,510,770,,,-1,0,0,,,,,,
301,527,141,302,527,141,,,-1,0,0,,,,,,
301,527,142,302,527,141,,,-1,0,1,,,,,,
301,527,146,302,527,146,,,-1,0,0,,,,,,
301,527,154,302,527,155,,,-1,0,-1,,,,,,
301,527,165,302,527,164,,,-1,0,1,,,,,,
301,527,178,302,527,179,,,-1,0,-1,,,,,,
301,528,193,302,527,193,,,-1,1,0,,,,,,
302,528,210,302,527,211,,,0,1,-1,,,,,,
302,528,229,303,528,229,,,-1,0,0,,,,,,
302,528,248,303,528,249,,,-1,0,-1,,,,,,
302,528,269,303,528,269,,,-1,0,0,,,,,,
303,528,290,303,528,290,,,0,0,0,,,,,,
303,529,312,304,528,312,,,-1,1,0,,,,,,
304,529,334,304,529,334,,,0,0,0,,,,,,
304,529,357,305,529,357,,,-1,0,0,,,,,,
305,530,380,306,529,380,,,-1,1,0,,,,,,
305,530,403,306,529,403,,,-1,1,0,,,,,,
306,530,427,307,530,427,,,-1,0,0,,,,,,
307,531,451,307,530,450,,,0,1,1,,,,,,
307,531,474,308,531,474,,,-1,0,0,,,,,,
308,531,499,309,531,498,,,-1,0,1,,,,,,
309,532,523,310,532,523,,,-1,0,0,,,,,,
310,532,547,310,532,547,,,0,0,0,,,,,,
311,533,572,311,533,572,,,0,0,0,,,,,,
312,534,596,312,533,596,,,0,1,0,,,,,,
313,534,621,313,534,621,,,0,0,0,,,,,,
314,535,646,315,534,645,,,-1,1,1,,,,,,
315,535,671,316,535,670,,,-1,0,1,,,,,,
316,536,696,317,536,695,,,-1,0,1,,,,,,
317,537,721,318,536,720,,,-1,1,1,,,,,,
319,537,746,319,537,746,,,0,0,0,,,,,,
320,538,771,320,538,771,,,0,0,0,,,,,,
317,556,149,318,556,149,,,-1,0,0,,,,,,
317,556,150,318,556,149,,,-1,0,1,,,,,,
317,556,154,318,556,154,,,-1,0,0,,,,,,
317,556,161,318,556,162,,,-1,0,-1,,,,,,
317,556,171,318,556,171,,,-1,0,0,,,,,,
317,556,184,318,556,185,,,-1,0,-1,,,,,,
317,556,199,318,556,199,,,-1,0,0,,,,,,
317,557,215,318,556,216,,,-1,1,-1,,,,,,
318,557,233,318,557,233,,,0,0,0,,,,,,
318,557,253,318,557,253,,,0,0,0,,,,,,
318,557,273,319,557,273,,,-1,0,0,,,,,,
318,557,294,319,557,294,,,-1,0,0,,,,,,
319,557,315,320,557,315,,,-1,0,0,,,,,,
319,558,337,320,557,337,,,-1,1,0,,,,,,
320,558,360,321,558,360,,,-1,0,0,,,,,,
320,558,383,321,558,383,,,-1,0,0,,,,,,
321,559,406,322,558,406,,,-1,1,0,,,,,,
321,559,429,322,559,429,,,-1,0,0,,,,,,
322,559,453,323,559,453,,,-1,0,0,,,,,,
323,560,477,323,559,476,,,0,1,1,,,,,,
324,560,501,324,560,500,,,0,0,1,,,,,,
324,561,525,325,560,524,,,-1,1,1,,,,,,
325,561,549,326,561,549,,,-1,0,0,,,,,,
326,562,573,327,561,573,,,-1,1,0,,,,,,
327,562,598,328,562,598,,,-1,0,0,,,,,,
328,563,623,329,562,622,,,-1,1,1,,,,,,
329,563,647,330,563,647,,,-1,0,0,,,,,,
330,564,672,331,563,672,,,-1,1,0,,,,,,
331,564,697,332,564,697,,,-1,0,0,,,,,,
332,565,722,333,565,722,,,-1,0,0,,,,,,
333,566,747,334,566,747,,,-1,0,0,,,,,,
335,567,772,335,566,772,,,0,1,0,,,,,,
332,585,157,333,585,156,,,-1,0,1,,,,,,
332,585,158,333,585,156,,,-1,0,2,,,,,,
332,585,161,333,585,161,,,-1,0,0,,,,,,
332,585,168,333,585,169,,,-1,0,-1,,,,,,
333,585,178,333,585,177,,,0,0,1,,,,,,
333,585,190,333,585,191,,,0,0,-1,,,,,,
333,585,204,333,585,204,,,0,0,0,,,,,,
333,586,221,333,585,221,,,0,1,0,,,,,,
333,586,238,334,586,238,,,-1,0,0,,,,,,
334,586,257,334,586,257,,,0,0,0,,,,,,
334,586,277,334,586,277,,,0,0,0,,,,,,
334,586,297,335,586,297,,,-1,0,0,,,,,,
335,586,319,335,586,318,,,0,0,1,,,,,,
335,587,340,336,586,340,,,-1,1,0,,,,,,
335,587,363,336,587,363,,,-1,0,0,,,,,,
336,587,385,336,587,385,,,0,0,0,,,,,,
336,587,408,337,587,408,,,-1,0,0,,,,,,
337,588,432,338,587,431,,,-1,1,1,,,,,,
338,588,455,338,588,455,,,0,0,0,,,,,,
338,589,479,339,588,478,,,-1,1,1,,,,,,
339,589,503,340,589,502,,,-1,0,1,,,,,,
340,589,527,340,589,526,,,0,0,1,,,,,,
340,590,551,341,589,551,,,-1,1,0,,,,,,
341,590,575,342,590,575,,,-1,0,0,,,,,,
342,591,600,343,590,599,,,-1,1,1,,,,,,
343,591,624,344,591,624,,,-1,0,0,,,,,,
344,592,649,345,591,648,,,-1,1,1,,,,,,
345,592,674,346,592,673,,,-1,0,1,,,,,,
346,593,698,347,593,698,,,-1,0,0,,,,,,
347,594,723,348,593,723,,,-1,1,0,,,,,,
348,594,748,349,594,748,,,-1,0,0,,,,,,
349,595,773,350,595,773,,,-1,0,0,,,,,,
348,614,164,349,614,164,,,-1,0,0,,,,,,
348,614,165,349,614,164,,,-1,0,1,,,,,,
348,614,169,349,614,169,,,-1,0,0,,,,,,
348,614,175,349,614,176,,,-1,0,-1,,,,,,
348,614,185,349,614,184,,,-1,0,1,,,,,,
349,614,196,349,614,197,,,0,0,-1,,,,,,
349,614,210,349,614,210,,,0,0,0,,,,,,
349,615,226,349,614,226,,,0,1,0,,,,,,
349,615,243,349,615,243,,,0,0,0,,,,,,
349,615,262,350,615,262,,,-1,0,0,,,,,,
350,615,281,350,615,281,,,0,0,0,,,,,,
350,615,301,351,615,301,,,-1,0,0,,,,,,
350,615,322,351,615,322,,,-1,0,0,,,,,,
351,616,344,351,615,344,,,0,1,0,,,,,,
351,616,366,351,616,366,,,0,0,0,,,,,,
352,616,388,352,616,388,,,0,0,0,,,,,,
352,616,411,352,616,411,,,0,0,0,,,,,,
353,617,434,353,616,434,,,0,1,0,,,,,,
353,617,457,354,617,457,,,-1,0,0,,,,,,
354,617,481,355,617,481,,,-1,0,0,,,,,,
354,618,505,355,618,505,,,-1,0,0,,,,,,
355,618,529,356,618,529,,,-1,0,0,,,,,,
356,619,553,356,618,553,,,0,1,0,,,,,,
357,619,577,357,619,577,,,0,0,0,,,,,,
358,620,601,358,619,601,,,0,1,0,,,,,,
358,620,626,359,620,625,,,-1,0,1,,,,,,
359,621,650,360,620,650,,,-1,1,0,,,,,,
360,621,675,361,621,675,,,-1,0,0,,,,,,
361,622,700,362,621,700,,,-1,1,0,,,,,,
362,622,725,363,622,725,,,-1,0,0,,,,,,
363,623,750,364,623,750,,,-1,0,0,,,,,,
364,623,775,365,623,775,,,-1,0,0,,,,,,
364,643,172,365,643,172,,,-1,0,0,,,,,,
364,643,173,365,643,172,,,-1,0,1,,,,,,
364,643,176,365,643,176,,,-1,0,0,,,,,,
364,643,183,365,643,184,,,-1,0,-1,,,,,,
364,643,191,365,643,191,,,-1,0,0,,,,,,
364,643,203,365,643,203,,,-1,0,0,,,,,,
365,644,216,365,643,216,,,0,1,0,,,,,,
365,644,231,365,643,232,,,0,1,-1,,,,,,
365,644,248,365,644,248,,,0,0,0,,,,,,
365,644,266,366,644,266,,,-1,0,0,,,,,,
365,644,285,366,644,285,,,-1,0,0,,,,,,
366,644,305,366,644,305,,,0,0,0,,,,,,
366,644,326,367,644,326,,,-1,0,0,,,,,,
366,645,347,367,644,347,,,-1,1,0,,,,,,
367,645,369,367,645,369,,,0,0,0,,,,,,
367,645,391,367,645,391,,,0,0,0,,,,,,
368,645,414,368,645,414,,,0,0,0,,,,,,
368,646,437,369,645,437,,,-1,1,0,,,,,,
369,646,460,369,646,460,,,0,0,0,,,,,,
369,646,483,370,646,483,,,-1,0,0,,,,,,
370,647,507,371,647,507,,,-1,0,0,,,,,,
371,647,531,371,647,531,,,0,0,0,,,,,,
371,647,555,372,647,555,,,-1,0,0,,,,,,
372,648,579,373,647,579,,,-1,1,0,,,,,,
373,648,603,373,648,603,,,0,0,0,,,,,,
374,649,628,374,648,627,,,0,1,1,,,,,,
375,649,652,375,649,652,,,0,0,0,,,,,,
376,650,677,376,649,676,,,0,1,1,,,,,,
377,650,701,377,650,701,,,0,0,0,,,,,,
378,651,726,378,650,726,,,0,1,0,,,,,,
379,651,751,379,651,751,,,0,0,0,,,,,,
380,652,776,380,652,776,,,0,0,0,,,,,,
380,672,180,381,672,180,,,-1,0,0,,,,,,
380,672,181,381,672,180,,,-1,0,1,,,,,,
380,672,184,381,672,184,,,-1,0,0,,,,,,
380,673,190,381,672,191,,,-1,1,-1,,,,,,
380,673,198,381,672,198,,,-1,1,0,,,,,,
380,673,209,381,672,210,,,-1,1,-1,,,,,,
380,673,222,381,673,222,,,-1,0,0,,,,,,
381,673,237,381,673,237,,,0,0,0,,,,,,
381,673,253,382,673,253,,,-1,0,0,,,,,,
381,673,271,382,673,271,,,-1,0,0,,,,,,
381,673,290,382,673,290,,,-1,0,0,,,,,,
382,673,310,382,673,310,,,0,0,0,,,,,,
382,674,330,383,673,330,,,-1,1,0,,,,,,
382,674,351,383,673,351,,,-1,1,0,,,,,,
383,674,372,383,674,372,,,0,0,0,,,,,,
383,674,394,383,674,394,,,0,0,0,,,,,,
384,674,417,384,674,417,,,0,0,0,,,,,,
384,675,440,384,674,440,,,0,1,0,,,,,,
385,675,463,385,675,463,,,0,0,0,,,,,,
385,675,486,386,675,486,,,-1,0,0,,,,,,
386,676,509,387,676,509,,,-1,0,0,,,,,,
386,676,533,387,676,533,,,-1,0,0,,,,,,
387,676,557,388,676,557,,,-1,0,0,,,,,,
388,677,581,388,676,581,,,0,1,0,,,,,,
389,677,605,389,677,605,,,0,0,0,,,,,,
389,678,630,390,677,629,,,-1,1,1,,,,,,
390,678,654,391,678,654,,,-1,0,0,,,,,,
391,679,678,392,678,678,,,-1,1,0,,,,,,
392,679,703,393,679,703,,,-1,0,0,,,,,,
393,680,728,394,679,728,,,-1,1,0,,,,,,
394,680,753,395,680,753,,,-1,0,0,,,,,,
395,681,778,396,680,778,,,-1,1,0,,,,,,
396,702,188,397,701,187,,,-1,1,1,,,,,,
396,702,188,397,701,187,,,-1,1,1,,,,,,
396,702,192,397,701,191,,,-1,1,1,,,,,,
396,702,197,397,701,198,,,-1,1,-1,,,,,,
396,702,205,397,701,205,,,-1,1,0,,,,,,
396,702,216,397,701,217,,,-1,1,-1,,,,,,
396,702,228,397,702,228,,,-1,0,0,,,,,,
397,702,243,397,702,243,,,0,0,0,,,,,,
397,702,259,397,702,258,,,0,0,1,,,,,,
397,702,276,397,702,276,,,0,0,0,,,,,,
397,702,295,398,702,294,,,-1,0,1,,,,,,
398,702,314,398,702,314,,,0,0,0,,,,,,
398,703,334,398,702,334,,,0,1,0,,,,,,
398,703,355,399,702,355,,,-1,1,0,,,,,,
399,703,376,399,703,376,,,0,0,0,,,,,,
399,703,398,399,703,398,,,0,0,0,,,,,,
399,704,420,400,703,420,,,-1,1,0,,,,,,
400,704,443,400,703,442,,,0,1,1,,,,,,
400,704,465,401,704,465,,,-1,0,0,,,,,,
401,704,489,401,704,488,,,0,0,1,,,,,,
402,705,512,402,705,511,,,0,0,1,,,,,,
402,705,535,403,705,535,,,-1,0,0,,,,,,
403,705,559,403,705,559,,,0,0,0,,,,,,
404,706,583,404,705,583,,,0,1,0,,,,,,
404,706,607,404,706,607,,,0,0,0,,,,,,
405,707,631,405,706,631,,,0,1,0,,,,,,
406,707,656,406,707,656,,,0,0,0,,,,,,
407,708,680,407,707,680,,,0,1,0,,,,,,
407,708,705,408,708,705,,,-1,0,0,,,,,,
408,709,730,409,708,729,,,-1,1,1,,,,,,
409,709,754,410,709,754,,,-1,0,0,,,,,,
410,710,779,411,709,779,,,-1,1,0,,,,,,
412,731,195,413,731,195,,,-1,0,0,,,,,,
412,731,196,413,731,195,,,-1,0,1,,,,,,
412,731,199,413,731,199,,,-1,0,0,,,,,,
412,731,205,413,731,205,,,-1,0,0,,,,,,
412,731,212,413,731,212,,,-1,0,0,,,,,,
412,731,223,413,731,223,,,-1,0,0,,,,,,
413,731,235,413,731,235,,,0,0,0,,,,,,
413,731,249,413,731,249,,,0,0,0,,,,,,
413,731,264,413,731,264,,,0,0,0,,,,,,
413,731,281,413,731,281,,,0,0,0,,,,,,
413,732,299,414,731,299,,,-1,1,0,,,,,,
414,732,318,414,731,318,,,0,1,0,,,,,,
414,732,338,414,732,338,,,0,0,0,,,,,,
414,732,359,415,732,359,,,-1,0,0,,,,,,
415,732,380,415,732,380,,,0,0,0,,,,,,
415,732,401,415,732,401,,,0,0,0,,,,,,
415,733,423,416,733,423,,,-1,0,0,,,,,,
416,733,446,416,733,445,,,0,0,1,,,,,,
416,733,468,417,733,468,,,-1,0,0,,,,,,
417,734,491,417,733,491,,,0,1,0,,,,,,
417,734,514,418,734,514,,,-1,0,0,,,,,,
418,734,538,418,734,538,,,0,0,0,,,,,,
419,735,562,419,734,562,,,0,1,0,,,,,,
419,735,585,420,734,585,,,-1,1,0,,,,,,
420,735,609,420,735,609,,,0,0,0,,,,,,
421,736,634,421,735,633,,,0,1,1,,,,,,
421,736,658,422,736,658,,,-1,0,0,,,,,,
422,737,682,422,736,682,,,0,1,0,,,,,,
423,737,707,423,737,707,,,0,0,0,,,,,,
424,738,731,424,737,731,,,0,1,0,,,,,,
425,738,756,425,738,756,,,0,0,0,,,,,,
426,739,781,426,738,781,,,0,1,0,,,,,,
428,760,203,429,760,203,,,-1,0,0,,,,,,
428,760,204,429,760,203,,,-1,0,1,,,,,,
428,760,207,429,760,206,,,-1,0,1,,,,,,
428,760,212,429,760,213,,,-1,0,-1,,,,,,
428,760,220,429,760,219,,,-1,0,1,,,,,,
429,760,229,429,760,230,,,0,0,-1,,,,,,
429,760,241,429,760,241,,,0,0,0,,,,,,
429,760,255,429,760,255,,,0,0,0,,,,,,
429,761,270,429,760,270,,,0,1,0,,,,,,
429,761,287,429,760,287,,,0,1,0,,,,,,
429,761,304,430,760,304,,,-1,1,0,,,,,,
430,761,323,430,761,323,,,0,0,0,,,,,,
430,761,342,430,761,342,,,0,0,0,,,,,,
430,761,363,431,761,363,,,-1,0,0,,,,,,
431,761,383,431,761,383,,,0,0,0,,,,,,
431,762,405,431,761,405,,,0,1,0,,,,,,
431,762,427,432,762,426,,,-1,0,1,,,,,,
432,762,449,432,762,448,,,0,0,1,,,,,,
432,762,471,432,762,471,,,0,0,0,,,,,,
433,763,494,433,762,494,,,0,1,0,,,,,,
433,763,517,433,763,517,,,0,0,0,,,,,,
434,763,541,434,763,540,,,0,0,1,,,,,,
434,764,564,435,763,564,,,-1,1,0,,,,,,
435,764,588,435,764,588,,,0,0,0,,,,,,
436,764,612,436,764,611,,,0,0,1,,,,,,
436,765,636,437,764,635,,,-1,1,1,,,,,,
437,765,660,437,765,660,,,0,0,0,,,,,,
438,766,684,438,765,684,,,0,1,0,,,,,,
439,766,709,439,766,709,,,0,0,0,,,,,,
440,767,733,440,766,733,,,0,1,0,,,,,,
440,767,758,441,767,758,,,-1,0,0,,,,,,
441,768,782,442,767,782,,,-1,1,0,,,,,,
444,790,211,445,789,211,,,-1,1,0,,,,,,
444,790,212,445,789,211,,,-1,1,1,,,,,,
444,790,215,445,789,214,,,-1,1,1,,,,,,
444,790,220,445,789,220,,,-1,1,0,,,,,,
445,790,227,445,790,227,,,0,0,0,,,,,,
445,790,236,445,790,237,,,0,0,-1,,,,,,
445,790,248,445,790,248,,,0,0,0,,,,,,
445,790,261,445,790,262,,,0,0,-1,,,,,,
445,790,276,445,790,276,,,0,0,0,,,,,,
445,790,292,446,790,292,,,-1,0,0,,,,,,
445,790,309,446,790,309,,,-1,0,0,,,,,,
446,790,328,446,790,328,,,0,0,0,,,,,,
446,790,347,446,790,347,,,0,0,0,,,,,,
446,791,367,447,790,367,,,-1,1,0,,,,,,
447,791,387,447,791,387,,,0,0,0,,,,,,
447,791,408,447,791,408,,,0,0,0,,,,,,
447,791,430,448,791,430,,,-1,0,0,,,,,,
448,791,452,448,791,452,,,0,0,0,,,,,,
448,792,474,448,792,474,,,0,0,0,,,,,,
449,792,497,449,792,497,,,0,0,0,,,,,,
449,792,520,449,792,520,,,0,0,0,,,,,,
450,793,543,450,792,543,,,0,1,0,,,,,,
450,793,567,451,793,567,,,-1,0,0,,,,,,
451,793,590,451,793,590,,,0,0,0,,,,,,
452,794,614,452,793,614,,,0,1,0,,,,,,
452,794,638,453,793,638,,,-1,1,0,,,,,,
453,794,662,453,794,662,,,0,0,0,,,,,,
454,795,686,454,794,686,,,0,1,0,,,,,,
454,795,711,455,795,711,,,-1,0,0,,,,,,
455,796,735,455,795,735,,,0,1,0,,,,,,
456,796,760,456,796,760,,,0,0,0,,,,,,
457,797,784,457,796,784,,,0,1,0,,,,,,
461,819,219,461,818,219,,,0,1,0,,,,,,
461,819,220,461,818,219,,,0,1,1,,,,,,
461,819,222,461,818,222,,,0,1,0,,,,,,
461,819,227,461,819,228,,,0,0,-1,,,,,,
461,819,234,461,819,234,,,0,0,0,,,,,,
461,819,243,461,819,244,,,0,0,-1,,,,,,
461,819,254,461,819,254,,,0,0,0,,,,,,
461,819,267,461,819,268,,,0,0,-1,,,,,,
461,819,282,461,819,282,,,0,0,0,,,,,,
461,819,297,462,819,298,,,-1,0,-1,,,,,,
462,819,314,462,819,314,,,0,0,0,,,,,,
462,820,332,462,819,333,,,0,1,-1,,,,,,
462,820,351,462,819,351,,,0,1,0,,,,,,
462,820,371,463,820,371,,,-1,0,0,,,,,,
463,820,391,463,820,391,,,0,0,0,,,,,,
463,820,412,463,820,412,,,0,0,0,,,,,,
463,820,434,464,820,433,,,-1,0,1,,,,,,
464,821,455,464,820,455,,,0,1,0,,,,,,
464,821,478,464,821,477,,,0,0,1,,,,,,
465,821,500,465,821,500,,,0,0,0,,,,,,
465,821,523,465,821,523,,,0,0,0,,,,,,
466,822,546,466,821,546,,,0,1,0,,,,,,
466,822,569,467,822,569,,,-1,0,0,,,,,,
467,822,593,467,822,593,,,0,0,0,,,,,,
467,823,616,468,822,616,,,-1,1,0,,,,,,
468,823,640,468,823,640,,,0,0,0,,,,,,
469,823,664,469,823,664,,,0,0,0,,,,,,
470,824,688,470,823,688,,,0,1,0,,,,,,
470,824,713,471,824,713,,,-1,0,0,,,,,,
471,825,737,471,824,737,,,0,1,0,,,,,,
472,825,762,472,825,762,,,0,0,0,,,,,,
473,826,786,473,825,786,,,0,1,0,,,,,,
477,848,227,477,848,227,,,0,0,0,,,,,,
477,848,227,477,848,227,,,0,0,0,,,,,,
477,848,230,477,848,230,,,0,0,0,,,,,,
477,848,235,477,848,235,,,0,0,0,,,,,,
477,848,241,477,848,241,,,0,0,0,,,,,,
477,848,250,477,848,251,,,0,0,-1,,,,,,
477,849,261,478,848,261,,,-1,1,0,,,,,,
477,849,273,478,848,274,,,-1,1,-1,,,,,,
477,849,288,478,849,288,,,-1,0,0,,,,,,
478,849,303,478,849,304,,,0,0,-1,,,,,,
478,849,320,478,849,320,,,0,0,0,,,,,,
478,849,337,478,849,338,,,0,0,-1,,,,,,
478,849,356,479,849,356,,,-1,0,0,,,,,,
479,849,376,479,849,376,,,0,0,0,,,,,,
479,849,396,479,849,396,,,0,0,0,,,,,,
479,850,416,479,849,416,,,0,1,0,,,,,,
480,850,437,480,850,437,,,0,0,0,,,,,,
480,850,459,480,850,459,,,0,0,0,,,,,,
480,850,481,481,850,481,,,-1,0,0,,,,,,
481,851,503,481,850,503,,,0,1,0,,,,,,
481,851,526,482,851,526,,,-1,0,0,,,,,,
482,851,549,482,851,549,,,0,0,0,,,,,,
482,851,572,483,851,572,,,-1,0,0,,,,,,
483,852,595,483,851,595,,,0,1,0,,,,,,
483,852,619,484,852,619,,,-1,0,0,,,,,,
484,852,643,484,852,643,,,0,0,0,,,,,,
485,853,667,485,853,667,,,0,0,0,,,,,,
485,853,691,486,853,691,,,-1,0,0,,,,,,
486,854,715,487,853,715,,,-1,1,0,,,,,,
487,854,739,487,853,739,,,0,1,0,,,,,,
488,854,764,488,854,764,,,0,0,0,,,,,,
488,855,788,489,854,788,,,-1,1,0,,,,,,
493,878,235,493,877,234,,,0,1,1,,,,,,
493,878,235,493,877,234,,,0,1,1,,,,,,
493,878,238,493,877,237,,,0,1,1,,,,,,
493,878,242,493,877,243,,,0,1,-1,,,,,,
493,878,249,493,877,248,,,0,1,1,,,,,,
493,878,257,493,877,258,,,0,1,-1,,,,,,
493,878,268,494,878,267,,,-1,0,1,,,,,,
494,878,280,494,878,280,,,0,0,0,,,,,,
494,878,294,494,878,294,,,0,0,0,,,,,,
494,878,309,494,878,309,,,0,0,0,,,,,,
494,878,325,494,878,325,,,0,0,0,,,,,,
494,878,343,494,878,343,,,0,0,0,,,,,,
494,879,361,495,878,361,,,-1,1,0,,,,,,
495,879,380,495,878,380,,,0,1,0,,,,,,
495,879,400,495,878,400,,,0,1,0,,,,,,
495,879,420,496,879,420,,,-1,0,0,,,,,,
496,879,441,496,879,441,,,0,0,0,,,,,,
496,879,463,496,879,462,,,0,0,1,,,,,,
496,880,484,497,879,484,,,-1,1,0,,,,,,
497,880,507,497,880,506,,,0,0,1,,,,,,
497,880,529,498,880,529,,,-1,0,0,,,,,,
498,880,552,498,880,552,,,0,0,0,,,,,,
498,881,575,499,880,575,,,-1,1,0,,,,,,
499,881,598,499,881,598,,,0,0,0,,,,,,
499,881,622,500,881,621,,,-1,0,1,,,,,,
500,882,645,500,881,645,,,0,1,0,,,,,,
501,882,669,501,882,669,,,0,0,0,,,,,,
501,882,693,501,882,693,,,0,0,0,,,,,,
502,883,717,502,882,717,,,0,1,0,,,,,,
503,883,741,503,883,741,,,0,0,0,,,,,,
503,884,766,504,883,766,,,-1,1,0,,,,,,
504,884,790,504,884,790,,,0,0,0,,,,,,
99,27,15,99,27,15,,,0,0,0,,,,,,
99,28,25,99,27,15,,,0,1,10,,,,,,
99,28,45,99,28,45,,,0,0,0,,,,,,
100,29,68,99,29,68,,,1,0,0,,,,,,
100,30,91,100,30,91,,,0,0,0,,,,,,
100,32,114,100,32,114,,,0,0,0,,,,,,
101,34,138,101,34,138,,,0,0,0,,,,,,
102,37,162,102,36,162,,,0,1,0,,,,,,
103,39,186,103,39,186,,,0,0,0,,,,,,
104,42,210,104,42,210,,,0,0,0,,,,,,
105,45,234,105,45,234,,,0,0,0,,,,,,
106,49,259,106,48,258,,,0,1,1,,,,,,
107,52,283,107,52,283,,,0,0,0,,,,,,
109,55,308,108,55,308,,,1,0,0,,,,,,
110,59,333,110,59,333,,,0,0,0,,,,,,
112,62,357,112,62,357,,,0,0,0,,,,,,
114,66,382,114,66,382,,,0,0,0,,,,,,
116,69,407,116,69,407,,,0,0,0,,,,,,
118,73,432,118,73,432,,,0,0,0,,,,,,
120,77,457,120,77,457,,,0,0,0,,,,,,
122,81,482,122,81,482,,,0,0,0,,,,,,
124,84,507,124,84,507,,,0,0,0,,,,,,
127,88,532,127,88,532,,,0,0,0,,,,,,
129,92,558,129,92,557,,,0,0,1,,,,,,
132,96,583,132,96,583,,,0,0,0,,,,,,
134,100,608,134,100,608,,,0,0,0,,,,,,
137,104,634,137,104,634,,,0,0,0,,,,,,
140,107,659,139,107,659,,,1,0,0,,,,,,
142,111,684,142,111,684,,,0,0,0,,,,,,
145,115,710,145,115,709,,,0,0,1,,,,,,
148,119,735,148,119,735,,,0,0,0,,,,,,
151,123,761,151,123,760,,,0,0,1,,,,,,
100,36,16,99,27,15,,,1,9,1,,,,,,
100,36,26,99,27,15,,,1,9,11,,,,,,
100,36,46,99,28,45,,,1,8,1,,,,,,
100,37,68,99,29,68,,,1,8,0,,,,,,
101,38,91,100,30,91,,,1,8,0,,,,,,
101,39,114,100,32,114,,,1,7,0,,,,,,
102,41,138,101,34,138,,,1,7,0,,,,,,
102,43,162,102,36,162,,,0,7,0,,,,,,
103,45,186,103,39,186,,,0,6,0,,,,,,
104,48,210,104,42,210,,,0,6,0,,,,,,
105,51,234,105,45,234,,,0,6,0,,,,,,
106,53,259,106,48,258,,,0,5,1,,,,,,
108,56,283,107,52,283,,,1,4,0,,,,,,
109,59,308,108,55,308,,,1,4,0,,,,,,
111,63,333,110,59,333,,,1,4,0,,,,,,
112,66,357,112,62,357,,,0,4,0,,,,,,
114,69,382,114,66,382,,,0,3,0,,,,,,
116,73,407,116,69,407,,,0,4,0,,,,,,
118,76,432,118,73,432,,,0,3,0,,,,,,
120,80,457,120,77,457,,,0,3,0,,,,,,
122,83,482,122,81,482,,,0,2,0,,,,,,
125,87,507,124,84,507,,,1,3,0,,,,,,
127,91,532,127,88,532,,,0,3,0,,,,,,
130,94,558,129,92,557,,,1,2,1,,,,,,
132,98,583,132,96,583,,,0,2,0,,,,,,
135,102,608,134,100,608,,,1,2,0,,,,,,
137,106,634,137,104,634,,,0,2,0,,,,,,
140,110,659,139,107,659,,,1,3,0,,,,,,
143,113,684,142,111,684,,,1,2,0,,,,,,
146,117,710,145,115,709,,,1,2,1,,,,,,
149,121,735,148,119,735,,,1,2,0,,,,,,
152,125,761,151,123,760,,,1,2,1,,,,,,
102,56,20,102,56,20,,,0,0,0,,,,,,
102,56,28,102,56,20,,,0,0,8,,,,,,
102,56,47,102,56,47,,,0,0,0,,,,,,
103,57,69,102,57,69,,,1,0,0,,,,,,
103,58,91,103,58,91,,,0,0,0,,,,,,
103,58,115,103,59,114,,,0,-1,1,,,,,,
104,60,138,104,60,138,,,0,0,0,,,,,,
105,61,162,105,61,162,,,0,0,0,,,,,,
106,63,186,106,63,186,,,0,0,0,,,,,,
106,64,210,107,64,210,,,-1,0,0,,,,,,
108,66,235,108,66,235,,,0,0,0,,,,,,
109,68,259,109,68,259,,,0,0,0,,,,,,
110,71,283,110,71,283,,,0,0,0,,,,,,
111,73,308,111,73,308,,,0,0,0,,,,,,
113,76,333,113,76,333,,,0,0,0,,,,,,
115,78,357,114,78,357,,,1,0,0,,,,,,
116,81,382,116,81,382,,,0,0,0,,,,,,
118,84,407,118,84,407,,,0,0,0,,,,,,
120,87,432,120,87,432,,,0,0,0,,,,,,
122,90,457,122,90,457,,,0,0,0,,,,,,
124,93,482,124,93,482,,,0,0,0,,,,,,
127,96,507,126,96,507,,,1,0,0,,,,,,
129,100,532,129,100,532,,,0,0,0,,,,,,
131,103,558,131,103,557,,,0,0,1,,,,,,
134,107,583,134,107,583,,,0,0,0,,,,,,
136,110,608,136,110,608,,,0,0,0,,,,,,
139,113,634,139,113,634,,,0,0,0,,,,,,
142,117,659,142,117,659,,,0,0,0,,,,,,
145,121,684,145,121,684,,,0,0,0,,,,,,
147,124,710,147,124,709,,,0,0,1,,,,,,
150,128,735,150,128,735,,,0,0,0,,,,,,
153,132,761,153,131,760,,,0,1,1,,,,,,
107,81,25,107,81,25,,,0,0,0,,,,,,
107,81,32,107,81,25,,,0,0,7,,,,,,
107,81,49,107,81,49,,,0,0,0,,,,,,
107,81,70,108,82,71,,,-1,-1,-1,,,,,,
107,82,93,108,82,92,,,-1,0,1,,,,,,
108,82,116,109,83,115,,,-1,-1,1,,,,,,
108,83,139,109,84,139,,,-1,-1,0,,,,,,
109,84,163,110,85,162,,,-1,-1,1,,,,,,
110,85,187,111,86,186,,,-1,-1,1,,,,,,
111,86,211,112,87,210,,,-1,-1,1,,,,,,
112,88,235,113,89,235,,,-1,-1,0,,,,,,
113,89,259,114,90,259,,,-1,-1,0,,,,,,
114,91,284,115,92,283,,,-1,-1,1,,,,,,
116,93,308,116,94,308,,,0,-1,0,,,,,,
117,95,333,118,96,333,,,-1,-1,0,,,,,,
119,97,358,119,98,357,,,0,-1,1,,,,,,
120,99,382,121,101,382,,,-1,-2,0,,,,,,
122,101,407,122,103,407,,,0,-2,0,,,,,,
124,104,432,124,106,432,,,0,-2,0,,,,,,
126,106,457,126,108,457,,,0,-2,0,,,,,,
128,109,482,128,111,482,,,0,-2,0,,,,,,
130,112,507,130,113,507,,,0,-1,0,,,,,,
132,115,533,133,116,532,,,-1,-1,1,,,,,,
135,117,558,135,119,557,,,0,-2,1,,,,,,
137,120,583,138,122,583,,,-1,-2,0,,,,,,
140,123,608,140,125,608,,,0,-2,0,,,,,,
142,127,634,143,128,634,,,-1,-1,0,,,,,,
145,130,659,145,131,659,,,0,-1,0,,,,,,
148,133,685,148,135,684,,,0,-2,1,,,,,,
150,136,710,151,138,710,,,-1,-2,0,,,,,,
153,139,735,153,141,735,,,0,-2,0,,,,,,
156,143,761,156,144,761,,,0,-1,0,,,,,,
113,106,31,113,106,31,,,0,0,0,,,,,,
113,106,37,113,106,31,,,0,0,6,,,,,,
113,107,52,113,107,52,,,0,0,0,,,,,,
113,107,72,113,107,73,,,0,0,-1,,,,,,
114,107,94,114,107,94,,,0,0,0,,,,,,
114,108,117,114,107,117,,,0,1,0,,,,,,
115,108,140,115,108,140,,,0,0,0,,,,,,
115,109,163,115,109,163,,,0,0,0,,,,,,
116,110,187,116,110,187,,,0,0,0,,,,,,
117,111,211,117,111,211,,,0,0,0,,,,,,
118,112,235,118,112,235,,,0,0,0,,,,,,
119,113,260,119,113,259,,,0,0,1,,,,,,
120,114,284,120,114,284,,,0,0,0,,,,,,
121,116,309,121,115,308,,,0,1,1,,,,,,
123,117,333,123,117,333,,,0,0,0,,,,,,
124,119,358,124,119,358,,,0,0,0,,,,,,
126,121,383,126,121,383,,,0,0,0,,,,,,
128,123,408,127,123,408,,,1,0,0,,,,,,
129,125,433,129,125,433,,,0,0,0,,,,,,
131,127,458,131,127,458,,,0,0,0,,,,,,
133,129,483,133,129,483,,,0,0,0,,,,,,
135,131,508,135,131,508,,,0,0,0,,,,,,
137,133,533,137,133,533,,,0,0,0,,,,,,
140,136,558,139,135,558,,,1,1,0,,,,,,
142,138,583,142,138,583,,,0,0,0,,,,,,
144,141,609,144,141,608,,,0,0,1,,,,,,
147,144,634,147,144,634,,,0,0,0,,,,,,
149,146,659,149,146,659,,,0,0,0,,,,,,
152,149,685,152,149,685,,,0,0,0,,,,,,
155,152,710,154,152,710,,,1,0,0,,,,,,
157,155,736,157,155,736,,,0,0,0,,,,,,
160,158,761,160,158,761,,,0,0,0,,,,,,
121,133,38,121,133,37,,,0,0,1,,,,,,
121,133,42,121,133,37,,,0,0,5,,,,,,
121,133,56,121,133,56,,,0,0,0,,,,,,
121,133,75,122,133,76,,,-1,0,-1,,,,,,
122,134,96,122,134,96,,,0,0,0,,,,,,
122,134,118,123,134,119,,,-1,0,-1,,,,,,
122,134,141,123,134,141,,,-1,0,0,,,,,,
123,135,165,124,135,165,,,-1,0,0,,,,,,
124,136,188,124,136,188,,,0,0,0,,,,,,
124,136,212,125,136,212,,,-1,0,0,,,,,,
125,137,236,126,137,236,,,-1,0,0,,,,,,
126,138,260,127,138,260,,,-1,0,0,,,,,,
127,139,285,128,139,285,,,-1,0,0,,,,,,
129,140,309,129,140,309,,,0,0,0,,,,,,
130,142,334,131,142,334,,,-1,0,0,,,,,,
131,143,359,132,143,358,,,-1,0,1,,,,,,
133,144,383,133,145,383,,,0,-1,0,,,,,,
134,146,408,135,146,408,,,-1,0,0,,,,,,
136,148,433,136,148,433,,,0,0,0,,,,,,
138,149,458,138,150,458,,,0,-1,0,,,,,,
140,151,483,140,152,483,,,0,-1,0,,,,,,
142,153,508,142,153,508,,,0,0,0,,,,,,
144,155,533,144,155,533,,,0,0,0,,,,,,
146,157,558,146,157,558,,,0,0,0,,,,,,
148,159,584,149,160,583,,,-1,-1,1,,,,,,
151,162,609,151,162,608,,,0,0,1,,,,,,
153,164,634,153,165,634,,,0,-1,0,,,,,,
155,166,660,156,167,659,,,-1,-1,1,,,,,,
158,169,685,158,169,685,,,0,0,0,,,,,,
160,171,710,161,172,710,,,-1,-1,0,,,,,,
163,174,736,163,175,736,,,0,-1,0,,,,,,
166,176,761,166,177,761,,,0,-1,0,,,,,,
130,160,44,130,160,44,,,0,0,0,,,,,,
130,160,48,130,160,44,,,0,0,4,,,,,,
130,160,61,130,160,61,,,0,0,0,,,,,,
131,160,79,130,160,80,,,1,0,-1,,,,,,
131,161,99,131,161,99,,,0,0,0,,,,,,
131,161,121,131,161,121,,,0,0,0,,,,,,
132,161,143,132,161,143,,,0,0,0,,,,,,
132,162,166,132,161,166,,,0,1,0,,,,,,
133,162,190,133,162,190,,,0,0,0,,,,,,
133,163,213,133,162,213,,,0,1,0,,,,,,
134,163,237,134,163,237,,,0,0,0,,,,,,
135,164,261,135,164,261,,,0,0,0,,,,,,
136,165,286,136,165,286,,,0,0,0,,,,,,
137,166,310,137,166,310,,,0,0,0,,,,,,
139,167,335,139,167,335,,,0,0,0,,,,,,
140,168,359,140,168,359,,,0,0,0,,,,,,
141,169,384,141,169,384,,,0,0,0,,,,,,
143,171,409,142,170,408,,,1,1,1,,,,,,
144,172,433,144,172,433,,,0,0,0,,,,,,
146,174,458,146,173,458,,,0,1,0,,,,,,
148,175,483,148,175,483,,,0,0,0,,,,,,
150,177,508,150,176,508,,,0,1,0,,,,,,
152,178,534,152,178,534,,,0,0,0,,,,,,
154,180,559,154,180,559,,,0,0,0,,,,,,
156,182,584,156,182,584,,,0,0,0,,,,,,
158,184,609,158,184,609,,,0,0,0,,,,,,
160,186,634,160,186,634,,,0,0,0,,,,,,
163,188,660,162,188,659,,,1,0,1,,,,,,
165,190,685,165,190,685,,,0,0,0,,,,,,
167,192,711,167,192,710,,,0,0,1,,,,,,
170,195,736,170,195,736,,,0,0,0,,,,,,
172,197,762,172,197,761,,,0,0,1,,,,,,
141,187,52,141,187,51,,,0,0,1,,,,,,
141,187,55,141,187,51,,,0,0,4,,,,,,
141,188,66,141,187,66,,,0,1,0,,,,,,
141,188,82,141,187,84,,,0,1,-2,,,,,,
141,188,102,142,188,102,,,-1,0,0,,,,,,
142,188,123,142,188,123,,,0,0,0,,,,,,
142,188,145,142,188,145,,,0,0,0,,,,,,
142,189,168,143,189,168,,,-1,0,0,,,,,,
143,189,191,143,189,191,,,0,0,0,,,,,,
144,190,215,144,190,215,,,0,0,0,,,,,,
144,190,238,145,190,238,,,-1,0,0,,,,,,
145,191,262,145,191,262,,,0,0,0,,,,,,
146,192,287,146,192,287,,,0,0,0,,,,,,
147,193,311,147,192,311,,,0,1,0,,,,,,
148,193,335,149,193,335,,,-1,0,0,,,,,,
150,194,360,150,194,360,,,0,0,0,,,,,,
151,195,385,151,195,384,,,0,0,1,,,,,,
152,197,409,152,196,409,,,0,1,0,,,,,,
154,198,434,154,198,434,,,0,0,0,,,,,,
155,199,459,155,199,459,,,0,0,0,,,,,,
157,200,484,157,200,484,,,0,0,0,,,,,,
159,202,509,159,202,509,,,0,0,0,,,,,,
161,203,534,161,203,534,,,0,0,0,,,,,,
163,205,559,163,205,559,,,0,0,0,,,,,,
165,206,584,165,206,584,,,0,0,0,,,,,,
167,208,610,167,208,609,,,0,0,1,,,,,,
169,210,635,169,210,634,,,0,0,1,,,,,,
171,212,660,171,212,660,,,0,0,0,,,,,,
173,213,686,173,214,685,,,0,-1,1,,,,,,
175,215,711,176,216,711,,,-1,-1,0,,,,,,
178,217,736,178,218,736,,,0,-1,0,,,,,,
180,219,762,180,220,762,,,0,-1,0,,,,,,
152,215,59,152,215,59,,,0,0,0,,,,,,
152,215,62,152,215,59,,,0,0,3,,,,,,
152,215,72,152,215,72,,,0,0,0,,,,,,
152,215,87,152,215,88,,,0,0,-1,,,,,,
153,215,105,153,215,105,,,0,0,0,,,,,,
153,216,126,153,215,126,,,0,1,0,,,,,,
153,216,148,153,216,148,,,0,0,0,,,,,,
154,216,170,153,216,170,,,1,0,0,,,,,,
154,217,193,154,217,193,,,0,0,0,,,,,,
155,217,216,155,217,216,,,0,0,0,,,,,,
156,218,240,156,218,240,,,0,0,0,,,,,,
156,218,264,156,218,264,,,0,0,0,,,,,,
157,219,288,157,219,288,,,0,0,0,,,,,,
158,219,312,158,219,312,,,0,0,0,,,,,,
159,220,336,159,220,336,,,0,0,0,,,,,,
160,221,361,160,221,360,,,0,0,1,,,,,,
162,222,385,162,222,385,,,0,0,0,,,,,,
163,223,410,163,223,410,,,0,0,0,,,,,,
164,224,435,164,224,435,,,0,0,0,,,,,,
166,225,460,165,225,460,,,1,0,0,,,,,,
167,226,485,167,226,485,,,0,0,0,,,,,,
169,227,510,169,227,510,,,0,0,0,,,,,,
171,229,535,171,229,535,,,0,0,0,,,,,,
172,230,560,172,230,560,,,0,0,0,,,,,,
174,231,585,174,231,585,,,0,0,0,,,,,,
176,233,610,176,232,610,,,0,1,0,,,,,,
178,234,635,178,234,635,,,0,0,0,,,,,,
180,236,661,180,236,660,,,0,0,1,,,,,,
182,238,686,182,238,686,,,0,0,0,,,,,,
184,239,711,184,239,711,,,0,0,0,,,,,,
187,241,737,187,241,737,,,0,0,0,,,,,,
189,243,762,189,243,762,,,0,0,0,,,,,,
164,243,66,164,243,66,,,0,0,0,,,,,,
164,243,69,164,243,66,,,0,0,3,,,,,,
164,243,78,164,243,78,,,0,0,0,,,,,,
165,243,92,165,243,93,,,0,0,-1,,,,,,
165,243,109,165,243,109,,,0,0,0,,,,,,
165,243,129,165,243,130,,,0,0,-1,,,,,,
165,244,150,165,243,150,,,0,1,0,,,,,,
166,244,172,166,244,172,,,0,0,0,,,,,,
166,244,195,166,244,195,,,0,0,0,,,,,,
167,245,218,167,245,218,,,0,0,0,,,,,,
168,245,241,168,245,241,,,0,0,0,,,,,,
168,246,265,168,246,265,,,0,0,0,,,,,,
169,246,289,169,246,289,,,0,0,0,,,,,,
170,247,313,170,247,313,,,0,0,0,,,,,,
171,247,337,171,247,337,,,0,0,0,,,,,,
172,248,362,172,248,361,,,0,0,1,,,,,,
173,249,386,173,249,386,,,0,0,0,,,,,,
174,250,411,174,250,411,,,0,0,0,,,,,,
176,251,436,175,251,436,,,1,0,0,,,,,,
177,252,460,177,252,460,,,0,0,0,,,,,,
178,253,485,178,253,485,,,0,0,0,,,,,,
180,254,510,180,254,510,,,0,0,0,,,,,,
181,255,535,182,255,535,,,-1,0,0,,,,,,
183,256,560,183,256,560,,,0,0,0,,,,,,
185,257,585,185,257,585,,,0,0,0,,,,,,
187,259,611,187,258,610,,,0,1,1,,,,,,
188,260,636,189,260,636,,,-1,0,0,,,,,,
190,261,661,190,261,661,,,0,0,0,,,,,,
192,263,687,192,263,686,,,0,0,1,,,,,,
194,264,712,194,265,712,,,0,-1,0,,,,,,
197,266,737,197,266,737,,,0,0,0,,,,,,
199,268,763,199,268,763,,,0,0,0,,,,,,
177,271,73,177,271,73,,,0,0,0,,,,,,
177,271,76,177,271,73,,,0,0,3,,,,,,
177,271,84,177,271,84,,,0,0,0,,,,,,
177,271,97,177,271,99,,,0,0,-2,,,,,,
178,271,114,178,271,114,,,0,0,0,,,,,,
178,271,133,178,271,133,,,0,0,0,,,,,,
178,271,153,178,271,153,,,0,0,0,,,,,,
178,272,175,178,271,175,,,0,1,0,,,,,,
179,272,197,179,272,197,,,0,0,0,,,,,,
179,272,220,179,272,220,,,0,0,0,,,,,,
180,273,243,180,273,243,,,0,0,0,,,,,,
181,273,267,180,273,267,,,1,0,0,,,,,,
181,274,291,181,274,291,,,0,0,0,,,,,,
182,274,314,182,274,315,,,0,0,-1,,,,,,
183,275,339,183,275,339,,,0,0,0,,,,,,
184,276,363,184,275,363,,,0,1,0,,,,,,
185,276,387,185,276,387,,,0,0,0,,,,,,
186,277,412,186,277,412,,,0,0,0,,,,,,
187,278,437,187,278,437,,,0,0,0,,,,,,
189,279,461,188,279,461,,,1,0,0,,,,,,
190,280,486,190,280,486,,,0,0,0,,,,,,
192,281,511,191,281,511,,,1,0,0,,,,,,
193,282,536,193,282,536,,,0,0,0,,,,,,
195,283,561,194,283,561,,,1,0,0,,,,,,
196,284,586,196,284,586,,,0,0,0,,,,,,
198,285,611,198,285,611,,,0,0,0,,,,,,
200,286,637,200,286,637,,,0,0,0,,,,,,
201,287,662,201,287,662,,,0,0,0,,,,,,
203,289,687,203,289,687,,,0,0,0,,,,,,
205,290,712,205,290,712,,,0,0,0,,,,,,
207,292,738,207,292,738,,,0,0,0,,,,,,
209,293,763,209,293,763,,,0,0,0,,,,,,
190,299,81,190,299,80,,,0,0,1,,,,,,
190,299,83,190,299,80,,,0,0,3,,,,,,
191,299,90,190,299,90,,,1,0,0,,,,,,
191,299,103,191,299,104,,,0,0,-1,,,,,,
191,299,118,191,299,118,,,0,0,0,,,,,,
191,299,137,191,299,137,,,0,0,0,,,,,,
191,300,157,191,299,156,,,0,1,1,,,,,,
192,300,178,192,299,178,,,0,1,0,,,,,,
192,300,200,192,300,200,,,0,0,0,,,,,,
193,300,222,193,300,222,,,0,0,0,,,,,,
193,301,245,193,301,245,,,0,0,0,,,,,,
194,301,269,194,301,269,,,0,0,0,,,,,,
194,302,292,194,302,292,,,0,0,0,,,,,,
195,302,316,195,302,316,,,0,0,0,,,,,,
196,303,340,196,302,340,,,0,1,0,,,,,,
197,303,364,197,303,364,,,0,0,0,,,,,,
198,304,389,198,304,388,,,0,0,1,,,,,,
199,304,413,199,304,413,,,0,0,0,,,,,,
200,305,438,200,305,438,,,0,0,0,,,,,,
201,306,462,201,306,462,,,0,0,0,,,,,,
202,307,487,202,307,487,,,0,0,0,,,,,,
204,308,512,204,308,512,,,0,0,0,,,,,,
205,309,537,205,309,537,,,0,0,0,,,,,,
207,310,562,207,310,562,,,0,0,0,,,,,,
208,311,587,208,311,587,,,0,0,0,,,,,,
210,312,612,210,312,612,,,0,0,0,,,,,,
211,313,637,212,313,637,,,-1,0,0,,,,,,
213,314,662,213,314,662,,,0,0,0,,,,,,
215,315,688,215,315,687,,,0,0,1,,,,,,
217,316,713,216,316,713,,,1,0,0,,,,,,
218,318,738,218,318,738,,,0,0,0,,,,,,
220,319,764,220,319,764,,,0,0,0,,,,,,
204,327,88,204,327,88,,,0,0,0,,,,,,
204,327,90,204,327,88,,,0,0,2,,,,,,
204,327,97,204,327,97,,,0,0,0,,,,,,
204,327,108,204,327,110,,,0,0,-2,,,,,,
205,327,123,205,327,123,,,0,0,0,,,,,,
205,328,141,205,327,141,,,0,1,0,,,,,,
205,328,160,205,328,160,,,0,0,0,,,,,,
205,328,181,205,328,181,,,0,0,0,,,,,,
206,328,203,206,328,203,,,0,0,0,,,,,,
206,328,225,206,328,225,,,0,0,0,,,,,,
207,329,248,207,329,248,,,0,0,0,,,,,,
207,329,271,207,329,271,,,0,0,0,,,,,,
208,330,294,208,330,294,,,0,0,0,,,,,,
209,330,318,208,330,318,,,1,0,0,,,,,,
209,330,342,209,330,342,,,0,0,0,,,,,,
210,331,366,210,331,366,,,0,0,0,,,,,,
211,332,390,211,332,390,,,0,0,0,,,,,,
212,332,414,212,332,414,,,0,0,0,,,,,,
213,333,439,213,333,439,,,0,0,0,,,,,,
214,334,463,214,333,463,,,0,1,0,,,,,,
215,334,488,215,334,488,,,0,0,0,,,,,,
217,335,513,216,335,513,,,1,0,0,,,,,,
218,336,538,218,336,538,,,0,0,0,,,,,,
219,337,563,219,337,563,,,0,0,0,,,,,,
221,338,588,221,338,588,,,0,0,0,,,,,,
222,339,613,222,339,613,,,0,0,0,,,,,,
224,340,638,224,340,638,,,0,0,0,,,,,,
225,341,663,225,341,663,,,0,0,0,,,,,,
227,342,688,227,342,688,,,0,0,0,,,,,,
229,343,714,228,343,713,,,1,0,1,,,,,,
230,344,739,230,344,739,,,0,0,0,,,,,,
232,345,765,232,345,764,,,0,0,1,,,,,,
218,356,96,218,355,95,,,0,1,1,,,,,,
218,356,97,218,355,95,,,0,1,2,,,,,,
218,356,104,218,355,104,,,0,1,0,,,,,,
218,356,114,218,355,116,,,0,1,-2,,,,,,
219,356,129,219,355,128,,,0,1,1,,,,,,
219,356,146,219,355,146,,,0,1,0,,,,,,
219,356,164,219,356,164,,,0,0,0,,,,,,
219,356,185,219,356,185,,,0,0,0,,,,,,
220,356,206,220,356,206,,,0,0,0,,,,,,
220,357,228,220,356,228,,,0,1,0,,,,,,
221,357,250,221,357,250,,,0,0,0,,,,,,
221,357,273,221,357,273,,,0,0,0,,,,,,
222,358,296,222,358,296,,,0,0,0,,,,,,
222,358,320,222,358,319,,,0,0,1,,,,,,
223,359,343,223,358,343,,,0,1,0,,,,,,
224,359,367,224,359,367,,,0,0,0,,,,,,
225,360,391,225,360,391,,,0,0,0,,,,,,
226,360,416,225,360,416,,,1,0,0,,,,,,
227,361,440,226,361,440,,,1,0,0,,,,,,
228,361,465,227,361,465,,,1,0,0,,,,,,
229,362,489,228,362,489,,,1,0,0,,,,,,
230,363,514,229,362,514,,,1,1,0,,,,,,
231,364,539,231,363,539,,,0,1,0,,,,,,
232,364,564,232,364,564,,,0,0,0,,,,,,
234,365,589,234,365,589,,,0,0,0,,,,,,
235,366,614,235,366,614,,,0,0,0,,,,,,
236,367,639,237,367,639,,,-1,0,0,,,,,,
238,368,664,238,368,664,,,0,0,0,,,,,,
239,369,689,239,369,689,,,0,0,0,,,,,,
241,370,715,241,370,714,,,0,0,1,,,,,,
243,371,740,243,371,740,,,0,0,0,,,,,,
244,372,765,244,372,765,,,0,0,0,,,,,,
233,384,103,233,384,103,,,0,0,0,,,,,,
233,384,105,233,384,103,,,0,0,2,,,,,,
233,384,111,233,384,111,,,0,0,0,,,,,,
233,384,121,233,384,122,,,0,0,-1,,,,,,
233,384,134,233,384,134,,,0,0,0,,,,,,
233,384,150,233,384,151,,,0,0,-1,,,,,,
233,384,169,233,384,169,,,0,0,0,,,,,,
234,385,188,233,384,189,,,1,1,-1,,,,,,
234,385,209,234,385,209,,,0,0,0,,,,,,
234,385,231,234,385,231,,,0,0,0,,,,,,
235,385,253,235,385,253,,,0,0,0,,,,,,
235,386,275,235,385,275,,,0,1,0,,,,,,
236,386,298,236,386,298,,,0,0,0,,,,,,
236,386,322,236,386,321,,,0,0,1,,,,,,
237,387,345,237,387,345,,,0,0,0,,,,,,
238,387,369,238,387,369,,,0,0,0,,,,,,
239,388,393,239,388,393,,,0,0,0,,,,,,
239,388,417,239,388,417,,,0,0,0,,,,,,
240,389,442,240,389,442,,,0,0,0,,,,,,
241,389,466,241,389,466,,,0,0,0,,,,,,
242,390,491,242,390,491,,,0,0,0,,,,,,
243,391,515,243,390,515,,,0,1,0,,,,,,
244,391,540,244,391,540,,,0,0,0,,,,,,
246,392,565,245,392,565,,,1,0,0,,,,,,
247,393,590,247,393,590,,,0,0,0,,,,,,
248,394,615,248,394,615,,,0,0,0,,,,,,
250,395,640,250,395,640,,,0,0,0,,,,,,
251,395,665,251,395,665,,,0,0,0,,,,,,
252,396,690,252,396,690,,,0,0,0,,,,,,
254,397,715,254,397,715,,,0,0,0,,,,,,
256,398,741,256,398,741,,,0,0,0,,,,,,
257,399,766,257,399,766,,,0,0,0,,,,,,
247,413,111,247,412,110,,,0,1,1,,,,,,
247,413,112,247,412,110,,,0,1,2,,,,,,
247,413,118,247,412,118,,,0,1,0,,,,,,
247,413,127,247,412,129,,,0,1,-2,,,,,,
247,413,140,247,412,140,,,0,1,0,,,,,,
248,413,156,247,412,156,,,1,1,0,,,,,,
248,413,173,248,413,173,,,0,0,0,,,,,,
248,413,192,248,413,193,,,0,0,-1,,,,,,
248,413,213,248,413,212,,,0,0,1,,,,,,
249,414,234,249,413,234,,,0,1,0,,,,,,
249,414,256,249,413,256,,,0,1,0,,,,,,
250,414,278,250,414,278,,,0,0,0,,,,,,
250,414,301,250,414,300,,,0,0,1,,,,,,
251,415,324,251,415,324,,,0,0,0,,,,,,
251,415,347,251,415,347,,,0,0,0,,,,,,
252,415,371,252,415,371,,,0,0,0,,,,,,
253,416,395,253,416,395,,,0,0,0,,,,,,
254,416,419,253,416,419,,,1,0,0,,,,,,
254,417,443,254,417,443,,,0,0,0,,,,,,
255,417,468,255,417,467,,,0,0,1,,,,,,
256,418,492,256,418,492,,,0,0,0,,,,,,
257,419,517,257,418,516,,,0,1,1,,,,,,
258,419,541,258,419,541,,,0,0,0,,,,,,
259,420,566,259,420,566,,,0,0,0,,,,,,
261,421,591,261,421,591,,,0,0,0,,,,,,
262,421,616,262,421,616,,,0,0,0,,,,,,
263,422,641,263,422,641,,,0,0,0,,,,,,
264,423,666,264,423,666,,,0,0,0,,,,,,
266,424,691,266,424,691,,,0,0,0,,,,,,
267,425,716,267,425,716,,,0,0,0,,,,,,
269,426,742,269,426,741,,,0,0,1,,,,,,
270,427,767,270,426,766,,,0,1,1,,,,,,
262,441,118,262,441,118,,,0,0,0,,,,,,
262,441,120,262,441,118,,,0,0,2,,,,,,
262,441,125,262,441,125,,,0,0,0,,,,,,
262,441,134,262,441,135,,,0,0,-1,,,,,,
262,441,146,262,441,146,,,0,0,0,,,,,,
262,441,161,262,441,162,,,0,0,-1,,,,,,
263,442,178,263,442,178,,,0,0,0,,,,,,
263,442,197,263,442,197,,,0,0,0,,,,,,
263,442,216,263,442,216,,,0,0,0,,,,,,
263,442,237,263,442,237,,,0,0,0,,,,,,
264,442,259,264,442,259,,,0,0,0,,,,,,
264,443,281,264,442,281,,,0,1,0,,,,,,
265,443,303,265,443,303,,,0,0,0,,,,,,
265,443,326,265,443,326,,,0,0,0,,,,,,
266,444,350,266,444,350,,,0,0,0,,,,,,
266,444,373,266,444,373,,,0,0,0,,,,,,
267,444,397,267,444,397,,,0,0,0,,,,,,
268,445,421,268,444,421,,,0,1,0,,,,,,
269,445,445,269,445,445,,,0,0,0,,,,,,
270,446,469,269,445,469,,,1,1,0,,,,,,
270,446,493,270,446,493,,,0,0,0,,,,,,
271,447,518,271,446,518,,,0,1,0,,,,,,
272,447,543,272,447,543,,,0,0,0,,,,,,
273,448,567,273,448,567,,,0,0,0,,,,,,
275,449,592,275,449,592,,,0,0,0,,,,,,
276,449,617,276,449,617,,,0,0,0,,,,,,
277,450,642,277,450,642,,,0,0,0,,,,,,
278,451,667,278,451,667,,,0,0,0,,,,,,
280,452,692,280,452,692,,,0,0,0,,,,,,
281,453,717,281,453,717,,,0,0,0,,,,,,
282,454,742,282,454,742,,,0,0,0,,,,,,
284,454,768,283,454,767,,,1,0,1,,,,,,
277,470,126,277,470,126,,,0,0,0,,,,,,
277,470,127,277,470,126,,,0,0,1,,,,,,
277,470,132,277,470,132,,,0,0,0,,,,,,
277,470,140,277,470,142,,,0,0,-2,,,,,,
277,470,152,277,470,152,,,0,0,0,,,,,,
277,470,166,277,470,167,,,0,0,-1,,,,,,
277,470,183,278,470,183,,,-1,0,0,,,,,,
278,470,201,278,470,201,,,0,0,0,,,,,,
278,471,220,278,470,220,,,0,1,0,,,,,,
278,471,241,278,470,241,,,0,1,0,,,,,,
279,471,262,279,471,262,,,0,0,0,,,,,,
279,471,284,279,471,284,,,0,0,0,,,,,,
280,471,306,279,471,306,,,1,0,0,,,,,,
280,472,329,280,472,329,,,0,0,0,,,,,,
281,472,352,280,472,352,,,1,0,0,,,,,,
281,472,375,281,472,375,,,0,0,0,,,,,,
282,473,399,282,472,399,,,0,1,0,,,,,,
283,473,423,282,473,423,,,1,0,0,,,,,,
283,474,447,283,473,447,,,0,1,0,,,,,,
284,474,471,284,474,471,,,0,0,0,,,,,,
285,475,495,285,474,495,,,0,1,0,,,,,,
286,475,520,285,475,519,,,1,0,1,,,,,,
287,476,544,286,475,544,,,1,1,0,,,,,,
288,476,569,287,476,569,,,1,0,0,,,,,,
289,477,593,289,477,593,,,0,0,0,,,,,,
290,478,618,290,477,618,,,0,1,0,,,,,,
291,478,643,291,478,643,,,0,0,0,,,,,,
292,479,668,292,479,668,,,0,0,0,,,,,,
293,480,693,294,480,693,,,-1,0,0,,,,,,
295,481,718,295,480,718,,,0,1,0,,,,,,
296,481,744,296,481,743,,,0,0,1,,,,,,
298,482,769,297,482,768,,,1,0,1,,,,,,
292,499,134,292,499,134,,,0,0,0,,,,,,
292,499,135,292,499,134,,,0,0,1,,,,,,
292,499,139,292,499,139,,,0,0,0,,,,,,
292,499,147,292,499,148,,,0,0,-1,,,,,,
292,499,158,292,499,158,,,0,0,0,,,,,,
292,499,172,292,499,173,,,0,0,-1,,,,,,
293,499,188,293,499,188,,,0,0,0,,,,,,
293,499,206,293,499,206,,,0,0,0,,,,,,
293,499,225,293,499,225,,,0,0,0,,,,,,
293,499,245,293,499,245,,,0,0,0,,,,,,
294,500,265,294,500,265,,,0,0,0,,,,,,
294,500,287,294,500,287,,,0,0,0,,,,,,
294,500,309,294,500,309,,,0,0,0,,,,,,
295,500,332,294,500,331,,,1,0,1,,,,,,
295,501,354,295,501,354,,,0,0,0,,,,,,
296,501,378,296,501,377,,,0,0,1,,,,,,
297,501,401,297,501,401,,,0,0,0,,,,,,
297,502,425,297,501,425,,,0,1,0,,,,,,
298,502,449,298,502,449,,,0,0,0,,,,,,
299,503,473,299,502,473,,,0,1,0,,,,,,
300,503,497,300,503,497,,,0,0,0,,,,,,
300,504,521,300,503,521,,,0,1,0,,,,,,
301,504,546,301,504,546,,,0,0,0,,,,,,
302,505,570,302,504,570,,,0,1,0,,,,,,
303,505,595,303,505,595,,,0,0,0,,,,,,
304,506,620,304,506,619,,,0,0,1,,,,,,
305,507,644,305,507,644,,,0,0,0,,,,,,
307,507,669,306,507,669,,,1,0,0,,,,,,
308,508,694,308,508,694,,,0,0,0,,,,,,
309,509,719,309,508,719,,,0,1,0,,,,,,
310,509,745,310,509,745,,,0,0,0,,,,,,
312,510,770,311,510,770,,,1,0,0,,,,,,
307,528,141,307,527,141,,,0,1,0,,,,,,
307,528,143,307,527,141,,,0,1,2,,,,,,
307,528,147,307,527,146,,,0,1,1,,,,,,
307,528,154,307,527,155,,,0,1,-1,,,,,,
307,528,165,307,528,164,,,0,0,1,,,,,,
308,528,178,307,528,179,,,1,0,-1,,,,,,
308,528,193,308,528,193,,,0,0,0,,,,,,
308,528,210,308,528,211,,,0,0,-1,,,,,,
308,528,229,308,528,229,,,0,0,0,,,,,,
308,528,249,308,528,249,,,0,0,0,,,,,,
309,528,269,309,528,269,,,0,0,0,,,,,,
309,529,290,309,528,290,,,0,1,0,,,,,,
310,529,312,309,529,312,,,1,0,0,,,,,,
310,529,334,310,529,334,,,0,0,0,,,,,,
311,529,357,310,529,357,,,1,0,0,,,,,,
311,530,380,311,529,380,,,0,1,0,,,,,,
312,530,403,312,530,403,,,0,0,0,,,,,,
312,530,427,312,530,427,,,0,0,0,,,,,,
313,531,451,313,531,451,,,0,0,0,,,,,,
314,531,475,313,531,475,,,1,0,0,,,,,,
314,532,499,314,531,499,,,0,1,0,,,,,,
315,532,523,315,532,523,,,0,0,0,,,,,,
316,533,547,316,532,547,,,0,1,0,,,,,,
317,533,572,317,533,572,,,0,0,0,,,,,,
318,534,596,318,533,596,,,0,1,0,,,,,,
319,534,621,319,534,621,,,0,0,0,,,,,,
320,535,646,320,535,645,,,0,0,1,,,,,,
321,536,671,321,535,670,,,0,1,1,,,,,,
322,536,696,322,536,695,,,0,0,1,,,,,,
323,537,721,323,537,720,,,0,0,1,,,,,,
324,538,746,324,537,746,,,0,1,0,,,,,,
326,538,771,325,538,771,,,1,0,0,,,,,,
323,556,149,323,556,149,,,0,0,0,,,,,,
323,556,150,323,556,149,,,0,0,1,,,,,,
323,556,154,323,556,154,,,0,0,0,,,,,,
323,556,161,323,556,162,,,0,0,-1,,,,,,
323,557,171,323,557,171,,,0,0,0,,,,,,
323,557,184,323,557,185,,,0,0,-1,,,,,,
323,557,199,323,557,199,,,0,0,0,,,,,,
323,557,215,323,557,216,,,0,0,-1,,,,,,
324,557,234,324,557,234,,,0,0,0,,,,,,
324,557,253,324,557,253,,,0,0,0,,,,,,
324,557,273,324,557,273,,,0,0,0,,,,,,
324,557,294,324,557,294,,,0,0,0,,,,,,
325,558,315,325,558,315,,,0,0,0,,,,,,
325,558,337,325,558,337,,,0,0,0,,,,,,
326,558,360,326,558,360,,,0,0,0,,,,,,
326,559,383,326,558,383,,,0,1,0,,,,,,
327,559,406,327,559,406,,,0,0,0,,,,,,
327,559,429,327,559,429,,,0,0,0,,,,,,
328,560,453,328,560,453,,,0,0,0,,,,,,
329,560,477,328,560,477,,,1,0,0,,,,,,
329,560,501,329,560,501,,,0,0,0,,,,,,
330,561,525,330,560,525,,,0,1,0,,,,,,
331,561,549,331,561,549,,,0,0,0,,,,,,
332,562,573,332,561,573,,,0,1,0,,,,,,
333,562,598,333,562,598,,,0,0,0,,,,,,
334,563,623,334,562,622,,,0,1,1,,,,,,
335,563,647,335,563,647,,,0,0,0,,,,,,
336,564,672,336,564,672,,,0,0,0,,,,,,
337,565,697,337,565,697,,,0,0,0,,,,,,
338,565,722,338,565,722,,,0,0,0,,,,,,
339,566,747,339,566,747,,,0,0,0,,,,,,
340,567,772,340,566,772,,,0,1,0,,,,,,
338,585,157,338,585,157,,,0,0,0,,,,,,
338,585,158,338,585,157,,,0,0,1,,,,,,
338,585,162,338,585,161,,,0,0,1,,,,,,
338,585,168,338,585,169,,,0,0,-1,,,,,,
338,585,178,338,586,178,,,0,-1,0,,,,,,
338,586,190,338,586,191,,,0,0,-1,,,,,,
339,586,205,338,586,204,,,1,0,1,,,,,,
339,586,221,338,586,221,,,1,0,0,,,,,,
339,586,238,339,586,238,,,0,0,0,,,,,,
339,586,257,339,586,257,,,0,0,0,,,,,,
339,586,277,339,586,277,,,0,0,0,,,,,,
340,586,298,340,586,297,,,0,0,1,,,,,,
340,587,319,340,587,318,,,0,0,1,,,,,,
341,587,341,340,587,340,,,1,0,1,,,,,,
341,587,363,341,587,363,,,0,0,0,,,,,,
342,587,385,341,587,385,,,1,0,0,,,,,,
342,588,408,342,588,408,,,0,0,0,,,,,,
343,588,432,342,588,431,,,1,0,1,,,,,,
343,588,455,343,588,455,,,0,0,0,,,,,,
344,589,479,344,588,479,,,0,1,0,,,,,,
345,589,503,344,589,503,,,1,0,0,,,,,,
345,590,527,345,589,527,,,0,1,0,,,,,,
346,590,551,346,590,551,,,0,0,0,,,,,,
347,590,575,347,590,575,,,0,0,0,,,,,,
348,591,600,348,591,599,,,0,0,1,,,,,,
349,591,624,349,591,624,,,0,0,0,,,,,,
350,592,649,350,592,648,,,0,0,1,,,,,,
351,593,674,350,592,673,,,1,1,1,,,,,,
352,593,698,351,593,698,,,1,0,0,,,,,,
353,594,723,352,594,723,,,1,0,0,,,,,,
354,594,748,354,594,748,,,0,0,0,,,,,,
355,595,773,355,595,773,,,0,0,0,,,,,,
354,614,165,354,614,165,,,0,0,0,,,,,,
354,614,166,354,614,165,,,0,0,1,,,,,,
354,614,169,354,614,169,,,0,0,0,,,,,,
354,614,176,354,614,177,,,0,0,-1,,,,,,
354,615,185,354,615,185,,,0,0,0,,,,,,
354,615,196,354,615,197,,,0,0,-1,,,,,,
354,615,210,354,615,210,,,0,0,0,,,,,,
354,615,226,354,615,226,,,0,0,0,,,,,,
354,615,243,354,615,243,,,0,0,0,,,,,,
355,615,262,354,615,262,,,1,0,0,,,,,,
355,615,281,355,615,281,,,0,0,0,,,,,,
355,615,301,355,615,301,,,0,0,0,,,,,,
356,616,322,356,616,322,,,0,0,0,,,,,,
356,616,344,356,616,344,,,0,0,0,,,,,,
356,616,366,356,616,366,,,0,0,0,,,,,,
357,616,388,356,616,388,,,1,0,0,,,,,,
357,617,411,357,617,411,,,0,0,0,,,,,,
358,617,434,358,617,434,,,0,0,0,,,,,,
359,617,457,359,617,457,,,0,0,0,,,,,,
359,618,481,359,617,481,,,0,1,0,,,,,,
360,618,505,360,618,505,,,0,0,0,,,,,,
361,618,529,360,618,529,,,1,0,0,,,,,,
361,619,553,361,619,553,,,0,0,0,,,,,,
362,619,577,362,619,577,,,0,0,0,,,,,,
363,620,601,363,620,601,,,0,0,0,,,,,,
364,620,626,364,620,625,,,0,0,1,,,,,,
365,621,650,365,621,650,,,0,0,0,,,,,,
365,621,675,365,621,675,,,0,0,0,,,,,,
366,622,700,366,622,700,,,0,0,0,,,,,,
367,622,725,367,622,725,,,0,0,0,,,,,,
369,623,750,369,623,750,,,0,0,0,,,,,,
370,624,775,370,623,775,,,0,1,0,,,,,,
369,644,172,369,643,172,,,0,1,0,,,,,,
369,644,173,369,643,172,,,0,1,1,,,,,,
369,644,177,369,643,176,,,0,1,1,,,,,,
369,644,183,369,643,184,,,0,1,-1,,,,,,
369,644,192,369,644,192,,,0,0,0,,,,,,
370,644,203,369,644,204,,,1,0,-1,,,,,,
370,644,216,369,644,216,,,1,0,0,,,,,,
370,644,232,369,644,232,,,1,0,0,,,,,,
370,644,248,370,644,248,,,0,0,0,,,,,,
370,644,266,370,644,267,,,0,0,-1,,,,,,
371,644,285,370,644,285,,,1,0,0,,,,,,
371,644,305,371,644,305,,,0,0,0,,,,,,
371,645,326,371,645,326,,,0,0,0,,,,,,
372,645,347,371,645,347,,,1,0,0,,,,,,
372,645,369,372,645,369,,,0,0,0,,,,,,
372,645,391,372,645,391,,,0,0,0,,,,,,
373,646,414,372,646,414,,,1,0,0,,,,,,
373,646,437,373,646,437,,,0,0,0,,,,,,
374,646,460,374,646,460,,,0,0,0,,,,,,
375,647,483,374,646,483,,,1,1,0,,,,,,
375,647,507,375,647,507,,,0,0,0,,,,,,
376,647,531,376,647,531,,,0,0,0,,,,,,
377,648,555,376,648,555,,,1,0,0,,,,,,
377,648,579,377,648,579,,,0,0,0,,,,,,
378,649,603,378,648,603,,,0,1,0,,,,,,
379,649,628,379,649,627,,,0,0,1,,,,,,
380,649,652,380,649,652,,,0,0,0,,,,,,
381,650,677,380,650,676,,,1,0,1,,,,,,
382,651,702,381,650,701,,,1,1,1,,,,,,
382,651,726,382,651,726,,,0,0,0,,,,,,
383,652,751,384,651,751,,,-1,1,0,,,,,,
385,652,776,385,652,776,,,0,0,0,,,,,,
385,673,180,385,673,180,,,0,0,0,,,,,,
385,673,181,385,673,180,,,0,0,1,,,,,,
385,673,184,385,673,184,,,0,0,0,,,,,,
385,673,190,385,673,191,,,0,0,-1,,,,,,
385,673,199,385,673,199,,,0,0,0,,,,,,
385,673,209,385,673,210,,,0,0,-1,,,,,,
385,673,222,385,673,222,,,0,0,0,,,,,,
386,673,237,385,673,238,,,1,0,-1,,,,,,
386,673,254,386,673,254,,,0,0,0,,,,,,
386,673,271,386,673,272,,,0,0,-1,,,,,,
386,673,290,386,673,290,,,0,0,0,,,,,,
387,673,310,386,673,310,,,1,0,0,,,,,,
387,674,330,387,674,330,,,0,0,0,,,,,,
387,674,351,387,674,351,,,0,0,0,,,,,,
388,674,373,388,674,373,,,0,0,0,,,,,,
388,674,395,388,674,395,,,0,0,0,,,,,,
388,675,417,388,675,417,,,0,0,0,,,,,,
389,675,440,388,675,440,,,1,0,0,,,,,,
389,675,463,389,675,463,,,0,0,0,,,,,,
390,675,486,390,675,486,,,0,0,0,,,,,,
391,676,509,391,676,509,,,0,0,0,,,,,,
391,676,533,391,676,533,,,0,0,0,,,,,,
392,677,557,392,677,557,,,0,0,0,,,,,,
393,677,581,392,677,581,,,1,0,0,,,,,,
393,677,605,393,677,605,,,0,0,0,,,,,,
394,678,630,394,677,629,,,0,1,1,,,,,,
395,678,654,395,678,654,,,0,0,0,,,,,,
396,679,679,396,678,678,,,0,1,1,,,,,,
397,679,703,397,679,703,,,0,0,0,,,,,,
398,680,728,398,679,728,,,0,1,0,,,,,,
399,680,753,399,680,753,,,0,0,0,,,,,,
400,681,778,400,681,778,,,0,0,0,,,,,,
401,702,188,401,702,188,,,0,0,0,,,,,,
401,702,189,401,702,188,,,0,0,1,,,,,,
401,702,192,401,702,191,,,0,0,1,,,,,,
401,702,197,401,702,198,,,0,0,-1,,,,,,
401,702,206,401,702,206,,,0,0,0,,,,,,
401,702,216,401,702,217,,,0,0,-1,,,,,,
401,702,229,401,702,228,,,0,0,1,,,,,,
401,702,243,401,702,243,,,0,0,0,,,,,,
402,702,259,401,702,259,,,1,0,0,,,,,,
402,702,276,401,702,276,,,1,0,0,,,,,,
402,702,295,402,702,294,,,0,0,1,,,,,,
402,703,314,402,702,314,,,0,1,0,,,,,,
403,703,334,402,703,334,,,1,0,0,,,,,,
403,703,355,403,703,355,,,0,0,0,,,,,,
403,703,376,403,703,376,,,0,0,0,,,,,,
404,703,398,403,703,398,,,1,0,0,,,,,,
404,704,420,404,704,420,,,0,0,0,,,,,,
405,704,443,404,704,442,,,1,0,1,,,,,,
405,704,465,405,704,465,,,0,0,0,,,,,,
406,705,489,405,704,488,,,1,1,1,,,,,,
406,705,512,406,705,512,,,0,0,0,,,,,,
407,705,536,407,705,535,,,0,0,1,,,,,,
407,706,559,407,706,559,,,0,0,0,,,,,,
408,706,583,408,706,583,,,0,0,0,,,,,,
409,706,607,408,706,607,,,1,0,0,,,,,,
410,707,632,409,706,631,,,1,1,1,,,,,,
410,707,656,410,707,656,,,0,0,0,,,,,,
411,708,680,411,707,680,,,0,1,0,,,,,,
412,708,705,412,708,705,,,0,0,0,,,,,,
413,709,730,413,708,729,,,0,1,1,,,,,,
414,709,754,414,709,754,,,0,0,0,,,,,,
415,710,779,415,709,779,,,0,1,0,,,,,,
417,731,196,417,731,196,,,0,0,0,,,,,,
417,731,196,417,731,196,,,0,0,0,,,,,,
417,731,199,417,731,199,,,0,0,0,,,,,,
417,731,205,417,731,206,,,0,0,-1,,,,,,
417,731,213,417,731,213,,,0,0,0,,,,,,
417,731,223,417,731,224,,,0,0,-1,,,,,,
417,731,235,417,731,235,,,0,0,0,,,,,,
417,731,249,417,731,249,,,0,0,0,,,,,,
417,731,264,417,731,264,,,0,0,0,,,,,,
418,732,281,417,731,281,,,1,1,0,,,,,,
418,732,299,418,732,299,,,0,0,0,,,,,,
418,732,318,418,732,318,,,0,0,0,,,,,,
418,732,338,418,732,338,,,0,0,0,,,,,,
419,732,359,418,732,359,,,1,0,0,,,,,,
419,732,380,419,732,380,,,0,0,0,,,,,,
419,733,401,419,732,401,,,0,1,0,,,,,,
420,733,423,420,733,423,,,0,0,0,,,,,,
420,733,446,420,733,445,,,0,0,1,,,,,,
421,733,468,421,733,468,,,0,0,0,,,,,,
421,734,491,421,733,491,,,0,1,0,,,,,,
422,734,515,422,734,515,,,0,0,0,,,,,,
422,734,538,422,734,538,,,0,0,0,,,,,,
423,735,562,423,735,562,,,0,0,0,,,,,,
424,735,585,423,735,585,,,1,0,0,,,,,,
424,735,609,424,735,609,,,0,0,0,,,,,,
425,736,634,425,735,633,,,0,1,1,,,,,,
426,736,658,426,736,658,,,0,0,0,,,,,,
427,737,682,426,736,682,,,1,1,0,,,,,,
427,737,707,427,737,707,,,0,0,0,,,,,,
428,738,731,428,737,731,,,0,1,0,,,,,,
429,738,756,429,738,756,,,0,0,0,,,,,,
430,739,781,430,738,781,,,0,1,0,,,,,,
433,760,203,433,760,203,,,0,0,0,,,,,,
433,760,204,433,760,203,,,0,0,1,,,,,,
433,760,207,433,760,207,,,0,0,0,,,,,,
433,760,212,433,760,213,,,0,0,-1,,,,,,
433,760,220,433,760,220,,,0,0,0,,,,,,
433,760,230,433,760,230,,,0,0,0,,,,,,
433,761,241,433,760,241,,,0,1,0,,,,,,
433,761,255,433,760,255,,,0,1,0,,,,,,
433,761,270,433,760,270,,,0,1,0,,,,,,
433,761,287,433,760,287,,,0,1,0,,,,,,
434,761,304,434,761,304,,,0,0,0,,,,,,
434,761,323,434,761,323,,,0,0,0,,,,,,
434,761,343,434,761,342,,,0,0,1,,,,,,
435,761,363,434,761,363,,,1,0,0,,,,,,
435,762,384,435,761,383,,,0,1,1,,,,,,
435,762,405,435,761,405,,,0,1,0,,,,,,
436,762,427,435,762,426,,,1,0,1,,,,,,
436,762,449,436,762,448,,,0,0,1,,,,,,
437,763,471,436,762,471,,,1,1,0,,,,,,
437,763,494,437,762,494,,,0,1,0,,,,,,
438,763,517,437,763,517,,,1,0,0,,,,,,
438,763,541,438,763,541,,,0,0,0,,,,,,
439,764,564,438,764,564,,,1,0,0,,,,,,
439,764,588,439,764,588,,,0,0,0,,,,,,
440,765,612,440,764,611,,,0,1,1,,,,,,
441,765,636,440,764,635,,,1,1,1,,,,,,
441,765,660,441,765,660,,,0,0,0,,,,,,
442,766,684,442,765,684,,,0,1,0,,,,,,
443,766,709,442,766,709,,,1,0,0,,,,,,
444,767,733,443,766,733,,,1,1,0,,,,,,
445,767,758,444,767,758,,,1,0,0,,,,,,
445,768,783,445,767,782,,,0,1,1,,,,,,
449,790,211,449,790,211,,,0,0,0,,,,,,
449,790,212,449,790,211,,,0,0,1,,,,,,
449,790,215,449,790,215,,,0,0,0,,,,,,
449,790,220,449,790,221,,,0,0,-1,,,,,,
449,790,227,449,790,227,,,0,0,0,,,,,,
449,790,236,449,790,237,,,0,0,-1,,,,,,
449,790,248,449,790,248,,,0,0,0,,,,,,
449,790,261,449,790,262,,,0,0,-1,,,,,,
449,790,276,449,790,276,,,0,0,0,,,,,,
449,790,292,449,790,292,,,0,0,0,,,,,,
450,790,309,450,790,309,,,0,0,0,,,,,,
450,790,328,450,790,328,,,0,0,0,,,,,,
450,791,347,450,791,347,,,0,0,0,,,,,,
450,791,367,450,791,367,,,0,0,0,,,,,,
451,791,387,451,791,387,,,0,0,0,,,,,,
451,791,409,451,791,408,,,0,0,1,,,,,,
451,791,430,451,791,430,,,0,0,0,,,,,,
452,792,452,451,791,452,,,1,1,0,,,,,,
452,792,474,452,792,474,,,0,0,0,,,,,,
453,792,497,452,792,497,,,1,0,0,,,,,,
453,792,520,453,792,520,,,0,0,0,,,,,,
454,793,543,453,792,543,,,1,1,0,,,,,,
454,793,567,454,793,567,,,0,0,0,,,,,,
455,793,590,455,793,590,,,0,0,0,,,,,,
456,794,614,456,794,614,,,0,0,0,,,,,,
456,794,638,456,794,638,,,0,0,0,,,,,,
457,794,662,457,794,662,,,0,0,0,,,,,,
458,795,686,457,794,686,,,1,1,0,,,,,,
458,795,711,458,795,711,,,0,0,0,,,,,,
459,796,735,459,795,735,,,0,1,0,,,,,,
460,796,760,460,796,760,,,0,0,0,,,,,,
461,797,784,461,796,784,,,0,1,0,,,,,,
465,819,219,465,819,219,,,0,0,0,,,,,,
465,819,220,465,819,219,,,0,0,1,,,,,,
465,819,222,465,819,222,,,0,0,0,,,,,,
465,819,227,465,819,228,,,0,0,-1,,,,,,
465,819,234,465,819,234,,,0,0,0,,,,,,
465,819,243,465,819,244,,,0,0,-1,,,,,,
465,819,254,465,819,254,,,0,0,0,,,,,,
465,819,267,465,819,268,,,0,0,-1,,,,,,
465,819,282,465,819,282,,,0,0,0,,,,,,
465,819,298,465,819,298,,,0,0,0,,,,,,
466,820,315,466,819,314,,,0,1,1,,,,,,
466,820,333,466,819,333,,,0,1,0,,,,,,
466,820,352,466,820,351,,,0,0,1,,,,,,
466,820,371,466,820,371,,,0,0,0,,,,,,
467,820,392,467,820,391,,,0,0,1,,,,,,
467,820,412,467,820,412,,,0,0,0,,,,,,
467,821,434,467,820,433,,,0,1,1,,,,,,
468,821,456,467,820,455,,,1,1,1,,,,,,
468,821,478,468,821,477,,,0,0,1,,,,,,
469,821,500,468,821,500,,,1,0,0,,,,,,
469,822,523,469,821,523,,,0,1,0,,,,,,
470,822,546,469,822,546,,,1,0,0,,,,,,
470,822,569,470,822,569,,,0,0,0,,,,,,
471,823,593,470,822,593,,,1,1,0,,,,,,
471,823,616,471,823,616,,,0,0,0,,,,,,
472,823,640,472,823,640,,,0,0,0,,,,,,
473,824,664,472,823,664,,,1,1,0,,,,,,
473,824,688,473,824,688,,,0,0,0,,,,,,
474,824,713,474,824,713,,,0,0,0,,,,,,
475,825,737,474,824,737,,,1,1,0,,,,,,
476,825,762,475,825,762,,,1,0,0,,,,,,
476,826,786,476,825,786,,,0,1,0,,,,,,
481,848,227,481,848,227,,,0,0,0,,,,,,
481,848,228,481,848,227,,,0,0,1,,,,,,
481,848,230,481,848,230,,,0,0,0,,,,,,
481,849,235,481,848,236,,,0,1,-1,,,,,,
481,849,242,481,849,242,,,0,0,0,,,,,,
481,849,250,481,849,251,,,0,0,-1,,,,,,
481,849,261,481,849,261,,,0,0,0,,,,,,
481,849,274,481,849,274,,,0,0,0,,,,,,
481,849,288,481,849,288,,,0,0,0,,,,,,
481,849,303,481,849,304,,,0,0,-1,,,,,,
482,849,320,482,849,320,,,0,0,0,,,,,,
482,849,338,482,849,338,,,0,0,0,,,,,,
482,849,356,482,849,356,,,0,0,0,,,,,,
482,849,376,482,849,376,,,0,0,0,,,,,,
483,850,396,483,850,396,,,0,0,0,,,,,,
483,850,416,483,850,416,,,0,0,0,,,,,,
483,850,437,483,850,437,,,0,0,0,,,,,,
484,850,459,483,850,459,,,1,0,0,,,,,,
484,850,481,484,850,481,,,0,0,0,,,,,,
485,851,503,484,850,503,,,1,1,0,,,,,,
485,851,526,485,851,526,,,0,0,0,,,,,,
486,851,549,485,851,549,,,1,0,0,,,,,,
486,852,572,486,852,572,,,0,0,0,,,,,,
487,852,595,486,852,595,,,1,0,0,,,,,,
487,852,619,487,852,619,,,0,0,0,,,,,,
488,853,643,487,852,643,,,1,1,0,,,,,,
488,853,667,488,853,667,,,0,0,0,,,,,,
489,853,691,489,853,691,,,0,0,0,,,,,,
490,854,715,490,854,715,,,0,0,0,,,,,,
491,854,739,490,854,739,,,1,0,0,,,,,,
491,854,764,491,854,764,,,0,0,0,,,,,,
492,855,788,492,854,788,,,0,1,0,,,,,,
497,878,235,497,877,235,,,0,1,0,,,,,,
497,878,235,497,877,235,,,0,1,0,,,,,,
497,878,238,497,877,238,,,0,1,0,,,,,,
497,878,242,497,877,243,,,0,1,-1,,,,,,
497,878,249,497,878,249,,,0,0,0,,,,,,
497,878,257,497,878,258,,,0,0,-1,,,,,,
497,878,268,497,878,268,,,0,0,0,,,,,,
497,878,280,497,878,281,,,0,0,-1,,,,,,
497,878,294,497,878,294,,,0,0,0,,,,,,
498,878,309,497,878,309,,,1,0,0,,,,,,
498,878,325,498,878,325,,,0,0,0,,,,,,
498,879,343,498,878,343,,,0,1,0,,,,,,
498,879,361,498,878,361,,,0,1,0,,,,,,
498,879,380,498,878,380,,,0,1,0,,,,,,
499,879,400,499,879,400,,,0,0,0,,,,,,
499,879,420,499,879,420,,,0,0,0,,,,,,
499,879,441,499,879,441,,,0,0,0,,,,,,
500,880,463,499,879,462,,,1,1,1,,,,,,
500,880,485,500,879,484,,,0,1,1,,,,,,
501,880,507,500,880,506,,,1,0,1,,,,,,
501,880,529,501,880,529,,,0,0,0,,,,,,
502,881,552,501,880,552,,,1,1,0,,,,,,
502,881,575,502,881,575,,,0,0,0,,,,,,
503,881,598,502,881,598,,,1,0,0,,,,,,
503,881,622,503,881,621,,,0,0,1,,,,,,
504,882,645,503,882,645,,,1,0,0,,,,,,
504,882,669,504,882,669,,,0,0,0,,,,,,
505,883,693,504,882,693,,,1,1,0,,,,,,
506,883,717,505,883,717,,,1,0,0,,,,,,
506,883,741,506,883,741,,,0,0,0,,,,,,
507,884,766,507,883,766,,,0,1,0,,,,,,
508,884,790,507,884,790,,,1,0,0,,,,,,
125,35,19,125,34,19,,,0,1,0,,,,,,
125,35,28,125,34,19,,,0,1,9,,,,,,
125,35,47,125,35,46,,,0,0,1,,,,,,
126,36,69,125,36,69,,,1,0,0,,,,,,
126,37,91,126,37,91,,,0,0,0,,,,,,
126,39,115,126,38,115,,,0,1,0,,,,,,
127,40,138,127,40,138,,,0,0,0,,,,,,
127,42,162,127,42,162,,,0,0,0,,,,,,
128,45,186,128,44,186,,,0,1,0,,,,,,
129,47,210,129,47,210,,,0,0,0,,,,,,
130,50,234,130,50,234,,,0,0,0,,,,,,
131,53,259,131,53,259,,,0,0,0,,,,,,
132,56,283,132,56,283,,,0,0,0,,,,,,
133,59,308,133,59,308,,,0,0,0,,,,,,
134,62,333,134,62,333,,,0,0,0,,,,,,
135,65,357,136,65,357,,,-1,0,0,,,,,,
137,69,382,137,69,382,,,0,0,0,,,,,,
138,72,407,139,72,407,,,-1,0,0,,,,,,
140,76,432,141,76,432,,,-1,0,0,,,,,,
142,79,457,142,79,457,,,0,0,0,,,,,,
144,83,482,144,83,482,,,0,0,0,,,,,,
146,87,507,146,87,507,,,0,0,0,,,,,,
148,90,532,148,90,532,,,0,0,0,,,,,,
150,94,558,150,94,557,,,0,0,1,,,,,,
152,98,583,153,98,583,,,-1,0,0,,,,,,
154,102,608,155,102,608,,,-1,0,0,,,,,,
156,105,634,157,106,634,,,-1,-1,0,,,,,,
159,109,659,159,109,659,,,0,0,0,,,,,,
161,113,684,162,113,684,,,-1,0,0,,,,,,
164,117,710,164,117,709,,,0,0,1,,,,,,
166,121,735,167,121,735,,,-1,0,0,,,,,,
169,125,761,169,125,760,,,0,0,1,,,,,,
126,41,20,125,34,19,,,1,7,1,,,,,,
126,41,28,125,34,19,,,1,7,9,,,,,,
126,42,47,125,35,46,,,1,7,1,,,,,,
126,42,69,125,36,69,,,1,6,0,,,,,,
126,43,91,126,37,91,,,0,6,0,,,,,,
127,45,115,126,38,115,,,1,7,0,,,,,,
127,46,138,127,40,138,,,0,6,0,,,,,,
128,48,162,127,42,162,,,1,6,0,,,,,,
128,50,186,128,44,186,,,0,6,0,,,,,,
129,52,210,129,47,210,,,0,5,0,,,,,,
130,55,235,130,50,234,,,0,5,1,,,,,,
131,57,259,131,53,259,,,0,4,0,,,,,,
132,60,283,132,56,283,,,0,4,0,,,,,,
133,63,308,133,59,308,,,0,4,0,,,,,,
134,66,333,134,62,333,,,0,4,0,,,,,,
136,69,357,136,65,357,,,0,4,0,,,,,,
137,72,382,137,69,382,,,0,3,0,,,,,,
139,75,407,139,72,407,,,0,3,0,,,,,,
141,79,432,141,76,432,,,0,3,0,,,,,,
142,82,457,142,79,457,,,0,3,0,,,,,,
144,86,482,144,83,482,,,0,3,0,,,,,,
146,89,507,146,87,507,,,0,2,0,,,,,,
148,93,532,148,90,532,,,0,3,0,,,,,,
150,96,558,150,94,557,,,0,2,1,,,,,,
152,100,583,153,98,583,,,-1,2,0,,,,,,
154,104,608,155,102,608,,,-1,2,0,,,,,,
157,108,634,157,106,634,,,0,2,0,,,,,,
159,111,659,159,109,659,,,0,2,0,,,,,,
162,115,684,162,113,684,,,0,2,0,,,,,,
164,119,710,164,117,709,,,0,2,1,,,,,,
167,123,735,167,121,735,,,0,2,0,,,,,,
169,127,761,169,125,760,,,0,2,1,,,,,,
128,60,23,128,60,23,,,0,0,0,,,,,,
128,60,30,128,60,23,,,0,0,7,,,,,,
128,60,48,128,60,48,,,0,0,0,,,,,,
128,60,70,128,60,70,,,0,0,0,,,,,,
128,61,92,128,61,92,,,0,0,0,,,,,,
129,62,115,129,62,115,,,0,0,0,,,,,,
129,63,139,129,63,138,,,0,0,1,,,,,,
130,64,162,130,65,162,,,0,-1,0,,,,,,
130,66,186,131,66,186,,,-1,0,0,,,,,,
131,67,210,131,68,210,,,0,-1,0,,,,,,
132,69,235,132,69,235,,,0,0,0,,,,,,
133,71,259,133,71,259,,,0,0,0,,,,,,
134,73,284,134,74,283,,,0,-1,1,,,,,,
135,76,308,135,76,308,,,0,0,0,,,,,,
136,78,333,137,78,333,,,-1,0,0,,,,,,
138,81,358,138,81,357,,,0,0,1,,,,,,
139,84,382,139,84,382,,,0,0,0,,,,,,
141,86,407,141,86,407,,,0,0,0,,,,,,
142,89,432,143,89,432,,,-1,0,0,,,,,,
144,92,457,144,92,457,,,0,0,0,,,,,,
146,95,482,146,95,482,,,0,0,0,,,,,,
148,98,507,148,98,507,,,0,0,0,,,,,,
150,102,533,150,102,532,,,0,0,1,,,,,,
152,105,558,152,105,557,,,0,0,1,,,,,,
154,108,583,154,109,583,,,0,-1,0,,,,,,
156,112,608,156,112,608,,,0,0,0,,,,,,
158,115,634,159,115,634,,,-1,0,0,,,,,,
161,119,659,161,118,659,,,0,1,0,,,,,,
163,122,684,164,122,684,,,-1,0,0,,,,,,
165,126,710,166,126,710,,,-1,0,0,,,,,,
168,129,735,169,129,735,,,-1,0,0,,,,,,
171,133,761,171,133,761,,,0,0,0,,,,,,
131,83,27,132,84,28,,,-1,-1,-1,,,,,,
131,83,34,132,84,28,,,-1,-1,6,,,,,,
131,83,50,132,84,51,,,-1,-1,-1,,,,,,
132,83,71,132,84,72,,,0,-1,-1,,,,,,
132,84,93,133,85,93,,,-1,-1,0,,,,,,
132,85,116,133,86,116,,,-1,-1,0,,,,,,
133,85,139,134,86,139,,,-1,-1,0,,,,,,
133,86,163,134,88,163,,,-1,-2,0,,,,,,
134,87,187,135,89,187,,,-1,-2,0,,,,,,
134,88,211,136,90,211,,,-2,-2,0,,,,,,
135,90,235,136,91,235,,,-1,-1,0,,,,,,
136,91,259,137,93,259,,,-1,-2,0,,,,,,
137,93,284,138,95,284,,,-1,-2,0,,,,,,
138,95,308,139,96,308,,,-1,-1,0,,,,,,
140,97,333,141,98,333,,,-1,-1,0,,,,,,
141,99,358,142,101,358,,,-1,-2,0,,,,,,
142,101,383,143,103,382,,,-1,-2,1,,,,,,
144,103,407,145,105,407,,,-1,-2,0,,,,,,
145,106,432,146,108,432,,,-1,-2,0,,,,,,
147,108,457,148,110,457,,,-1,-2,0,,,,,,
149,111,482,150,113,482,,,-1,-2,0,,,,,,
151,113,508,152,115,507,,,-1,-2,1,,,,,,
153,116,533,154,118,532,,,-1,-2,1,,,,,,
155,119,558,156,121,557,,,-1,-2,1,,,,,,
157,122,583,158,124,583,,,-1,-2,0,,,,,,
159,125,608,160,127,608,,,-1,-2,0,,,,,,
161,128,634,162,130,634,,,-1,-2,0,,,,,,
163,131,659,164,133,659,,,-1,-2,0,,,,,,
166,134,685,167,136,684,,,-1,-2,1,,,,,,
168,138,710,169,139,710,,,-1,-1,0,,,,,,
171,141,736,172,143,735,,,-1,-2,1,,,,,,
173,144,761,174,146,761,,,-1,-2,0,,,,,,
136,108,33,137,108,33,,,-1,0,0,,,,,,
136,108,38,137,108,33,,,-1,0,5,,,,,,
136,108,53,137,109,53,,,-1,-1,0,,,,,,
137,109,73,137,109,74,,,0,0,-1,,,,,,
137,109,95,137,109,94,,,0,0,1,,,,,,
137,109,117,138,109,117,,,-1,0,0,,,,,,
138,110,140,138,110,140,,,0,0,0,,,,,,
138,111,164,139,111,164,,,-1,0,0,,,,,,
139,111,188,139,112,187,,,0,-1,1,,,,,,
139,112,212,140,113,211,,,-1,-1,1,,,,,,
140,113,236,141,114,235,,,-1,-1,1,,,,,,
141,115,260,141,115,260,,,0,0,0,,,,,,
142,116,284,142,116,284,,,0,0,0,,,,,,
143,117,309,143,117,309,,,0,0,0,,,,,,
144,119,333,145,119,333,,,-1,0,0,,,,,,
145,120,358,146,120,358,,,-1,0,0,,,,,,
147,122,383,148,122,383,,,-1,0,0,,,,,,
148,124,408,149,124,408,,,-1,0,0,,,,,,
150,126,433,150,126,433,,,0,0,0,,,,,,
151,128,458,152,128,458,,,-1,0,0,,,,,,
153,130,483,154,130,483,,,-1,0,0,,,,,,
155,133,508,155,132,508,,,0,1,0,,,,,,
157,135,533,157,135,533,,,0,0,0,,,,,,
159,137,558,159,137,558,,,0,0,0,,,,,,
161,140,583,162,139,583,,,-1,1,0,,,,,,
163,142,609,164,142,608,,,-1,0,1,,,,,,
165,145,634,166,145,634,,,-1,0,0,,,,,,
167,148,659,168,148,659,,,-1,0,0,,,,,,
170,150,685,170,150,685,,,0,0,0,,,,,,
172,153,710,173,153,710,,,-1,0,0,,,,,,
174,156,736,175,156,736,,,-1,0,0,,,,,,
177,159,761,178,159,761,,,-1,0,0,,,,,,
143,134,39,144,134,39,,,-1,0,0,,,,,,
143,134,44,144,134,39,,,-1,0,5,,,,,,
143,135,57,144,135,57,,,-1,0,0,,,,,,
143,135,76,144,135,77,,,-1,0,-1,,,,,,
143,135,97,144,135,97,,,-1,0,0,,,,,,
144,135,119,145,135,119,,,-1,0,0,,,,,,
144,136,142,145,136,142,,,-1,0,0,,,,,,
144,136,165,146,137,165,,,-2,-1,0,,,,,,
145,137,189,146,137,188,,,-1,0,1,,,,,,
146,138,212,147,138,212,,,-1,0,0,,,,,,
146,139,236,148,139,236,,,-2,0,0,,,,,,
147,140,261,148,140,260,,,-1,0,1,,,,,,
148,141,285,149,141,285,,,-1,0,0,,,,,,
149,142,309,150,142,309,,,-1,0,0,,,,,,
150,143,334,152,143,334,,,-2,0,0,,,,,,
152,144,359,153,145,358,,,-1,-1,1,,,,,,
153,146,383,154,146,383,,,-1,0,0,,,,,,
154,147,408,155,148,408,,,-1,-1,0,,,,,,
156,149,433,157,150,433,,,-1,-1,0,,,,,,
157,151,458,158,151,458,,,-1,0,0,,,,,,
159,152,483,160,153,483,,,-1,-1,0,,,,,,
161,154,508,162,155,508,,,-1,-1,0,,,,,,
162,156,533,164,157,533,,,-2,-1,0,,,,,,
164,158,558,166,159,558,,,-2,-1,0,,,,,,
166,160,584,168,161,583,,,-2,-1,1,,,,,,
168,163,609,170,163,608,,,-2,0,1,,,,,,
170,165,634,172,166,634,,,-2,-1,0,,,,,,
172,167,660,174,168,659,,,-2,-1,1,,,,,,
175,170,685,176,170,685,,,-1,0,0,,,,,,
177,172,710,178,173,710,,,-1,-1,0,,,,,,
179,175,736,181,176,736,,,-2,-1,0,,,,,,
182,177,761,183,178,761,,,-1,-1,0,,,,,,
151,161,46,151,161,45,,,0,0,1,,,,,,
151,161,50,151,161,45,,,0,0,5,,,,,,
151,161,62,151,161,62,,,0,0,0,,,,,,
151,161,79,151,161,80,,,0,0,-1,,,,,,
151,162,99,152,162,99,,,-1,0,0,,,,,,
151,162,121,152,162,121,,,-1,0,0,,,,,,
152,162,143,153,162,143,,,-1,0,0,,,,,,
152,163,166,153,163,166,,,-1,0,0,,,,,,
153,163,190,154,163,190,,,-1,0,0,,,,,,
153,164,213,154,164,213,,,-1,0,0,,,,,,
154,165,237,155,164,237,,,-1,1,0,,,,,,
155,165,262,155,165,261,,,0,0,1,,,,,,
156,166,286,156,166,286,,,0,0,0,,,,,,
157,167,310,157,167,310,,,0,0,0,,,,,,
158,168,335,159,168,335,,,-1,0,0,,,,,,
159,169,359,160,169,359,,,-1,0,0,,,,,,
160,171,384,161,170,384,,,-1,1,0,,,,,,
161,172,409,162,172,408,,,-1,0,1,,,,,,
163,173,434,163,173,433,,,0,0,1,,,,,,
164,175,458,165,175,458,,,-1,0,0,,,,,,
166,176,483,167,176,483,,,-1,0,0,,,,,,
168,178,509,168,178,508,,,0,0,1,,,,,,
169,180,534,170,179,534,,,-1,1,0,,,,,,
171,181,559,172,181,559,,,-1,0,0,,,,,,
173,183,584,174,183,584,,,-1,0,0,,,,,,
175,185,609,176,185,609,,,-1,0,0,,,,,,
177,187,635,178,187,634,,,-1,0,1,,,,,,
179,189,660,180,189,659,,,-1,0,1,,,,,,
181,191,685,182,191,685,,,-1,0,0,,,,,,
183,193,711,184,193,710,,,-1,0,1,,,,,,
185,196,736,187,196,736,,,-2,0,0,,,,,,
188,198,762,189,198,761,,,-1,0,1,,,,,,
160,188,53,161,188,52,,,-1,0,1,,,,,,
160,188,56,161,188,52,,,-1,0,4,,,,,,
160,189,67,161,188,67,,,-1,1,0,,,,,,
160,189,83,161,188,85,,,-1,1,-2,,,,,,
160,189,102,161,189,102,,,-1,0,0,,,,,,
160,189,123,162,189,124,,,-2,0,-1,,,,,,
161,189,145,162,189,145,,,-1,0,0,,,,,,
161,190,168,162,190,168,,,-1,0,0,,,,,,
162,190,191,163,190,191,,,-1,0,0,,,,,,
162,191,215,163,191,215,,,-1,0,0,,,,,,
163,191,239,164,191,238,,,-1,0,1,,,,,,
164,192,263,165,192,262,,,-1,0,1,,,,,,
164,193,287,165,193,287,,,-1,0,0,,,,,,
165,193,311,166,194,311,,,-1,-1,0,,,,,,
166,194,335,168,194,335,,,-2,0,0,,,,,,
167,195,360,169,195,360,,,-2,0,0,,,,,,
169,196,385,170,196,384,,,-1,0,1,,,,,,
170,197,409,171,198,409,,,-1,-1,0,,,,,,
171,199,434,172,199,434,,,-1,0,0,,,,,,
173,200,459,174,200,459,,,-1,0,0,,,,,,
174,201,484,175,201,484,,,-1,0,0,,,,,,
176,203,509,177,203,509,,,-1,0,0,,,,,,
177,204,534,179,204,534,,,-2,0,0,,,,,,
179,206,559,180,206,559,,,-1,0,0,,,,,,
181,207,584,182,207,584,,,-1,0,0,,,,,,
183,209,610,184,209,609,,,-1,0,1,,,,,,
184,211,635,186,211,635,,,-2,0,0,,,,,,
186,212,660,188,212,660,,,-2,0,0,,,,,,
188,214,686,190,214,685,,,-2,0,1,,,,,,
191,216,711,192,216,711,,,-1,0,0,,,,,,
193,218,737,194,219,736,,,-1,-1,1,,,,,,
195,220,762,196,221,762,,,-1,-1,0,,,,,,
170,216,60,170,216,60,,,0,0,0,,,,,,
170,216,63,170,216,60,,,0,0,3,,,,,,
170,216,72,170,216,72,,,0,0,0,,,,,,
170,216,88,171,216,89,,,-1,0,-1,,,,,,
170,216,106,171,216,106,,,-1,0,0,,,,,,
170,216,126,171,216,127,,,-1,0,-1,,,,,,
171,217,148,171,217,148,,,0,0,0,,,,,,
171,217,170,172,217,170,,,-1,0,0,,,,,,
172,217,193,172,217,193,,,0,0,0,,,,,,
172,218,216,173,218,216,,,-1,0,0,,,,,,
173,218,240,174,218,240,,,-1,0,0,,,,,,
173,219,264,174,219,264,,,-1,0,0,,,,,,
174,220,288,175,220,288,,,-1,0,0,,,,,,
175,220,312,176,220,312,,,-1,0,0,,,,,,
176,221,336,177,221,336,,,-1,0,0,,,,,,
177,222,361,178,222,361,,,-1,0,0,,,,,,
178,223,385,179,223,385,,,-1,0,0,,,,,,
179,224,410,180,224,410,,,-1,0,0,,,,,,
180,225,435,181,225,435,,,-1,0,0,,,,,,
182,226,460,182,226,460,,,0,0,0,,,,,,
183,227,485,184,227,485,,,-1,0,0,,,,,,
185,228,510,185,228,510,,,0,0,0,,,,,,
186,229,535,187,229,535,,,-1,0,0,,,,,,
188,231,560,189,230,560,,,-1,1,0,,,,,,
189,232,585,190,232,585,,,-1,0,0,,,,,,
191,234,610,192,233,610,,,-1,1,0,,,,,,
193,235,635,194,235,635,,,-1,0,0,,,,,,
195,237,661,196,236,660,,,-1,1,1,,,,,,
197,238,686,198,238,686,,,-1,0,0,,,,,,
199,240,711,200,240,711,,,-1,0,0,,,,,,
201,242,737,202,242,737,,,-1,0,0,,,,,,
203,244,762,204,244,762,,,-1,0,0,,,,,,
181,244,67,182,243,67,,,-1,1,0,,,,,,
181,244,69,182,243,67,,,-1,1,2,,,,,,
181,244,78,182,243,78,,,-1,1,0,,,,,,
181,244,92,182,243,94,,,-1,1,-2,,,,,,
181,244,110,182,244,110,,,-1,0,0,,,,,,
181,244,130,182,244,130,,,-1,0,0,,,,,,
181,244,151,182,244,150,,,-1,0,1,,,,,,
182,245,173,183,244,173,,,-1,1,0,,,,,,
182,245,195,183,245,195,,,-1,0,0,,,,,,
183,245,218,184,245,218,,,-1,0,0,,,,,,
183,246,242,185,246,241,,,-2,0,1,,,,,,
184,246,265,185,246,265,,,-1,0,0,,,,,,
185,247,289,186,247,289,,,-1,0,0,,,,,,
186,247,313,187,247,313,,,-1,0,0,,,,,,
186,248,338,188,248,337,,,-2,0,1,,,,,,
187,249,362,189,249,362,,,-2,0,0,,,,,,
188,250,386,190,250,386,,,-2,0,0,,,,,,
190,250,411,191,250,411,,,-1,0,0,,,,,,
191,251,436,192,251,436,,,-1,0,0,,,,,,
192,252,461,193,252,460,,,-1,0,1,,,,,,
193,253,485,194,253,485,,,-1,0,0,,,,,,
195,254,510,196,254,510,,,-1,0,0,,,,,,
196,256,535,197,256,535,,,-1,0,0,,,,,,
198,257,560,199,257,560,,,-1,0,0,,,,,,
199,258,586,200,258,585,,,-1,0,1,,,,,,
201,259,611,202,259,610,,,-1,0,1,,,,,,
203,261,636,204,261,636,,,-1,0,0,,,,,,
204,262,661,206,262,661,,,-2,0,0,,,,,,
206,264,687,207,264,686,,,-1,0,1,,,,,,
208,265,712,209,265,712,,,-1,0,0,,,,,,
210,267,737,211,267,737,,,-1,0,0,,,,,,
212,268,763,213,269,763,,,-1,-1,0,,,,,,
192,272,74,193,271,74,,,-1,1,0,,,,,,
192,272,76,193,271,74,,,-1,1,2,,,,,,
192,272,85,193,271,84,,,-1,1,1,,,,,,
192,272,98,193,271,99,,,-1,1,-1,,,,,,
193,272,114,194,272,114,,,-1,0,0,,,,,,
193,272,133,194,272,134,,,-1,0,-1,,,,,,
193,272,154,194,272,153,,,-1,0,1,,,,,,
193,272,175,194,272,175,,,-1,0,0,,,,,,
194,273,197,195,272,197,,,-1,1,0,,,,,,
194,273,220,195,273,220,,,-1,0,0,,,,,,
195,273,243,196,273,243,,,-1,0,0,,,,,,
195,274,267,196,274,267,,,-1,0,0,,,,,,
196,274,291,197,274,291,,,-1,0,0,,,,,,
197,275,315,198,275,315,,,-1,0,0,,,,,,
198,275,339,199,275,339,,,-1,0,0,,,,,,
199,276,363,199,276,363,,,0,0,0,,,,,,
200,277,388,200,277,387,,,0,0,1,,,,,,
201,278,412,201,277,412,,,0,1,0,,,,,,
202,278,437,202,278,437,,,0,0,0,,,,,,
203,279,461,203,279,461,,,0,0,0,,,,,,
204,280,486,205,280,486,,,-1,0,0,,,,,,
205,281,511,206,281,511,,,-1,0,0,,,,,,
207,282,536,208,282,536,,,-1,0,0,,,,,,
208,283,561,209,283,561,,,-1,0,0,,,,,,
210,284,586,211,284,586,,,-1,0,0,,,,,,
211,286,611,212,285,611,,,-1,1,0,,,,,,
213,287,637,214,287,637,,,-1,0,0,,,,,,
215,288,662,216,288,662,,,-1,0,0,,,,,,
216,289,687,217,289,687,,,-1,0,0,,,,,,
218,291,713,219,291,712,,,-1,0,1,,,,,,
220,292,738,221,292,738,,,-1,0,0,,,,,,
222,294,763,223,294,763,,,-1,0,0,,,,,,
204,300,81,205,299,81,,,-1,1,0,,,,,,
204,300,84,205,299,81,,,-1,1,3,,,,,,
204,300,91,206,299,91,,,-2,1,0,,,,,,
205,300,103,206,299,105,,,-1,1,-2,,,,,,
205,300,119,206,300,119,,,-1,0,0,,,,,,
205,300,137,206,300,138,,,-1,0,-1,,,,,,
205,300,157,206,300,157,,,-1,0,0,,,,,,
206,300,178,207,300,178,,,-1,0,0,,,,,,
206,301,200,207,300,200,,,-1,1,0,,,,,,
206,301,223,208,301,223,,,-2,0,0,,,,,,
207,301,245,208,301,245,,,-1,0,0,,,,,,
207,302,269,209,302,269,,,-2,0,0,,,,,,
208,302,292,209,302,292,,,-1,0,0,,,,,,
209,303,316,210,302,316,,,-1,1,0,,,,,,
210,303,340,211,303,340,,,-1,0,0,,,,,,
210,304,364,211,304,364,,,-1,0,0,,,,,,
211,304,389,212,304,388,,,-1,0,1,,,,,,
212,305,413,213,305,413,,,-1,0,0,,,,,,
213,306,438,214,306,438,,,-1,0,0,,,,,,
214,307,462,215,306,462,,,-1,1,0,,,,,,
216,307,487,216,307,487,,,0,0,0,,,,,,
217,308,512,218,308,512,,,-1,0,0,,,,,,
218,309,537,219,309,537,,,-1,0,0,,,,,,
219,310,562,221,310,562,,,-2,0,0,,,,,,
221,311,587,222,311,587,,,-1,0,0,,,,,,
222,312,612,224,312,612,,,-2,0,0,,,,,,
224,313,637,225,313,637,,,-1,0,0,,,,,,
225,314,663,227,314,662,,,-2,0,1,,,,,,
227,316,688,228,316,687,,,-1,0,1,,,,,,
229,317,713,230,317,713,,,-1,0,0,,,,,,
231,318,739,232,318,738,,,-1,0,1,,,,,,
232,320,764,233,320,764,,,-1,0,0,,,,,,
217,328,89,218,327,89,,,-1,1,0,,,,,,
217,328,91,218,327,89,,,-1,1,2,,,,,,
217,328,98,218,327,97,,,-1,1,1,,,,,,
217,328,109,218,327,110,,,-1,1,-1,,,,,,
217,328,124,219,328,123,,,-2,0,1,,,,,,
218,328,141,219,328,142,,,-1,0,-1,,,,,,
218,328,161,219,328,160,,,-1,0,1,,,,,,
218,328,181,219,328,181,,,-1,0,0,,,,,,
219,329,203,220,328,203,,,-1,1,0,,,,,,
219,329,225,220,329,225,,,-1,0,0,,,,,,
219,329,248,221,329,248,,,-2,0,0,,,,,,
220,330,271,221,330,271,,,-1,0,0,,,,,,
221,330,294,222,330,294,,,-1,0,0,,,,,,
221,330,318,222,330,318,,,-1,0,0,,,,,,
222,331,342,223,331,342,,,-1,0,0,,,,,,
223,332,366,223,331,366,,,0,1,0,,,,,,
224,332,390,224,332,390,,,0,0,0,,,,,,
224,333,414,225,333,414,,,-1,0,0,,,,,,
225,333,439,226,333,439,,,-1,0,0,,,,,,
226,334,464,227,334,463,,,-1,0,1,,,,,,
228,335,488,228,334,488,,,0,1,0,,,,,,
229,336,513,229,335,513,,,0,1,0,,,,,,
230,336,538,231,336,538,,,-1,0,0,,,,,,
231,337,563,232,337,563,,,-1,0,0,,,,,,
233,338,588,234,338,588,,,-1,0,0,,,,,,
234,339,613,235,339,613,,,-1,0,0,,,,,,
235,340,638,237,340,638,,,-2,0,0,,,,,,
237,341,663,238,341,663,,,-1,0,0,,,,,,
238,342,689,239,342,688,,,-1,0,1,,,,,,
240,344,714,241,343,713,,,-1,1,1,,,,,,
242,345,739,243,344,739,,,-1,1,0,,,,,,
244,346,765,244,346,764,,,0,0,1,,,,,,
230,356,96,231,356,96,,,-1,0,0,,,,,,
230,356,98,231,356,96,,,-1,0,2,,,,,,
230,356,104,232,356,104,,,-2,0,0,,,,,,
230,356,115,232,356,116,,,-2,0,-1,,,,,,
231,356,129,232,356,129,,,-1,0,0,,,,,,
231,356,146,232,356,146,,,-1,0,0,,,,,,
231,357,165,232,356,164,,,-1,1,1,,,,,,
231,357,185,232,356,185,,,-1,1,0,,,,,,
232,357,206,233,357,206,,,-1,0,0,,,,,,
232,357,228,233,357,228,,,-1,0,0,,,,,,
232,357,250,234,357,250,,,-2,0,0,,,,,,
233,358,273,234,358,273,,,-1,0,0,,,,,,
234,358,296,235,358,296,,,-1,0,0,,,,,,
234,359,320,235,358,320,,,-1,1,0,,,,,,
235,359,344,236,359,343,,,-1,0,1,,,,,,
236,359,367,236,359,367,,,0,0,0,,,,,,
236,360,392,237,360,391,,,-1,0,1,,,,,,
237,361,416,238,361,416,,,-1,0,0,,,,,,
238,361,440,239,361,440,,,-1,0,0,,,,,,
239,362,465,240,362,465,,,-1,0,0,,,,,,
240,362,489,241,362,489,,,-1,0,0,,,,,,
241,363,514,242,363,514,,,-1,0,0,,,,,,
242,364,539,243,364,539,,,-1,0,0,,,,,,
244,365,564,244,365,564,,,0,0,0,,,,,,
245,366,589,246,366,589,,,-1,0,0,,,,,,
246,367,614,247,367,614,,,-1,0,0,,,,,,
248,367,639,249,368,639,,,-1,-1,0,,,,,,
249,368,664,250,368,664,,,-1,0,0,,,,,,
250,369,689,251,369,689,,,-1,0,0,,,,,,
252,370,715,253,370,714,,,-1,0,1,,,,,,
254,372,740,255,371,740,,,-1,1,0,,,,,,
255,373,765,256,372,765,,,-1,1,0,,,,,,
244,384,104,245,384,103,,,-1,0,1,,,,,,
244,384,105,245,384,103,,,-1,0,2,,,,,,
244,384,111,245,384,111,,,-1,0,0,,,,,,
244,385,121,245,384,123,,,-1,1,-2,,,,,,
244,385,135,245,384,134,,,-1,1,1,,,,,,
244,385,151,245,384,151,,,-1,1,0,,,,,,
245,385,169,245,384,169,,,0,1,0,,,,,,
245,385,189,246,385,189,,,-1,0,0,,,,,,
245,385,209,246,385,209,,,-1,0,0,,,,,,
245,385,231,246,385,231,,,-1,0,0,,,,,,
246,386,253,247,385,253,,,-1,1,0,,,,,,
246,386,276,247,386,275,,,-1,0,1,,,,,,
247,386,299,248,386,298,,,-1,0,1,,,,,,
247,387,322,248,387,322,,,-1,0,0,,,,,,
248,387,345,249,387,345,,,-1,0,0,,,,,,
249,388,369,250,388,369,,,-1,0,0,,,,,,
250,388,393,251,388,393,,,-1,0,0,,,,,,
250,389,417,251,389,417,,,-1,0,0,,,,,,
251,389,442,252,389,442,,,-1,0,0,,,,,,
252,390,466,253,390,466,,,-1,0,0,,,,,,
253,390,491,254,390,491,,,-1,0,0,,,,,,
254,391,515,255,391,515,,,-1,0,0,,,,,,
255,392,540,256,391,540,,,-1,1,0,,,,,,
256,393,565,257,392,565,,,-1,1,0,,,,,,
258,393,590,258,393,590,,,0,0,0,,,,,,
259,394,615,260,394,615,,,-1,0,0,,,,,,
260,395,640,261,395,640,,,-1,0,0,,,,,,
261,396,665,262,396,665,,,-1,0,0,,,,,,
263,397,690,263,396,690,,,0,1,0,,,,,,
264,398,715,265,397,715,,,-1,1,0,,,,,,
266,399,741,267,398,741,,,-1,1,0,,,,,,
267,400,766,268,399,766,,,-1,1,0,,,,,,
258,413,111,259,413,111,,,-1,0,0,,,,,,
258,413,113,259,413,111,,,-1,0,2,,,,,,
258,413,118,259,413,118,,,-1,0,0,,,,,,
258,413,128,259,413,129,,,-1,0,-1,,,,,,
258,413,140,259,413,140,,,-1,0,0,,,,,,
258,413,156,259,413,157,,,-1,0,-1,,,,,,
258,413,173,259,413,173,,,-1,0,0,,,,,,
259,414,193,260,413,193,,,-1,1,0,,,,,,
259,414,213,260,414,213,,,-1,0,0,,,,,,
259,414,234,260,414,234,,,-1,0,0,,,,,,
260,414,256,261,414,256,,,-1,0,0,,,,,,
260,414,278,261,414,278,,,-1,0,0,,,,,,
261,415,301,262,415,301,,,-1,0,0,,,,,,
261,415,324,262,415,324,,,-1,0,0,,,,,,
262,415,347,263,415,347,,,-1,0,0,,,,,,
262,416,371,263,416,371,,,-1,0,0,,,,,,
263,416,395,264,416,395,,,-1,0,0,,,,,,
264,417,419,265,417,419,,,-1,0,0,,,,,,
265,417,443,265,417,443,,,0,0,0,,,,,,
266,418,468,266,418,467,,,0,0,1,,,,,,
266,418,492,267,418,492,,,-1,0,0,,,,,,
267,419,517,268,419,516,,,-1,0,1,,,,,,
268,420,541,269,419,541,,,-1,1,0,,,,,,
269,420,566,270,420,566,,,-1,0,0,,,,,,
271,421,591,272,421,591,,,-1,0,0,,,,,,
272,422,616,273,422,616,,,-1,0,0,,,,,,
273,423,641,274,423,641,,,-1,0,0,,,,,,
274,424,666,275,423,666,,,-1,1,0,,,,,,
276,424,691,276,424,691,,,0,0,0,,,,,,
277,425,716,278,425,716,,,-1,0,0,,,,,,
278,426,742,279,426,741,,,-1,0,1,,,,,,
280,427,767,281,427,767,,,-1,0,0,,,,,,
272,442,119,273,441,118,,,-1,1,1,,,,,,
272,442,120,273,441,118,,,-1,1,2,,,,,,
272,442,125,273,441,125,,,-1,1,0,,,,,,
272,442,134,273,441,136,,,-1,1,-2,,,,,,
272,442,146,273,441,146,,,-1,1,0,,,,,,
272,442,161,273,441,162,,,-1,1,-1,,,,,,
272,442,178,274,442,178,,,-2,0,0,,,,,,
273,442,197,274,442,197,,,-1,0,0,,,,,,
273,442,217,274,442,216,,,-1,0,1,,,,,,
273,442,237,274,442,237,,,-1,0,0,,,,,,
274,443,259,275,442,259,,,-1,1,0,,,,,,
274,443,281,275,443,281,,,-1,0,0,,,,,,
275,443,303,276,443,303,,,-1,0,0,,,,,,
275,444,326,276,443,326,,,-1,1,0,,,,,,
276,444,350,277,444,350,,,-1,0,0,,,,,,
276,444,373,277,444,373,,,-1,0,0,,,,,,
277,445,397,278,444,397,,,-1,1,0,,,,,,
278,445,421,278,445,421,,,0,0,0,,,,,,
278,446,445,279,445,445,,,-1,1,0,,,,,,
279,446,469,280,446,469,,,-1,0,0,,,,,,
280,447,494,281,446,493,,,-1,1,1,,,,,,
281,447,518,282,447,518,,,-1,0,0,,,,,,
282,448,543,283,447,543,,,-1,1,0,,,,,,
283,448,567,284,448,567,,,-1,0,0,,,,,,
284,449,592,285,449,592,,,-1,0,0,,,,,,
285,450,617,286,450,617,,,-1,0,0,,,,,,
286,451,642,287,450,642,,,-1,1,0,,,,,,
288,451,667,288,451,667,,,0,0,0,,,,,,
289,452,692,290,452,692,,,-1,0,0,,,,,,
290,453,717,291,453,717,,,-1,0,0,,,,,,
291,454,743,292,454,742,,,-1,0,1,,,,,,
293,455,768,293,454,767,,,0,1,1,,,,,,
286,470,126,287,470,126,,,-1,0,0,,,,,,
286,470,128,287,470,126,,,-1,0,2,,,,,,
286,470,133,287,470,132,,,-1,0,1,,,,,,
286,470,141,287,470,142,,,-1,0,-1,,,,,,
286,470,152,287,470,152,,,-1,0,0,,,,,,
287,470,167,287,470,168,,,0,0,-1,,,,,,
287,471,183,288,470,183,,,-1,1,0,,,,,,
287,471,201,288,470,202,,,-1,1,-1,,,,,,
287,471,221,288,471,220,,,-1,0,1,,,,,,
288,471,241,288,471,241,,,0,0,0,,,,,,
288,471,262,289,471,262,,,-1,0,0,,,,,,
288,472,284,289,471,284,,,-1,1,0,,,,,,
289,472,306,290,472,306,,,-1,0,0,,,,,,
289,472,329,290,472,329,,,-1,0,0,,,,,,
290,472,352,291,472,352,,,-1,0,0,,,,,,
290,473,375,291,472,375,,,-1,1,0,,,,,,
291,473,399,292,473,399,,,-1,0,0,,,,,,
292,474,423,292,473,423,,,0,1,0,,,,,,
292,474,447,293,474,447,,,-1,0,0,,,,,,
293,474,471,294,474,471,,,-1,0,0,,,,,,
294,475,495,295,475,495,,,-1,0,0,,,,,,
295,476,520,296,475,519,,,-1,1,1,,,,,,
296,476,544,296,476,544,,,0,0,0,,,,,,
297,477,569,297,476,569,,,0,1,0,,,,,,
298,477,594,299,477,593,,,-1,0,1,,,,,,
299,478,618,300,478,618,,,-1,0,0,,,,,,
300,479,643,301,478,643,,,-1,1,0,,,,,,
301,479,668,302,479,668,,,-1,0,0,,,,,,
302,480,693,303,480,693,,,-1,0,0,,,,,,
304,481,718,304,481,718,,,0,0,0,,,,,,
305,482,744,306,481,743,,,-1,1,1,,,,,,
306,483,769,307,482,768,,,-1,1,1,,,,,,
301,499,134,302,499,134,,,-1,0,0,,,,,,
301,499,135,302,499,134,,,-1,0,1,,,,,,
301,499,140,302,499,139,,,-1,0,1,,,,,,
301,499,148,302,499,149,,,-1,0,-1,,,,,,
301,499,159,302,499,158,,,-1,0,1,,,,,,
301,499,172,302,499,173,,,-1,0,-1,,,,,,
301,499,188,302,499,188,,,-1,0,0,,,,,,
302,499,206,302,499,206,,,0,0,0,,,,,,
302,500,225,303,499,225,,,-1,1,0,,,,,,
302,500,245,303,499,245,,,-1,1,0,,,,,,
302,500,266,303,500,265,,,-1,0,1,,,,,,
303,500,287,303,500,287,,,0,0,0,,,,,,
303,500,309,304,500,309,,,-1,0,0,,,,,,
304,501,332,304,500,331,,,0,1,1,,,,,,
304,501,355,305,501,354,,,-1,0,1,,,,,,
305,501,378,305,501,377,,,0,0,1,,,,,,
305,502,401,306,501,401,,,-1,1,0,,,,,,
306,502,425,307,502,425,,,-1,0,0,,,,,,
307,503,449,307,502,449,,,0,1,0,,,,,,
307,503,473,308,503,473,,,-1,0,0,,,,,,
308,503,497,309,503,497,,,-1,0,0,,,,,,
309,504,521,310,504,521,,,-1,0,0,,,,,,
310,504,546,310,504,546,,,0,0,0,,,,,,
311,505,570,311,505,570,,,0,0,0,,,,,,
312,506,595,312,505,595,,,0,1,0,,,,,,
313,506,620,313,506,619,,,0,0,1,,,,,,
314,507,645,314,507,644,,,0,0,1,,,,,,
315,508,669,315,507,669,,,0,1,0,,,,,,
316,508,694,317,508,694,,,-1,0,0,,,,,,
317,509,720,318,509,719,,,-1,0,1,,,,,,
318,510,745,319,509,745,,,-1,1,0,,,,,,
320,511,770,320,510,770,,,0,1,0,,,,,,
316,528,142,316,527,142,,,0,1,0,,,,,,
316,528,143,316,527,142,,,0,1,1,,,,,,
316,528,147,316,527,147,,,0,1,0,,,,,,
316,528,155,316,528,156,,,0,0,-1,,,,,,
316,528,165,317,528,165,,,-1,0,0,,,,,,
316,528,178,317,528,179,,,-1,0,-1,,,,,,
316,528,194,317,528,193,,,-1,0,1,,,,,,
316,528,211,317,528,211,,,-1,0,0,,,,,,
317,528,229,317,528,229,,,0,0,0,,,,,,
317,529,249,318,528,249,,,-1,1,0,,,,,,
317,529,269,318,528,269,,,-1,1,0,,,,,,
318,529,290,318,529,290,,,0,0,0,,,,,,
318,529,312,318,529,312,,,0,0,0,,,,,,
318,529,335,319,529,334,,,-1,0,1,,,,,,
319,530,357,319,529,357,,,0,1,0,,,,,,
319,530,380,320,530,380,,,-1,0,0,,,,,,
320,530,403,321,530,403,,,-1,0,0,,,,,,
321,531,427,321,530,427,,,0,1,0,,,,,,
321,531,451,322,531,451,,,-1,0,0,,,,,,
322,532,475,322,531,475,,,0,1,0,,,,,,
323,532,499,323,532,499,,,0,0,0,,,,,,
323,532,523,324,532,523,,,-1,0,0,,,,,,
324,533,547,325,533,547,,,-1,0,0,,,,,,
325,533,572,326,533,572,,,-1,0,0,,,,,,
326,534,596,327,534,596,,,-1,0,0,,,,,,
327,535,621,328,534,621,,,-1,1,0,,,,,,
328,535,646,329,535,645,,,-1,0,1,,,,,,
329,536,671,330,536,670,,,-1,0,1,,,,,,
330,537,696,331,536,695,,,-1,1,1,,,,,,
331,537,721,332,537,720,,,-1,0,1,,,,,,
332,538,746,333,538,746,,,-1,0,0,,,,,,
334,539,771,334,538,771,,,0,1,0,,,,,,
331,557,149,331,556,149,,,0,1,0,,,,,,
331,557,151,331,556,149,,,0,1,2,,,,,,
331,557,154,331,556,154,,,0,1,0,,,,,,
331,557,162,331,556,163,,,0,1,-1,,,,,,
331,557,172,332,557,171,,,-1,0,1,,,,,,
331,557,184,332,557,185,,,-1,0,-1,,,,,,
331,557,199,332,557,199,,,-1,0,0,,,,,,
331,557,216,332,557,216,,,-1,0,0,,,,,,
331,557,234,332,557,234,,,-1,0,0,,,,,,
332,557,253,332,557,253,,,0,0,0,,,,,,
332,558,273,333,557,273,,,-1,1,0,,,,,,
332,558,294,333,557,294,,,-1,1,0,,,,,,
333,558,316,333,558,315,,,0,0,1,,,,,,
333,558,338,334,558,337,,,-1,0,1,,,,,,
334,559,360,334,558,360,,,0,1,0,,,,,,
334,559,383,335,558,383,,,-1,1,0,,,,,,
335,559,406,335,559,406,,,0,0,0,,,,,,
335,559,429,336,559,429,,,-1,0,0,,,,,,
336,560,453,336,560,453,,,0,0,0,,,,,,
336,560,477,337,560,477,,,-1,0,0,,,,,,
337,561,501,338,560,501,,,-1,1,0,,,,,,
338,561,525,338,561,525,,,0,0,0,,,,,,
339,562,549,339,561,549,,,0,1,0,,,,,,
340,562,573,340,562,573,,,0,0,0,,,,,,
340,563,598,341,562,598,,,-1,1,0,,,,,,
341,563,623,342,563,622,,,-1,0,1,,,,,,
342,564,647,343,563,647,,,-1,1,0,,,,,,
343,564,672,344,564,672,,,-1,0,0,,,,,,
344,565,697,345,565,697,,,-1,0,0,,,,,,
345,566,722,346,565,722,,,-1,1,0,,,,,,
347,566,747,347,566,747,,,0,0,0,,,,,,
348,567,772,348,567,772,,,0,0,0,,,,,,
346,586,157,346,585,157,,,0,1,0,,,,,,
346,586,158,346,585,157,,,0,1,1,,,,,,
346,586,162,346,585,162,,,0,1,0,,,,,,
346,586,169,346,585,170,,,0,1,-1,,,,,,
346,586,178,347,586,178,,,-1,0,0,,,,,,
346,586,190,347,586,191,,,-1,0,-1,,,,,,
346,586,205,347,586,204,,,-1,0,1,,,,,,
346,586,221,347,586,221,,,-1,0,0,,,,,,
346,586,239,347,586,238,,,-1,0,1,,,,,,
347,586,257,347,586,258,,,0,0,-1,,,,,,
347,586,277,348,586,277,,,-1,0,0,,,,,,
347,587,298,348,586,298,,,-1,1,0,,,,,,
348,587,319,348,587,319,,,0,0,0,,,,,,
348,587,341,349,587,341,,,-1,0,0,,,,,,
349,587,363,349,587,363,,,0,0,0,,,,,,
349,588,386,349,587,385,,,0,1,1,,,,,,
350,588,409,350,588,408,,,0,0,1,,,,,,
350,588,432,350,588,431,,,0,0,1,,,,,,
351,589,455,351,588,455,,,0,1,0,,,,,,
351,589,479,352,589,479,,,-1,0,0,,,,,,
352,589,503,353,589,503,,,-1,0,0,,,,,,
353,590,527,353,589,527,,,0,1,0,,,,,,
353,590,551,354,590,551,,,-1,0,0,,,,,,
354,591,575,355,590,575,,,-1,1,0,,,,,,
355,591,600,356,591,599,,,-1,0,1,,,,,,
356,592,624,357,591,624,,,-1,1,0,,,,,,
357,592,649,358,592,648,,,-1,0,1,,,,,,
358,593,674,358,592,673,,,0,1,1,,,,,,
359,593,698,359,593,698,,,0,0,0,,,,,,
360,594,723,360,594,723,,,0,0,0,,,,,,
361,595,748,362,595,748,,,-1,0,0,,,,,,
362,595,773,363,595,773,,,-1,0,0,,,,,,
361,615,165,362,614,165,,,-1,1,0,,,,,,
361,615,166,362,614,165,,,-1,1,1,,,,,,
361,615,169,362,614,169,,,-1,1,0,,,,,,
361,615,176,362,614,177,,,-1,1,-1,,,,,,
361,615,185,362,615,185,,,-1,0,0,,,,,,
361,615,197,362,615,197,,,-1,0,0,,,,,,
361,615,211,362,615,210,,,-1,0,1,,,,,,
361,615,226,362,615,227,,,-1,0,-1,,,,,,
362,615,243,362,615,243,,,0,0,0,,,,,,
362,615,262,362,615,262,,,0,0,0,,,,,,
362,615,281,363,615,281,,,-1,0,0,,,,,,
362,616,302,363,615,302,,,-1,1,0,,,,,,
363,616,323,364,616,322,,,-1,0,1,,,,,,
363,616,344,364,616,344,,,-1,0,0,,,,,,
364,616,366,364,616,366,,,0,0,0,,,,,,
364,617,388,364,616,388,,,0,1,0,,,,,,
365,617,411,365,617,411,,,0,0,0,,,,,,
365,617,434,365,617,434,,,0,0,0,,,,,,
366,617,458,366,617,457,,,0,0,1,,,,,,
366,618,481,367,618,481,,,-1,0,0,,,,,,
367,618,505,368,618,505,,,-1,0,0,,,,,,
368,619,529,368,618,529,,,0,1,0,,,,,,
368,619,553,369,619,553,,,-1,0,0,,,,,,
369,619,577,370,619,577,,,-1,0,0,,,,,,
370,620,601,371,620,601,,,-1,0,0,,,,,,
371,620,626,371,620,626,,,0,0,0,,,,,,
372,621,651,372,621,650,,,0,0,1,,,,,,
372,622,675,373,621,675,,,-1,1,0,,,,,,
373,622,700,374,622,700,,,-1,0,0,,,,,,
374,623,725,375,622,725,,,-1,1,0,,,,,,
375,623,750,376,623,750,,,-1,0,0,,,,,,
376,624,775,377,624,775,,,-1,0,0,,,,,,
376,644,173,377,643,172,,,-1,1,1,,,,,,
376,644,174,377,643,172,,,-1,1,2,,,,,,
376,644,177,377,643,177,,,-1,1,0,,,,,,
376,644,183,377,643,184,,,-1,1,-1,,,,,,
376,644,192,377,644,192,,,-1,0,0,,,,,,
376,644,203,377,644,204,,,-1,0,-1,,,,,,
377,644,217,377,644,216,,,0,0,1,,,,,,
377,644,232,377,644,232,,,0,0,0,,,,,,
377,644,249,377,644,248,,,0,0,1,,,,,,
377,644,267,378,644,267,,,-1,0,0,,,,,,
377,644,286,378,644,285,,,-1,0,1,,,,,,
378,645,306,378,644,306,,,0,1,0,,,,,,
378,645,326,379,645,326,,,-1,0,0,,,,,,
378,645,348,379,645,347,,,-1,0,1,,,,,,
379,645,369,379,645,369,,,0,0,0,,,,,,
379,646,392,379,645,391,,,0,1,1,,,,,,
380,646,414,380,646,414,,,0,0,0,,,,,,
380,646,437,380,646,437,,,0,0,0,,,,,,
381,646,460,381,646,460,,,0,0,0,,,,,,
381,647,484,382,646,483,,,-1,1,1,,,,,,
382,647,507,383,647,507,,,-1,0,0,,,,,,
383,647,531,383,647,531,,,0,0,0,,,,,,
383,648,555,384,648,555,,,-1,0,0,,,,,,
384,648,579,384,648,579,,,0,0,0,,,,,,
385,649,603,385,648,603,,,0,1,0,,,,,,
386,649,628,386,649,627,,,0,0,1,,,,,,
386,650,652,387,649,652,,,-1,1,0,,,,,,
387,650,677,388,650,676,,,-1,0,1,,,,,,
388,651,702,389,650,701,,,-1,1,1,,,,,,
389,651,726,390,651,726,,,-1,0,0,,,,,,
390,652,751,391,652,751,,,-1,0,0,,,,,,
391,653,776,392,652,776,,,-1,1,0,,,,,,
392,673,180,392,673,180,,,0,0,0,,,,,,
392,673,181,392,673,180,,,0,0,1,,,,,,
392,673,184,392,673,184,,,0,0,0,,,,,,
392,673,190,392,673,191,,,0,0,-1,,,,,,
392,673,199,392,673,199,,,0,0,0,,,,,,
392,673,210,392,673,210,,,0,0,0,,,,,,
392,673,223,392,673,222,,,0,0,1,,,,,,
392,673,237,392,673,238,,,0,0,-1,,,,,,
392,673,254,393,673,254,,,-1,0,0,,,,,,
393,673,271,393,673,272,,,0,0,-1,,,,,,
393,674,290,393,673,290,,,0,1,0,,,,,,
393,674,310,394,673,310,,,-1,1,0,,,,,,
393,674,330,394,674,330,,,-1,0,0,,,,,,
394,674,351,394,674,351,,,0,0,0,,,,,,
394,674,373,395,674,373,,,-1,0,0,,,,,,
395,675,395,395,674,395,,,0,1,0,,,,,,
395,675,417,395,675,417,,,0,0,0,,,,,,
395,675,440,396,675,440,,,-1,0,0,,,,,,
396,675,463,396,675,463,,,0,0,0,,,,,,
397,676,486,397,675,486,,,0,1,0,,,,,,
397,676,510,398,676,509,,,-1,0,1,,,,,,
398,676,533,398,676,533,,,0,0,0,,,,,,
398,677,557,399,677,557,,,-1,0,0,,,,,,
399,677,581,399,677,581,,,0,0,0,,,,,,
400,678,605,400,677,605,,,0,1,0,,,,,,
401,678,630,401,678,629,,,0,0,1,,,,,,
401,679,654,402,678,654,,,-1,1,0,,,,,,
402,679,679,403,679,678,,,-1,0,1,,,,,,
403,680,703,404,679,703,,,-1,1,0,,,,,,
404,680,728,405,680,728,,,-1,0,0,,,,,,
405,681,753,406,680,753,,,-1,1,0,,,,,,
406,681,778,407,681,778,,,-1,0,0,,,,,,
407,702,188,408,702,188,,,-1,0,0,,,,,,
407,702,189,408,702,188,,,-1,0,1,,,,,,
407,702,192,408,702,192,,,-1,0,0,,,,,,
407,702,198,408,702,199,,,-1,0,-1,,,,,,
407,702,206,408,702,206,,,-1,0,0,,,,,,
407,702,216,408,702,217,,,-1,0,-1,,,,,,
407,702,229,408,702,228,,,-1,0,1,,,,,,
408,702,243,408,702,244,,,0,0,-1,,,,,,
408,702,259,408,702,259,,,0,0,0,,,,,,
408,703,276,408,702,277,,,0,1,-1,,,,,,
408,703,295,409,702,294,,,-1,1,1,,,,,,
409,703,314,409,702,314,,,0,1,0,,,,,,
409,703,334,409,703,334,,,0,0,0,,,,,,
409,703,355,410,703,355,,,-1,0,0,,,,,,
410,703,376,410,703,376,,,0,0,0,,,,,,
410,704,398,410,703,398,,,0,1,0,,,,,,
410,704,420,411,704,420,,,-1,0,0,,,,,,
411,704,443,411,704,443,,,0,0,0,,,,,,
411,704,466,412,704,465,,,-1,0,1,,,,,,
412,705,489,412,704,489,,,0,1,0,,,,,,
412,705,512,413,705,512,,,-1,0,0,,,,,,
413,705,536,413,705,535,,,0,0,1,,,,,,
414,706,559,414,706,559,,,0,0,0,,,,,,
414,706,583,415,706,583,,,-1,0,0,,,,,,
415,707,607,415,706,607,,,0,1,0,,,,,,
416,707,632,416,707,631,,,0,0,1,,,,,,
416,707,656,417,707,656,,,-1,0,0,,,,,,
417,708,680,418,708,680,,,-1,0,0,,,,,,
418,708,705,419,708,705,,,-1,0,0,,,,,,
419,709,730,419,709,729,,,0,0,1,,,,,,
420,709,754,420,709,754,,,0,0,0,,,,,,
421,710,779,421,710,779,,,0,0,0,,,,,,
423,731,196,423,731,196,,,0,0,0,,,,,,
423,731,197,423,731,196,,,0,0,1,,,,,,
423,731,200,423,731,199,,,0,0,1,,,,,,
423,731,205,423,731,206,,,0,0,-1,,,,,,
423,731,213,423,731,213,,,0,0,0,,,,,,
423,731,223,423,731,224,,,0,0,-1,,,,,,
423,731,235,424,731,235,,,-1,0,0,,,,,,
423,732,249,424,731,249,,,-1,1,0,,,,,,
423,732,265,424,731,264,,,-1,1,1,,,,,,
424,732,282,424,731,282,,,0,1,0,,,,,,
424,732,300,424,732,299,,,0,0,1,,,,,,
424,732,319,424,732,319,,,0,0,0,,,,,,
424,732,338,425,732,338,,,-1,0,0,,,,,,
425,732,359,425,732,359,,,0,0,0,,,,,,
425,733,380,425,732,380,,,0,1,0,,,,,,
425,733,401,426,732,401,,,-1,1,0,,,,,,
426,733,423,426,733,423,,,0,0,0,,,,,,
426,733,446,427,733,446,,,-1,0,0,,,,,,
427,734,468,427,733,468,,,0,1,0,,,,,,
427,734,491,428,733,491,,,-1,1,0,,,,,,
428,734,515,428,734,515,,,0,0,0,,,,,,
428,735,538,429,734,538,,,-1,1,0,,,,,,
429,735,562,429,735,562,,,0,0,0,,,,,,
430,735,586,430,735,585,,,0,0,1,,,,,,
430,736,610,431,735,609,,,-1,1,1,,,,,,
431,736,634,431,736,633,,,0,0,1,,,,,,
432,736,658,432,736,658,,,0,0,0,,,,,,
432,737,682,433,737,682,,,-1,0,0,,,,,,
433,737,707,434,737,707,,,-1,0,0,,,,,,
434,738,731,434,738,731,,,0,0,0,,,,,,
435,738,756,435,738,756,,,0,0,0,,,,,,
436,739,781,436,739,781,,,0,0,0,,,,,,
438,761,204,439,760,203,,,-1,1,1,,,,,,
438,761,204,439,760,203,,,-1,1,1,,,,,,
438,761,207,439,760,207,,,-1,1,0,,,,,,
438,761,212,439,760,213,,,-1,1,-1,,,,,,
439,761,220,439,760,220,,,0,1,0,,,,,,
439,761,230,439,760,230,,,0,1,0,,,,,,
439,761,242,439,760,241,,,0,1,1,,,,,,
439,761,255,439,760,255,,,0,1,0,,,,,,
439,761,270,439,760,270,,,0,1,0,,,,,,
439,761,287,440,761,287,,,-1,0,0,,,,,,
439,761,304,440,761,304,,,-1,0,0,,,,,,
440,761,323,440,761,323,,,0,0,0,,,,,,
440,761,343,440,761,342,,,0,0,1,,,,,,
440,762,363,441,761,363,,,-1,1,0,,,,,,
441,762,384,441,761,383,,,0,1,1,,,,,,
441,762,405,441,762,405,,,0,0,0,,,,,,
441,762,427,442,762,426,,,-1,0,1,,,,,,
442,763,449,442,762,449,,,0,1,0,,,,,,
442,763,471,443,762,471,,,-1,1,0,,,,,,
443,763,494,443,763,494,,,0,0,0,,,,,,
443,763,517,444,763,517,,,-1,0,0,,,,,,
444,764,541,444,763,541,,,0,1,0,,,,,,
444,764,564,445,764,564,,,-1,0,0,,,,,,
445,764,588,445,764,588,,,0,0,0,,,,,,
446,765,612,446,764,611,,,0,1,1,,,,,,
446,765,636,447,765,635,,,-1,0,1,,,,,,
447,766,660,447,765,660,,,0,1,0,,,,,,
448,766,684,448,766,684,,,0,0,0,,,,,,
449,766,709,449,766,709,,,0,0,0,,,,,,
449,767,733,450,767,733,,,-1,0,0,,,,,,
450,767,758,450,767,758,,,0,0,0,,,,,,
451,768,783,451,768,782,,,0,0,1,,,,,,
454,790,212,455,790,211,,,-1,0,1,,,,,,
454,790,212,455,790,211,,,-1,0,1,,,,,,
454,790,215,455,790,215,,,-1,0,0,,,,,,
454,790,220,455,790,221,,,-1,0,-1,,,,,,
454,790,227,455,790,227,,,-1,0,0,,,,,,
454,790,237,455,790,237,,,-1,0,0,,,,,,
454,790,248,455,790,248,,,-1,0,0,,,,,,
455,790,261,455,790,262,,,0,0,-1,,,,,,
455,790,276,455,790,276,,,0,0,0,,,,,,
455,790,292,455,790,292,,,0,0,0,,,,,,
455,790,310,456,790,309,,,-1,0,1,,,,,,
455,791,328,456,790,328,,,-1,1,0,,,,,,
456,791,347,456,791,347,,,0,0,0,,,,,,
456,791,367,456,791,367,,,0,0,0,,,,,,
456,791,388,457,791,387,,,-1,0,1,,,,,,
457,791,409,457,791,408,,,0,0,1,,,,,,
457,792,430,457,791,430,,,0,1,0,,,,,,
457,792,452,458,791,452,,,-1,1,0,,,,,,
458,792,475,458,792,474,,,0,0,1,,,,,,
458,792,497,459,792,497,,,-1,0,0,,,,,,
459,793,520,459,792,520,,,0,1,0,,,,,,
459,793,543,460,792,543,,,-1,1,0,,,,,,
460,793,567,460,793,567,,,0,0,0,,,,,,
460,794,590,461,793,590,,,-1,1,0,,,,,,
461,794,614,462,794,614,,,-1,0,0,,,,,,
462,794,638,462,794,638,,,0,0,0,,,,,,
462,795,662,463,794,662,,,-1,1,0,,,,,,
463,795,686,463,795,686,,,0,0,0,,,,,,
464,795,711,464,795,711,,,0,0,0,,,,,,
465,796,735,465,796,735,,,0,0,0,,,,,,
465,796,760,466,796,760,,,-1,0,0,,,,,,
466,797,784,467,797,784,,,-1,0,0,,,,,,
470,819,219,470,819,219,,,0,0,0,,,,,,
470,819,220,470,819,219,,,0,0,1,,,,,,
470,819,223,470,819,222,,,0,0,1,,,,,,
470,819,227,470,819,228,,,0,0,-1,,,,,,
470,819,234,470,819,234,,,0,0,0,,,,,,
470,819,244,470,819,244,,,0,0,0,,,,,,
470,819,255,471,819,254,,,-1,0,1,,,,,,
470,819,267,471,819,268,,,-1,0,-1,,,,,,
471,820,282,471,819,282,,,0,1,0,,,,,,
471,820,298,471,819,298,,,0,1,0,,,,,,
471,820,315,471,819,314,,,0,1,1,,,,,,
471,820,333,472,820,333,,,-1,0,0,,,,,,
471,820,352,472,820,351,,,-1,0,1,,,,,,
472,820,371,472,820,371,,,0,0,0,,,,,,
472,820,392,472,820,391,,,0,0,1,,,,,,
472,821,413,473,820,412,,,-1,1,1,,,,,,
473,821,434,473,820,433,,,0,1,1,,,,,,
473,821,456,473,821,455,,,0,0,1,,,,,,
474,821,478,474,821,477,,,0,0,1,,,,,,
474,822,500,474,821,500,,,0,1,0,,,,,,
474,822,523,475,821,523,,,-1,1,0,,,,,,
475,822,546,475,822,546,,,0,0,0,,,,,,
475,822,569,476,822,569,,,-1,0,0,,,,,,
476,823,593,476,822,593,,,0,1,0,,,,,,
477,823,617,477,823,616,,,0,0,1,,,,,,
477,823,640,478,823,640,,,-1,0,0,,,,,,
478,824,664,478,823,664,,,0,1,0,,,,,,
479,824,689,479,824,688,,,0,0,1,,,,,,
479,825,713,480,824,713,,,-1,1,0,,,,,,
480,825,737,480,825,737,,,0,0,0,,,,,,
481,826,762,481,825,762,,,0,1,0,,,,,,
482,826,786,482,826,786,,,0,0,0,,,,,,
486,849,227,486,848,227,,,0,1,0,,,,,,
486,849,228,486,848,227,,,0,1,1,,,,,,
486,849,230,486,848,230,,,0,1,0,,,,,,
486,849,235,486,848,236,,,0,1,-1,,,,,,
486,849,242,486,849,242,,,0,0,0,,,,,,
486,849,251,486,849,251,,,0,0,0,,,,,,
486,849,261,487,849,261,,,-1,0,0,,,,,,
486,849,274,487,849,274,,,-1,0,0,,,,,,
486,849,288,487,849,288,,,-1,0,0,,,,,,
487,849,303,487,849,304,,,0,0,-1,,,,,,
487,849,320,487,849,320,,,0,0,0,,,,,,
487,849,338,487,849,338,,,0,0,0,,,,,,
487,849,356,488,849,356,,,-1,0,0,,,,,,
487,850,376,488,849,376,,,-1,1,0,,,,,,
488,850,396,488,850,396,,,0,0,0,,,,,,
488,850,416,488,850,416,,,0,0,0,,,,,,
488,850,438,489,850,437,,,-1,0,1,,,,,,
489,850,459,489,850,459,,,0,0,0,,,,,,
489,851,481,490,850,481,,,-1,1,0,,,,,,
490,851,503,490,850,503,,,0,1,0,,,,,,
490,851,526,491,851,526,,,-1,0,0,,,,,,
491,851,549,491,851,549,,,0,0,0,,,,,,
491,852,572,492,852,572,,,-1,0,0,,,,,,
492,852,596,492,852,595,,,0,0,1,,,,,,
492,852,619,493,852,619,,,-1,0,0,,,,,,
493,853,643,493,852,643,,,0,1,0,,,,,,
494,853,667,494,853,667,,,0,0,0,,,,,,
494,853,691,494,853,691,,,0,0,0,,,,,,
495,854,715,495,854,715,,,0,0,0,,,,,,
496,854,739,496,854,739,,,0,0,0,,,,,,
496,855,764,497,854,764,,,-1,1,0,,,,,,
497,855,788,497,855,788,,,0,0,0,,,,,,
502,878,235,502,878,235,,,0,0,0,,,,,,
502,878,236,502,878,235,,,0,0,1,,,,,,
502,878,238,502,878,238,,,0,0,0,,,,,,
502,878,243,502,878,243,,,0,0,0,,,,,,
502,878,249,502,878,249,,,0,0,0,,,,,,
502,878,258,502,878,258,,,0,0,0,,,,,,
502,878,268,502,878,268,,,0,0,0,,,,,,
502,878,280,502,878,281,,,0,0,-1,,,,,,
502,878,294,502,878,294,,,0,0,0,,,,,,
502,879,309,503,878,309,,,-1,1,0,,,,,,
503,879,325,503,878,325,,,0,1,0,,,,,,
503,879,343,503,878,343,,,0,1,0,,,,,,
503,879,361,503,879,361,,,0,0,0,,,,,,
503,879,380,504,879,380,,,-1,0,0,,,,,,
504,879,400,504,879,400,,,0,0,0,,,,,,
504,879,420,504,879,420,,,0,0,0,,,,,,
504,880,441,504,879,441,,,0,1,0,,,,,,
505,880,463,505,879,463,,,0,1,0,,,,,,
505,880,485,505,880,484,,,0,0,1,,,,,,
505,880,507,506,880,506,,,-1,0,1,,,,,,
506,880,529,506,880,529,,,0,0,0,,,,,,
506,881,552,507,880,552,,,-1,1,0,,,,,,
507,881,575,507,881,575,,,0,0,0,,,,,,
507,881,598,508,881,598,,,-1,0,0,,,,,,
508,882,622,508,881,621,,,0,1,1,,,,,,
509,882,645,509,882,645,,,0,0,0,,,,,,
509,882,669,509,882,669,,,0,0,0,,,,,,
510,883,693,510,882,693,,,0,1,0,,,,,,
511,883,717,511,883,717,,,0,0,0,,,,,,
511,883,741,511,883,741,,,0,0,0,,,,,,
512,884,766,512,883,766,,,0,1,0,,,,,,
513,884,790,513,884,790,,,0,0,0,,,,,,
152,42,23,152,42,23,,,0,0,0,,,,,,
152,42,30,152,42,23,,,0,0,7,,,,,,
152,42,48,152,42,48,,,0,0,0,,,,,,
152,43,70,152,43,70,,,0,0,0,,,,,,
152,44,92,152,44,92,,,0,0,0,,,,,,
152,45,115,152,45,115,,,0,0,0,,,,,,
153,47,139,153,47,139,,,0,0,0,,,,,,
153,48,162,153,48,162,,,0,0,0,,,,,,
154,50,186,154,50,186,,,0,0,0,,,,,,
154,53,210,154,52,210,,,0,1,0,,,,,,
155,55,235,155,55,235,,,0,0,0,,,,,,
156,58,259,156,57,259,,,0,1,0,,,,,,
157,60,284,157,60,284,,,0,0,0,,,,,,
158,63,308,158,63,308,,,0,0,0,,,,,,
159,66,333,159,66,333,,,0,0,0,,,,,,
160,69,358,160,69,357,,,0,0,1,,,,,,
161,72,382,161,72,382,,,0,0,0,,,,,,
162,76,407,162,75,407,,,0,1,0,,,,,,
164,79,432,164,79,432,,,0,0,0,,,,,,
165,83,457,165,82,457,,,0,1,0,,,,,,
167,86,482,167,86,482,,,0,0,0,,,,,,
168,90,507,168,89,507,,,0,1,0,,,,,,
170,93,533,170,93,533,,,0,0,0,,,,,,
172,97,558,172,96,558,,,0,1,0,,,,,,
174,100,583,174,100,583,,,0,0,0,,,,,,
176,104,608,176,104,608,,,0,0,0,,,,,,
178,108,634,178,108,634,,,0,0,0,,,,,,
180,111,659,180,111,659,,,0,0,0,,,,,,
182,115,684,182,115,684,,,0,0,0,,,,,,
184,119,710,184,119,709,,,0,0,1,,,,,,
186,123,735,186,123,735,,,0,0,0,,,,,,
189,127,761,188,127,761,,,1,0,0,,,,,,
152,48,24,152,42,23,,,0,6,1,,,,,,
152,48,31,152,42,23,,,0,6,8,,,,,,
152,48,49,152,42,48,,,0,6,1,,,,,,
152,48,70,152,43,70,,,0,5,0,,,,,,
153,49,92,152,44,92,,,1,5,0,,,,,,
153,50,115,152,45,115,,,1,5,0,,,,,,
153,52,139,153,47,139,,,0,5,0,,,,,,
154,53,162,153,48,162,,,1,5,0,,,,,,
154,55,186,154,50,186,,,0,5,0,,,,,,
155,57,211,154,52,210,,,1,5,1,,,,,,
156,59,235,155,55,235,,,1,4,0,,,,,,
156,62,259,156,57,259,,,0,5,0,,,,,,
157,64,284,157,60,284,,,0,4,0,,,,,,
158,67,308,158,63,308,,,0,4,0,,,,,,
159,70,333,159,66,333,,,0,4,0,,,,,,
160,73,358,160,69,357,,,0,4,1,,,,,,
162,76,382,161,72,382,,,1,4,0,,,,,,
163,79,407,162,75,407,,,1,4,0,,,,,,
164,82,432,164,79,432,,,0,3,0,,,,,,
166,85,457,165,82,457,,,1,3,0,,,,,,
167,89,482,167,86,482,,,0,3,0,,,,,,
169,92,507,168,89,507,,,1,3,0,,,,,,
171,96,533,170,93,533,,,1,3,0,,,,,,
172,99,558,172,96,558,,,0,3,0,,,,,,
174,103,583,174,100,583,,,0,3,0,,,,,,
176,106,608,176,104,608,,,0,2,0,,,,,,
178,110,634,178,108,634,,,0,2,0,,,,,,
180,113,659,180,111,659,,,0,2,0,,,,,,
182,117,685,182,115,684,,,0,2,1,,,,,,
184,121,710,184,119,709,,,0,2,1,,,,,,
187,125,735,186,123,735,,,1,2,0,,,,,,
189,128,761,188,127,761,,,1,1,0,,,,,,
154,64,26,154,64,26,,,0,0,0,,,,,,
154,64,33,154,64,26,,,0,0,7,,,,,,
154,64,50,154,64,50,,,0,0,0,,,,,,
154,65,71,154,64,71,,,0,1,0,,,,,,
154,65,93,154,65,93,,,0,0,0,,,,,,
154,66,116,154,66,116,,,0,0,0,,,,,,
155,67,139,155,67,139,,,0,0,0,,,,,,
155,68,163,155,68,163,,,0,0,0,,,,,,
156,70,187,156,70,187,,,0,0,0,,,,,,
156,71,211,156,71,211,,,0,0,0,,,,,,
157,73,235,157,73,235,,,0,0,0,,,,,,
158,75,259,158,75,259,,,0,0,0,,,,,,
159,77,284,159,77,284,,,0,0,0,,,,,,
160,79,308,160,79,308,,,0,0,0,,,,,,
161,81,333,161,81,333,,,0,0,0,,,,,,
162,84,358,162,84,358,,,0,0,0,,,,,,
163,87,383,163,87,383,,,0,0,0,,,,,,
164,89,407,164,89,407,,,0,0,0,,,,,,
166,92,432,166,92,432,,,0,0,0,,,,,,
167,95,457,167,95,457,,,0,0,0,,,,,,
169,98,482,169,98,482,,,0,0,0,,,,,,
170,101,508,170,101,507,,,0,0,1,,,,,,
172,104,533,172,104,533,,,0,0,0,,,,,,
174,107,558,173,107,558,,,1,0,0,,,,,,
175,111,583,175,111,583,,,0,0,0,,,,,,
177,114,608,177,114,608,,,0,0,0,,,,,,
179,117,634,179,117,634,,,0,0,0,,,,,,
181,121,659,181,120,659,,,0,1,0,,,,,,
183,124,685,183,124,685,,,0,0,0,,,,,,
186,128,710,185,127,710,,,1,1,0,,,,,,
188,131,736,188,131,736,,,0,0,0,,,,,,
190,135,761,190,134,761,,,0,1,0,,,,,,
156,86,30,157,87,30,,,-1,-1,0,,,,,,
157,86,36,157,87,30,,,0,-1,6,,,,,,
157,86,52,157,87,52,,,0,-1,0,,,,,,
157,86,72,157,87,73,,,0,-1,-1,,,,,,
157,87,94,157,88,94,,,0,-1,0,,,,,,
157,87,117,158,88,117,,,-1,-1,0,,,,,,
158,88,140,158,89,140,,,0,-1,0,,,,,,
158,89,163,159,90,163,,,-1,-1,0,,,,,,
159,90,187,159,92,187,,,0,-2,0,,,,,,
159,91,211,160,93,211,,,-1,-2,0,,,,,,
160,93,235,160,94,235,,,0,-1,0,,,,,,
161,94,260,161,96,260,,,0,-2,0,,,,,,
161,96,284,162,97,284,,,-1,-1,0,,,,,,
162,97,309,163,99,309,,,-1,-2,0,,,,,,
163,99,333,164,101,333,,,-1,-2,0,,,,,,
164,101,358,165,103,358,,,-1,-2,0,,,,,,
166,103,383,166,105,383,,,0,-2,0,,,,,,
167,106,408,167,107,407,,,0,-1,1,,,,,,
168,108,433,169,110,432,,,-1,-2,1,,,,,,
170,110,458,170,112,457,,,0,-2,1,,,,,,
171,113,483,172,115,482,,,-1,-2,1,,,,,,
173,116,508,173,117,507,,,0,-1,1,,,,,,
174,118,533,175,120,533,,,-1,-2,0,,,,,,
176,121,558,176,123,558,,,0,-2,0,,,,,,
178,124,583,178,126,583,,,0,-2,0,,,,,,
180,127,609,180,129,608,,,0,-2,1,,,,,,
182,130,634,182,132,634,,,0,-2,0,,,,,,
184,133,659,184,135,659,,,0,-2,0,,,,,,
186,136,685,186,138,685,,,0,-2,0,,,,,,
188,139,710,188,141,710,,,0,-2,0,,,,,,
190,142,736,191,144,736,,,-1,-2,0,,,,,,
192,146,761,193,147,761,,,-1,-1,0,,,,,,
161,110,35,161,110,35,,,0,0,0,,,,,,
161,111,40,161,110,35,,,0,1,5,,,,,,
161,111,55,161,111,55,,,0,0,0,,,,,,
161,111,74,161,111,75,,,0,0,-1,,,,,,
161,111,95,161,111,95,,,0,0,0,,,,,,
161,112,118,161,111,118,,,0,1,0,,,,,,
162,112,141,162,112,141,,,0,0,0,,,,,,
162,113,164,162,113,164,,,0,0,0,,,,,,
163,114,188,163,114,188,,,0,0,0,,,,,,
163,115,212,163,115,212,,,0,0,0,,,,,,
164,116,236,164,116,236,,,0,0,0,,,,,,
165,117,260,164,117,260,,,1,0,0,,,,,,
165,118,285,165,118,285,,,0,0,0,,,,,,
166,119,309,166,119,309,,,0,0,0,,,,,,
167,121,334,167,121,334,,,0,0,0,,,,,,
168,123,358,168,122,358,,,0,1,0,,,,,,
170,124,383,170,124,383,,,0,0,0,,,,,,
171,126,408,171,126,408,,,0,0,0,,,,,,
172,128,433,172,128,433,,,0,0,0,,,,,,
173,130,458,173,130,458,,,0,0,0,,,,,,
175,132,483,175,132,483,,,0,0,0,,,,,,
176,134,508,176,134,508,,,0,0,0,,,,,,
178,137,533,178,137,533,,,0,0,0,,,,,,
180,139,558,180,139,558,,,0,0,0,,,,,,
182,141,583,182,141,583,,,0,0,0,,,,,,
183,144,609,183,144,608,,,0,0,1,,,,,,
185,147,634,185,147,634,,,0,0,0,,,,,,
187,149,659,187,149,659,,,0,0,0,,,,,,
189,152,685,189,152,685,,,0,0,0,,,,,,
191,155,710,191,155,710,,,0,0,0,,,,,,
194,158,736,194,158,736,,,0,0,0,,,,,,
196,161,761,196,161,761,,,0,0,0,,,,,,
166,136,41,167,136,41,,,-1,0,0,,,,,,
166,136,45,167,136,41,,,-1,0,4,,,,,,
166,136,59,167,137,59,,,-1,-1,0,,,,,,
166,137,77,167,137,78,,,-1,0,-1,,,,,,
167,137,98,167,137,97,,,0,0,1,,,,,,
167,137,119,167,137,120,,,0,0,-1,,,,,,
167,138,142,168,138,142,,,-1,0,0,,,,,,
168,138,165,168,138,165,,,0,0,0,,,,,,
168,139,189,169,139,189,,,-1,0,0,,,,,,
169,139,213,169,140,213,,,0,-1,0,,,,,,
169,140,237,170,141,237,,,-1,-1,0,,,,,,
170,141,261,170,142,261,,,0,-1,0,,,,,,
171,142,285,171,143,285,,,0,-1,0,,,,,,
172,143,310,172,144,310,,,0,-1,0,,,,,,
173,145,334,173,145,334,,,0,0,0,,,,,,
174,146,359,174,146,359,,,0,0,0,,,,,,
175,147,384,175,148,383,,,0,-1,1,,,,,,
176,149,408,176,149,408,,,0,0,0,,,,,,
177,150,433,177,151,433,,,0,-1,0,,,,,,
179,152,458,179,153,458,,,0,-1,0,,,,,,
180,154,483,180,155,483,,,0,-1,0,,,,,,
181,156,508,182,157,508,,,-1,-1,0,,,,,,
183,158,533,183,159,533,,,0,-1,0,,,,,,
185,160,559,185,160,558,,,0,0,1,,,,,,
186,162,584,187,162,583,,,-1,0,1,,,,,,
188,164,609,188,165,609,,,0,-1,0,,,,,,
190,166,634,190,167,634,,,0,-1,0,,,,,,
192,169,660,192,169,659,,,0,0,1,,,,,,
194,171,685,194,172,685,,,0,-1,0,,,,,,
196,174,711,196,174,710,,,0,0,1,,,,,,
198,176,736,199,177,736,,,-1,-1,0,,,,,,
200,179,762,201,180,761,,,-1,-1,1,,,,,,
173,163,47,173,163,47,,,0,0,0,,,,,,
173,163,51,173,163,47,,,0,0,4,,,,,,
173,163,63,173,163,63,,,0,0,0,,,,,,
173,163,80,173,163,81,,,0,0,-1,,,,,,
173,163,100,173,163,100,,,0,0,0,,,,,,
173,163,122,173,163,122,,,0,0,0,,,,,,
174,164,144,174,164,144,,,0,0,0,,,,,,
174,164,167,174,164,167,,,0,0,0,,,,,,
175,165,190,175,165,190,,,0,0,0,,,,,,
175,165,214,175,165,214,,,0,0,0,,,,,,
176,166,238,176,166,238,,,0,0,0,,,,,,
176,167,262,176,167,262,,,0,0,0,,,,,,
177,168,286,177,168,286,,,0,0,0,,,,,,
178,169,310,178,169,310,,,0,0,0,,,,,,
179,170,335,179,170,335,,,0,0,0,,,,,,
180,171,359,180,171,359,,,0,0,0,,,,,,
181,172,384,181,172,384,,,0,0,0,,,,,,
182,173,409,182,173,409,,,0,0,0,,,,,,
183,175,434,183,175,434,,,0,0,0,,,,,,
185,176,459,184,176,459,,,1,0,0,,,,,,
186,178,484,186,178,484,,,0,0,0,,,,,,
188,179,509,187,179,509,,,1,0,0,,,,,,
189,181,534,189,181,534,,,0,0,0,,,,,,
191,183,559,190,182,559,,,1,1,0,,,,,,
192,184,584,192,184,584,,,0,0,0,,,,,,
194,186,609,194,186,609,,,0,0,0,,,,,,
196,188,635,196,188,635,,,0,0,0,,,,,,
198,190,660,198,190,660,,,0,0,0,,,,,,
200,192,685,200,192,685,,,0,0,0,,,,,,
202,195,711,202,194,710,,,0,1,1,,,,,,
204,197,736,204,197,736,,,0,0,0,,,,,,
206,199,762,206,199,761,,,0,0,1,,,,,,
181,190,54,181,190,54,,,0,0,0,,,,,,
181,190,57,181,190,54,,,0,0,3,,,,,,
181,190,68,181,190,68,,,0,0,0,,,,,,
181,190,84,181,190,85,,,0,0,-1,,,,,,
181,190,103,181,190,103,,,0,0,0,,,,,,
181,190,124,181,190,124,,,0,0,0,,,,,,
182,191,146,182,191,146,,,0,0,0,,,,,,
182,191,169,182,191,168,,,0,0,1,,,,,,
182,191,192,183,191,191,,,-1,0,1,,,,,,
183,192,215,183,192,215,,,0,0,0,,,,,,
183,192,239,184,192,239,,,-1,0,0,,,,,,
184,193,263,184,193,263,,,0,0,0,,,,,,
185,194,287,185,194,287,,,0,0,0,,,,,,
186,195,311,186,195,311,,,0,0,0,,,,,,
186,196,336,187,196,336,,,-1,0,0,,,,,,
187,197,360,188,197,360,,,-1,0,0,,,,,,
188,198,385,189,198,385,,,-1,0,0,,,,,,
190,199,410,190,199,409,,,0,0,1,,,,,,
191,200,434,191,200,434,,,0,0,0,,,,,,
192,201,459,192,201,459,,,0,0,0,,,,,,
193,202,484,193,203,484,,,0,-1,0,,,,,,
195,204,509,195,204,509,,,0,0,0,,,,,,
196,205,534,196,205,534,,,0,0,0,,,,,,
198,207,559,198,207,559,,,0,0,0,,,,,,
199,208,585,199,208,584,,,0,0,1,,,,,,
201,210,610,201,210,610,,,0,0,0,,,,,,
203,212,635,203,212,635,,,0,0,0,,,,,,
204,213,660,205,213,660,,,-1,0,0,,,,,,
206,215,686,207,215,685,,,-1,0,1,,,,,,
208,217,711,209,217,711,,,-1,0,0,,,,,,
210,219,737,211,220,736,,,-1,-1,1,,,,,,
212,221,762,213,222,762,,,-1,-1,0,,,,,,
189,217,61,189,217,61,,,0,0,0,,,,,,
189,217,64,189,217,61,,,0,0,3,,,,,,
189,217,73,189,217,73,,,0,0,0,,,,,,
190,217,88,189,217,90,,,1,0,-2,,,,,,
190,217,107,190,217,107,,,0,0,0,,,,,,
190,218,127,190,217,127,,,0,1,0,,,,,,
190,218,148,190,218,148,,,0,0,0,,,,,,
191,218,171,190,218,170,,,1,0,1,,,,,,
191,218,193,191,218,193,,,0,0,0,,,,,,
192,219,217,191,218,216,,,1,1,1,,,,,,
192,219,240,192,219,240,,,0,0,0,,,,,,
193,220,264,192,220,264,,,1,0,0,,,,,,
193,221,288,193,221,288,,,0,0,0,,,,,,
194,221,312,194,221,312,,,0,0,0,,,,,,
195,222,337,195,222,337,,,0,0,0,,,,,,
196,223,361,196,223,361,,,0,0,0,,,,,,
197,224,386,197,224,386,,,0,0,0,,,,,,
198,225,410,198,225,410,,,0,0,0,,,,,,
199,226,435,199,226,435,,,0,0,0,,,,,,
200,227,460,200,227,460,,,0,0,0,,,,,,
201,228,485,201,228,485,,,0,0,0,,,,,,
203,229,510,202,229,510,,,1,0,0,,,,,,
204,230,535,204,230,535,,,0,0,0,,,,,,
206,232,560,205,231,560,,,1,1,0,,,,,,
207,233,585,207,233,585,,,0,0,0,,,,,,
209,235,610,208,234,610,,,1,1,0,,,,,,
210,236,636,210,236,636,,,0,0,0,,,,,,
212,238,661,212,237,661,,,0,1,0,,,,,,
214,239,686,214,239,686,,,0,0,0,,,,,,
216,241,712,216,241,711,,,0,0,1,,,,,,
218,243,737,218,243,737,,,0,0,0,,,,,,
220,245,762,220,245,762,,,0,0,0,,,,,,
199,245,68,199,244,68,,,0,1,0,,,,,,
199,245,70,199,244,68,,,0,1,2,,,,,,
199,245,79,199,244,79,,,0,1,0,,,,,,
199,245,93,199,244,95,,,0,1,-2,,,,,,
199,245,111,200,245,111,,,-1,0,0,,,,,,
200,245,130,200,245,131,,,0,0,-1,,,,,,
200,245,151,200,245,151,,,0,0,0,,,,,,
200,246,173,200,245,173,,,0,1,0,,,,,,
201,246,195,201,245,195,,,0,1,0,,,,,,
201,246,218,201,246,218,,,0,0,0,,,,,,
202,247,242,202,246,242,,,0,1,0,,,,,,
202,247,266,202,247,265,,,0,0,1,,,,,,
203,248,289,203,248,289,,,0,0,0,,,,,,
204,248,313,204,248,313,,,0,0,0,,,,,,
204,249,338,205,249,338,,,-1,0,0,,,,,,
205,250,362,205,250,362,,,0,0,0,,,,,,
206,251,387,206,251,387,,,0,0,0,,,,,,
207,251,411,207,251,411,,,0,0,0,,,,,,
208,252,436,208,252,436,,,0,0,0,,,,,,
209,253,461,209,253,460,,,0,0,1,,,,,,
211,254,486,210,254,485,,,1,0,1,,,,,,
212,255,510,212,255,510,,,0,0,0,,,,,,
213,256,535,213,256,535,,,0,0,0,,,,,,
215,258,561,215,257,560,,,0,1,1,,,,,,
216,259,586,216,259,585,,,0,0,1,,,,,,
217,260,611,218,260,611,,,-1,0,0,,,,,,
219,262,636,219,262,636,,,0,0,0,,,,,,
221,263,661,221,263,661,,,0,0,0,,,,,,
222,264,687,223,264,686,,,-1,0,1,,,,,,
224,266,712,224,266,712,,,0,0,0,,,,,,
226,268,737,226,268,737,,,0,0,0,,,,,,
228,269,763,228,269,763,,,0,0,0,,,,,,
210,272,75,210,272,75,,,0,0,0,,,,,,
210,272,77,210,272,75,,,0,0,2,,,,,,
210,272,85,210,272,85,,,0,0,0,,,,,,
210,272,98,210,272,100,,,0,0,-2,,,,,,
210,273,115,210,273,115,,,0,0,0,,,,,,
210,273,134,210,273,134,,,0,0,0,,,,,,
210,273,154,210,273,154,,,0,0,0,,,,,,
211,273,176,210,273,176,,,1,0,0,,,,,,
211,273,198,211,273,198,,,0,0,0,,,,,,
211,274,221,211,273,221,,,0,1,0,,,,,,
212,274,244,212,274,244,,,0,0,0,,,,,,
213,275,267,212,274,267,,,1,1,0,,,,,,
213,275,291,213,275,291,,,0,0,0,,,,,,
214,276,315,214,275,315,,,0,1,0,,,,,,
215,276,339,215,276,339,,,0,0,0,,,,,,
215,277,363,215,277,363,,,0,0,0,,,,,,
216,278,388,216,278,388,,,0,0,0,,,,,,
217,278,412,217,278,412,,,0,0,0,,,,,,
218,279,437,218,279,437,,,0,0,0,,,,,,
219,280,462,219,280,461,,,0,0,1,,,,,,
220,281,486,220,281,486,,,0,0,0,,,,,,
222,282,511,221,282,511,,,1,0,0,,,,,,
223,283,536,223,283,536,,,0,0,0,,,,,,
224,284,561,224,284,561,,,0,0,0,,,,,,
226,285,586,226,285,586,,,0,0,0,,,,,,
227,286,611,227,286,611,,,0,0,0,,,,,,
229,288,637,229,288,637,,,0,0,0,,,,,,
230,289,662,230,289,662,,,0,0,0,,,,,,
232,290,687,232,290,687,,,0,0,0,,,,,,
233,292,713,233,291,712,,,0,1,1,,,,,,
235,293,738,235,293,738,,,0,0,0,,,,,,
237,294,763,237,294,763,,,0,0,0,,,,,,
221,300,82,221,300,82,,,0,0,0,,,,,,
221,300,84,221,300,82,,,0,0,2,,,,,,
221,300,92,221,300,91,,,0,0,1,,,,,,
221,300,104,221,300,105,,,0,0,-1,,,,,,
221,301,120,221,301,119,,,0,0,1,,,,,,
221,301,138,221,301,138,,,0,0,0,,,,,,
221,301,158,221,301,157,,,0,0,1,,,,,,
222,301,179,222,301,179,,,0,0,0,,,,,,
222,301,200,222,301,200,,,0,0,0,,,,,,
223,302,223,223,301,223,,,0,1,0,,,,,,
223,302,246,223,302,246,,,0,0,0,,,,,,
224,302,269,224,302,269,,,0,0,0,,,,,,
224,303,293,224,303,292,,,0,0,1,,,,,,
225,303,316,225,303,316,,,0,0,0,,,,,,
225,304,340,226,304,340,,,-1,0,0,,,,,,
226,304,365,226,304,364,,,0,0,1,,,,,,
227,305,389,227,305,389,,,0,0,0,,,,,,
228,306,413,228,306,413,,,0,0,0,,,,,,
229,306,438,229,306,438,,,0,0,0,,,,,,
230,307,463,230,307,462,,,0,0,1,,,,,,
231,308,487,231,308,487,,,0,0,0,,,,,,
232,309,512,232,309,512,,,0,0,0,,,,,,
233,310,537,233,310,537,,,0,0,0,,,,,,
235,311,562,235,311,562,,,0,0,0,,,,,,
236,312,587,236,312,587,,,0,0,0,,,,,,
237,313,612,238,313,612,,,-1,0,0,,,,,,
239,314,637,239,314,637,,,0,0,0,,,,,,
240,315,663,240,315,662,,,0,0,1,,,,,,
242,316,688,242,316,688,,,0,0,0,,,,,,
243,318,713,243,317,713,,,0,1,0,,,,,,
245,319,739,245,319,738,,,0,0,1,,,,,,
247,320,764,247,320,764,,,0,0,0,,,,,,
232,328,90,232,328,90,,,0,0,0,,,,,,
233,328,92,232,328,90,,,1,0,2,,,,,,
233,328,98,233,328,98,,,0,0,0,,,,,,
233,329,110,233,328,111,,,0,1,-1,,,,,,
233,329,124,233,329,124,,,0,0,0,,,,,,
233,329,142,233,329,142,,,0,0,0,,,,,,
233,329,161,233,329,161,,,0,0,0,,,,,,
233,329,182,233,329,182,,,0,0,0,,,,,,
234,329,203,234,329,203,,,0,0,0,,,,,,
234,330,225,234,329,225,,,0,1,0,,,,,,
235,330,248,235,330,248,,,0,0,0,,,,,,
235,330,271,235,330,271,,,0,0,0,,,,,,
236,331,294,236,331,294,,,0,0,0,,,,,,
236,331,318,236,331,318,,,0,0,0,,,,,,
237,332,342,237,332,342,,,0,0,0,,,,,,
238,332,366,237,332,366,,,1,0,0,,,,,,
238,333,390,238,333,390,,,0,0,0,,,,,,
239,333,415,239,333,414,,,0,0,1,,,,,,
240,334,439,240,334,439,,,0,0,0,,,,,,
241,335,464,241,334,463,,,0,1,1,,,,,,
242,335,488,242,335,488,,,0,0,0,,,,,,
243,336,513,243,336,513,,,0,0,0,,,,,,
244,337,538,244,337,538,,,0,0,0,,,,,,
246,338,563,245,338,563,,,1,0,0,,,,,,
247,339,588,247,339,588,,,0,0,0,,,,,,
248,340,613,248,340,613,,,0,0,0,,,,,,
250,341,638,250,341,638,,,0,0,0,,,,,,
251,342,663,251,342,663,,,0,0,0,,,,,,
252,343,689,252,343,689,,,0,0,0,,,,,,
254,344,714,254,344,714,,,0,0,0,,,,,,
256,345,739,256,345,739,,,0,0,0,,,,,,
257,347,765,257,346,764,,,0,1,1,,,,,,
245,357,97,244,356,97,,,1,1,0,,,,,,
245,357,99,244,356,97,,,1,1,2,,,,,,
245,357,105,245,356,105,,,0,1,0,,,,,,
245,357,116,245,356,117,,,0,1,-1,,,,,,
245,357,130,245,357,129,,,0,0,1,,,,,,
245,357,146,245,357,147,,,0,0,-1,,,,,,
245,357,165,245,357,165,,,0,0,0,,,,,,
246,357,185,246,357,185,,,0,0,0,,,,,,
246,358,206,246,357,206,,,0,1,0,,,,,,
246,358,228,246,357,228,,,0,1,0,,,,,,
247,358,250,247,358,250,,,0,0,0,,,,,,
247,358,273,247,358,273,,,0,0,0,,,,,,
248,359,296,248,359,296,,,0,0,0,,,,,,
248,359,320,248,359,320,,,0,0,0,,,,,,
249,360,344,249,360,344,,,0,0,0,,,,,,
250,360,368,249,360,367,,,1,0,1,,,,,,
250,361,392,250,361,391,,,0,0,1,,,,,,
251,361,416,251,361,416,,,0,0,0,,,,,,
252,362,440,252,362,440,,,0,0,0,,,,,,
253,362,465,253,362,465,,,0,0,0,,,,,,
254,363,490,254,363,489,,,0,0,1,,,,,,
255,364,514,255,363,514,,,0,1,0,,,,,,
256,365,539,256,364,539,,,0,1,0,,,,,,
257,365,564,257,365,564,,,0,0,0,,,,,,
258,366,589,258,366,589,,,0,0,0,,,,,,
260,367,614,260,367,614,,,0,0,0,,,,,,
261,368,639,261,368,639,,,0,0,0,,,,,,
262,369,664,262,369,664,,,0,0,0,,,,,,
264,370,689,263,370,689,,,1,0,0,,,,,,
265,371,715,265,371,714,,,0,0,1,,,,,,
267,372,740,267,372,740,,,0,0,0,,,,,,
268,373,765,268,373,765,,,0,0,0,,,,,,
257,385,104,257,385,104,,,0,0,0,,,,,,
257,385,106,257,385,104,,,0,0,2,,,,,,
258,385,112,258,385,112,,,0,0,0,,,,,,
258,385,122,258,385,123,,,0,0,-1,,,,,,
258,385,135,258,385,135,,,0,0,0,,,,,,
258,385,151,258,385,152,,,0,0,-1,,,,,,
258,385,169,258,385,169,,,0,0,0,,,,,,
258,386,189,258,385,189,,,0,1,0,,,,,,
259,386,210,259,386,210,,,0,0,0,,,,,,
259,386,231,259,386,231,,,0,0,0,,,,,,
259,386,253,259,386,253,,,0,0,0,,,,,,
260,387,276,259,386,276,,,1,1,0,,,,,,
260,387,299,260,387,299,,,0,0,0,,,,,,
261,387,322,260,387,322,,,1,0,0,,,,,,
261,388,346,261,388,346,,,0,0,0,,,,,,
262,388,369,262,388,369,,,0,0,0,,,,,,
263,389,393,263,389,393,,,0,0,0,,,,,,
264,389,418,263,389,417,,,1,0,1,,,,,,
264,390,442,264,390,442,,,0,0,0,,,,,,
265,390,466,265,390,466,,,0,0,0,,,,,,
266,391,491,266,391,491,,,0,0,0,,,,,,
267,392,515,267,391,515,,,0,1,0,,,,,,
268,392,540,268,392,540,,,0,0,0,,,,,,
269,393,565,269,393,565,,,0,0,0,,,,,,
270,394,590,270,394,590,,,0,0,0,,,,,,
272,395,615,271,395,615,,,1,0,0,,,,,,
273,396,640,273,396,640,,,0,0,0,,,,,,
274,396,665,274,396,665,,,0,0,0,,,,,,
275,397,690,275,397,690,,,0,0,0,,,,,,
277,398,716,276,398,715,,,1,0,1,,,,,,
278,399,741,278,399,741,,,0,0,0,,,,,,
280,400,766,279,400,766,,,1,0,0,,,,,,
271,413,112,270,413,111,,,1,0,1,,,,,,
271,413,113,270,413,111,,,1,0,2,,,,,,
271,414,119,271,413,119,,,0,1,0,,,,,,
271,414,128,271,413,130,,,0,1,-2,,,,,,
271,414,141,271,413,141,,,0,1,0,,,,,,
271,414,156,271,413,157,,,0,1,-1,,,,,,
271,414,174,271,413,174,,,0,1,0,,,,,,
271,414,193,271,414,193,,,0,0,0,,,,,,
272,414,213,272,414,213,,,0,0,0,,,,,,
272,414,234,272,414,234,,,0,0,0,,,,,,
272,415,256,272,414,256,,,0,1,0,,,,,,
273,415,278,273,415,278,,,0,0,0,,,,,,
273,415,301,273,415,301,,,0,0,0,,,,,,
274,416,324,274,415,324,,,0,1,0,,,,,,
274,416,348,274,416,348,,,0,0,0,,,,,,
275,416,371,275,416,371,,,0,0,0,,,,,,
276,417,395,276,417,395,,,0,0,0,,,,,,
276,417,419,276,417,419,,,0,0,0,,,,,,
277,418,443,277,418,443,,,0,0,0,,,,,,
278,418,468,278,418,468,,,0,0,0,,,,,,
279,419,492,279,419,492,,,0,0,0,,,,,,
280,420,517,280,419,517,,,0,1,0,,,,,,
281,420,541,281,420,541,,,0,0,0,,,,,,
282,421,566,282,421,566,,,0,0,0,,,,,,
283,422,591,283,422,591,,,0,0,0,,,,,,
284,422,616,284,422,616,,,0,0,0,,,,,,
285,423,641,285,423,641,,,0,0,0,,,,,,
286,424,666,286,424,666,,,0,0,0,,,,,,
288,425,691,287,425,691,,,1,0,0,,,,,,
289,426,716,289,425,716,,,0,1,0,,,,,,
290,427,742,290,426,742,,,0,1,0,,,,,,
292,428,767,291,427,767,,,1,1,0,,,,,,
284,442,119,284,442,119,,,0,0,0,,,,,,
284,442,121,284,442,119,,,0,0,2,,,,,,
284,442,126,284,442,126,,,0,0,0,,,,,,
284,442,135,284,442,136,,,0,0,-1,,,,,,
284,442,147,284,442,147,,,0,0,0,,,,,,
284,442,162,284,442,163,,,0,0,-1,,,,,,
285,442,179,285,442,179,,,0,0,0,,,,,,
285,443,197,285,442,198,,,0,1,-1,,,,,,
285,443,217,285,443,217,,,0,0,0,,,,,,
285,443,238,285,443,238,,,0,0,0,,,,,,
286,443,259,286,443,259,,,0,0,0,,,,,,
286,443,281,286,443,281,,,0,0,0,,,,,,
287,444,304,287,444,304,,,0,0,0,,,,,,
287,444,327,287,444,327,,,0,0,0,,,,,,
288,444,350,288,444,350,,,0,0,0,,,,,,
288,445,373,288,444,373,,,0,1,0,,,,,,
289,445,397,289,445,397,,,0,0,0,,,,,,
289,446,421,289,445,421,,,0,1,0,,,,,,
290,446,445,290,446,445,,,0,0,0,,,,,,
291,447,469,291,446,469,,,0,1,0,,,,,,
292,447,494,292,447,494,,,0,0,0,,,,,,
293,448,518,293,447,518,,,0,1,0,,,,,,
294,448,543,294,448,543,,,0,0,0,,,,,,
295,449,568,295,449,567,,,0,0,1,,,,,,
296,450,592,296,450,592,,,0,0,0,,,,,,
297,450,617,297,450,617,,,0,0,0,,,,,,
298,451,642,298,451,642,,,0,0,0,,,,,,
299,452,667,299,452,667,,,0,0,0,,,,,,
300,453,692,300,453,692,,,0,0,0,,,,,,
301,453,717,301,453,717,,,0,0,0,,,,,,
303,454,743,303,454,743,,,0,0,0,,,,,,
304,455,768,304,455,768,,,0,0,0,,,,,,
298,471,127,298,470,127,,,0,1,0,,,,,,
298,471,128,298,470,127,,,0,1,1,,,,,,
298,471,133,298,470,133,,,0,1,0,,,,,,
298,471,141,298,470,143,,,0,1,-2,,,,,,
298,471,153,298,471,153,,,0,0,0,,,,,,
298,471,167,298,471,168,,,0,0,-1,,,,,,
298,471,183,298,471,184,,,0,0,-1,,,,,,
298,471,202,298,471,202,,,0,0,0,,,,,,
299,471,221,299,471,221,,,0,0,0,,,,,,
299,471,241,299,471,241,,,0,0,0,,,,,,
299,472,262,299,471,262,,,0,1,0,,,,,,
300,472,284,300,472,284,,,0,0,0,,,,,,
300,472,306,300,472,306,,,0,0,0,,,,,,
301,473,329,301,472,329,,,0,1,0,,,,,,
301,473,352,301,472,352,,,0,1,0,,,,,,
302,473,376,302,473,375,,,0,0,1,,,,,,
302,474,399,302,473,399,,,0,1,0,,,,,,
303,474,423,303,474,423,,,0,0,0,,,,,,
304,474,447,303,474,447,,,1,0,0,,,,,,
304,475,471,304,475,471,,,0,0,0,,,,,,
305,475,495,305,475,495,,,0,0,0,,,,,,
306,476,520,306,476,520,,,0,0,0,,,,,,
307,477,544,307,476,544,,,0,1,0,,,,,,
308,477,569,308,477,569,,,0,0,0,,,,,,
309,478,594,309,478,593,,,0,0,1,,,,,,
310,478,618,310,478,618,,,0,0,0,,,,,,
311,479,643,311,479,643,,,0,0,0,,,,,,
312,480,668,312,480,668,,,0,0,0,,,,,,
313,481,693,313,481,693,,,0,0,0,,,,,,
314,481,718,314,481,718,,,0,0,0,,,,,,
316,482,744,316,482,744,,,0,0,0,,,,,,
317,483,769,317,483,769,,,0,0,0,,,,,,
312,499,135,312,499,135,,,0,0,0,,,,,,
312,499,136,312,499,135,,,0,0,1,,,,,,
312,499,140,312,499,140,,,0,0,0,,,,,,
312,499,148,312,499,149,,,0,0,-1,,,,,,
312,500,159,312,500,159,,,0,0,0,,,,,,
312,500,173,312,500,174,,,0,0,-1,,,,,,
312,500,189,312,500,189,,,0,0,0,,,,,,
312,500,206,312,500,207,,,0,0,-1,,,,,,
313,500,225,313,500,225,,,0,0,0,,,,,,
313,500,245,313,500,245,,,0,0,0,,,,,,
313,500,266,313,500,266,,,0,0,0,,,,,,
314,501,287,313,500,287,,,1,1,0,,,,,,
314,501,309,314,501,309,,,0,0,0,,,,,,
314,501,332,314,501,332,,,0,0,0,,,,,,
315,501,355,315,501,355,,,0,0,0,,,,,,
316,502,378,315,501,378,,,1,1,0,,,,,,
316,502,401,316,502,401,,,0,0,0,,,,,,
317,503,425,316,502,425,,,1,1,0,,,,,,
317,503,449,317,503,449,,,0,0,0,,,,,,
318,503,473,318,503,473,,,0,0,0,,,,,,
319,504,497,319,504,497,,,0,0,0,,,,,,
320,504,521,319,504,521,,,1,0,0,,,,,,
320,505,546,320,505,546,,,0,0,0,,,,,,
321,505,570,321,505,570,,,0,0,0,,,,,,
322,506,595,322,506,595,,,0,0,0,,,,,,
323,507,620,323,506,620,,,0,1,0,,,,,,
324,507,645,324,507,645,,,0,0,0,,,,,,
325,508,670,325,508,670,,,0,0,0,,,,,,
326,509,695,326,509,695,,,0,0,0,,,,,,
328,509,720,327,509,720,,,1,0,0,,,,,,
329,510,745,329,510,745,,,0,0,0,,,,,,
330,511,770,330,511,770,,,0,0,0,,,,,,
326,528,142,326,528,142,,,0,0,0,,,,,,
326,528,143,326,528,142,,,0,0,1,,,,,,
326,528,148,326,528,147,,,0,0,1,,,,,,
326,528,155,326,528,156,,,0,0,-1,,,,,,
326,528,165,326,528,165,,,0,0,0,,,,,,
326,528,179,326,528,179,,,0,0,0,,,,,,
326,528,194,326,528,194,,,0,0,0,,,,,,
327,529,211,326,528,211,,,1,1,0,,,,,,
327,529,229,327,529,229,,,0,0,0,,,,,,
327,529,249,327,529,249,,,0,0,0,,,,,,
327,529,270,327,529,269,,,0,0,1,,,,,,
328,529,291,327,529,291,,,1,0,0,,,,,,
328,530,312,328,529,312,,,0,1,0,,,,,,
329,530,335,328,529,335,,,1,1,0,,,,,,
329,530,357,329,530,357,,,0,0,0,,,,,,
330,530,380,329,530,380,,,1,0,0,,,,,,
330,531,404,330,530,403,,,0,1,1,,,,,,
331,531,427,330,531,427,,,1,0,0,,,,,,
331,532,451,331,531,451,,,0,1,0,,,,,,
332,532,475,332,532,475,,,0,0,0,,,,,,
333,532,499,333,532,499,,,0,0,0,,,,,,
333,533,523,333,533,523,,,0,0,0,,,,,,
334,533,547,334,533,547,,,0,0,0,,,,,,
335,534,572,335,534,572,,,0,0,0,,,,,,
336,534,597,336,534,596,,,0,0,1,,,,,,
337,535,621,337,535,621,,,0,0,0,,,,,,
338,536,646,338,535,646,,,0,1,0,,,,,,
339,536,671,339,536,671,,,0,0,0,,,,,,
340,537,696,340,537,696,,,0,0,0,,,,,,
341,538,721,341,537,721,,,0,1,0,,,,,,
342,538,746,342,538,746,,,0,0,0,,,,,,
343,539,771,343,539,771,,,0,0,0,,,,,,
340,557,150,340,557,150,,,0,0,0,,,,,,
340,557,151,340,557,150,,,0,0,1,,,,,,
340,557,155,340,557,155,,,0,0,0,,,,,,
340,557,162,340,557,163,,,0,0,-1,,,,,,
341,557,172,341,557,172,,,0,0,0,,,,,,
341,557,185,341,557,185,,,0,0,0,,,,,,
341,557,199,341,557,199,,,0,0,0,,,,,,
341,557,216,341,557,216,,,0,0,0,,,,,,
341,558,234,341,558,234,,,0,0,0,,,,,,
341,558,253,341,558,253,,,0,0,0,,,,,,
342,558,273,342,558,273,,,0,0,0,,,,,,
342,558,294,342,558,294,,,0,0,0,,,,,,
342,558,316,342,558,316,,,0,0,0,,,,,,
343,559,338,342,558,338,,,1,1,0,,,,,,
343,559,360,343,559,360,,,0,0,0,,,,,,
344,559,383,343,559,383,,,1,0,0,,,,,,
344,559,406,344,559,406,,,0,0,0,,,,,,
345,560,429,344,559,429,,,1,1,0,,,,,,
345,560,453,345,560,453,,,0,0,0,,,,,,
346,561,477,346,560,477,,,0,1,0,,,,,,
347,561,501,347,561,501,,,0,0,0,,,,,,
348,561,525,347,561,525,,,1,0,0,,,,,,
348,562,549,348,562,549,,,0,0,0,,,,,,
349,562,574,349,562,573,,,0,0,1,,,,,,
350,563,598,350,563,598,,,0,0,0,,,,,,
351,564,623,351,563,622,,,0,1,1,,,,,,
352,564,647,352,564,647,,,0,0,0,,,,,,
353,565,672,353,564,672,,,0,1,0,,,,,,
354,565,697,354,565,697,,,0,0,0,,,,,,
355,566,722,355,566,722,,,0,0,0,,,,,,
356,567,747,356,567,747,,,0,0,0,,,,,,
357,567,772,357,567,772,,,0,0,0,,,,,,
355,586,158,355,586,157,,,0,0,1,,,,,,
355,586,159,355,586,157,,,0,0,2,,,,,,
355,586,162,355,586,162,,,0,0,0,,,,,,
355,586,169,355,586,170,,,0,0,-1,,,,,,
355,586,179,355,586,178,,,0,0,1,,,,,,
355,586,191,355,586,191,,,0,0,0,,,,,,
355,586,205,355,586,205,,,0,0,0,,,,,,
356,586,221,355,586,222,,,1,0,-1,,,,,,
356,587,239,356,586,239,,,0,1,0,,,,,,
356,587,258,356,586,258,,,0,1,0,,,,,,
356,587,277,356,587,277,,,0,0,0,,,,,,
357,587,298,356,587,298,,,1,0,0,,,,,,
357,587,319,357,587,319,,,0,0,0,,,,,,
357,587,341,357,587,341,,,0,0,0,,,,,,
358,588,363,357,588,363,,,1,0,0,,,,,,
358,588,386,358,588,385,,,0,0,1,,,,,,
359,588,409,358,588,408,,,1,0,1,,,,,,
359,589,432,359,588,432,,,0,1,0,,,,,,
360,589,455,359,589,455,,,1,0,0,,,,,,
360,589,479,360,589,479,,,0,0,0,,,,,,
361,590,503,361,590,503,,,0,0,0,,,,,,
362,590,527,362,590,527,,,0,0,0,,,,,,
363,591,551,362,590,551,,,1,1,0,,,,,,
363,591,575,363,591,575,,,0,0,0,,,,,,
364,592,600,364,591,600,,,0,1,0,,,,,,
365,592,624,365,592,624,,,0,0,0,,,,,,
366,593,649,366,592,649,,,0,1,0,,,,,,
367,593,674,367,593,673,,,0,0,1,,,,,,
368,594,699,368,593,698,,,0,1,1,,,,,,
369,594,723,369,594,723,,,0,0,0,,,,,,
370,595,748,370,595,748,,,0,0,0,,,,,,
371,596,774,371,596,773,,,0,0,1,,,,,,
370,615,165,370,615,165,,,0,0,0,,,,,,
370,615,166,370,615,165,,,0,0,1,,,,,,
370,615,170,370,615,170,,,0,0,0,,,,,,
370,615,176,370,615,177,,,0,0,-1,,,,,,
370,615,185,370,615,185,,,0,0,0,,,,,,
370,615,197,370,615,198,,,0,0,-1,,,,,,
370,615,211,370,615,211,,,0,0,0,,,,,,
370,615,227,370,615,227,,,0,0,0,,,,,,
371,615,244,371,615,244,,,0,0,0,,,,,,
371,616,262,371,615,263,,,0,1,-1,,,,,,
371,616,282,371,616,282,,,0,0,0,,,,,,
371,616,302,371,616,302,,,0,0,0,,,,,,
372,616,323,372,616,323,,,0,0,0,,,,,,
372,616,344,372,616,344,,,0,0,0,,,,,,
372,617,366,372,617,366,,,0,0,0,,,,,,
373,617,389,372,617,388,,,1,0,1,,,,,,
373,617,411,373,617,411,,,0,0,0,,,,,,
374,617,434,373,617,434,,,1,0,0,,,,,,
374,618,458,374,618,458,,,0,0,0,,,,,,
375,618,481,375,618,481,,,0,0,0,,,,,,
376,619,505,376,619,505,,,0,0,0,,,,,,
376,619,529,376,619,529,,,0,0,0,,,,,,
377,619,553,377,619,553,,,0,0,0,,,,,,
378,620,577,378,619,577,,,0,1,0,,,,,,
379,620,602,379,620,602,,,0,0,0,,,,,,
379,621,626,379,620,626,,,0,1,0,,,,,,
380,621,651,380,621,651,,,0,0,0,,,,,,
381,622,675,381,621,675,,,0,1,0,,,,,,
382,622,700,382,622,700,,,0,0,0,,,,,,
383,623,725,383,623,725,,,0,0,0,,,,,,
384,624,750,384,624,750,,,0,0,0,,,,,,
385,624,775,385,624,775,,,0,0,0,,,,,,
385,644,173,385,644,173,,,0,0,0,,,,,,
385,644,174,385,644,173,,,0,0,1,,,,,,
385,644,177,385,644,177,,,0,0,0,,,,,,
385,644,183,385,644,184,,,0,0,-1,,,,,,
385,644,192,385,644,192,,,0,0,0,,,,,,
385,644,203,385,644,204,,,0,0,-1,,,,,,
385,644,217,385,644,217,,,0,0,0,,,,,,
385,644,232,385,644,233,,,0,0,-1,,,,,,
385,645,249,385,644,249,,,0,1,0,,,,,,
386,645,267,385,644,267,,,1,1,0,,,,,,
386,645,286,386,645,286,,,0,0,0,,,,,,
386,645,306,386,645,306,,,0,0,0,,,,,,
387,645,326,387,645,326,,,0,0,0,,,,,,
387,645,348,387,645,348,,,0,0,0,,,,,,
387,646,369,387,646,369,,,0,0,0,,,,,,
388,646,392,387,646,391,,,1,0,1,,,,,,
388,646,414,388,646,414,,,0,0,0,,,,,,
389,646,437,388,646,437,,,1,0,0,,,,,,
389,647,460,389,647,460,,,0,0,0,,,,,,
390,647,484,389,647,484,,,1,0,0,,,,,,
390,647,507,390,647,507,,,0,0,0,,,,,,
391,648,531,391,647,531,,,0,1,0,,,,,,
392,648,555,391,648,555,,,1,0,0,,,,,,
392,649,579,392,648,579,,,0,1,0,,,,,,
393,649,603,393,649,603,,,0,0,0,,,,,,
394,650,628,394,649,628,,,0,1,0,,,,,,
395,650,652,394,650,652,,,1,0,0,,,,,,
396,651,677,395,650,677,,,1,1,0,,,,,,
396,651,702,396,651,701,,,0,0,1,,,,,,
397,652,726,397,651,726,,,0,1,0,,,,,,
398,652,751,398,652,751,,,0,0,0,,,,,,
399,653,776,399,653,776,,,0,0,0,,,,,,
400,673,181,400,673,181,,,0,0,0,,,,,,
400,673,182,400,673,181,,,0,0,1,,,,,,
400,673,185,400,673,185,,,0,0,0,,,,,,
400,673,191,400,673,192,,,0,0,-1,,,,,,
400,673,199,400,673,199,,,0,0,0,,,,,,
400,673,210,400,673,211,,,0,0,-1,,,,,,
400,673,223,400,673,223,,,0,0,0,,,,,,
400,673,238,400,673,238,,,0,0,0,,,,,,
400,674,254,400,674,254,,,0,0,0,,,,,,
401,674,272,400,674,272,,,1,0,0,,,,,,
401,674,290,401,674,290,,,0,0,0,,,,,,
401,674,310,401,674,310,,,0,0,0,,,,,,
402,674,330,402,674,330,,,0,0,0,,,,,,
402,674,351,402,674,351,,,0,0,0,,,,,,
402,675,373,402,675,373,,,0,0,0,,,,,,
403,675,395,402,675,395,,,1,0,0,,,,,,
403,675,417,403,675,417,,,0,0,0,,,,,,
404,675,440,403,675,440,,,1,0,0,,,,,,
404,676,463,404,676,463,,,0,0,0,,,,,,
405,676,486,404,676,486,,,1,0,0,,,,,,
405,676,510,405,676,510,,,0,0,0,,,,,,
406,677,533,405,676,533,,,1,1,0,,,,,,
406,677,557,406,677,557,,,0,0,0,,,,,,
407,678,581,407,677,581,,,0,1,0,,,,,,
408,678,605,408,678,605,,,0,0,0,,,,,,
409,678,630,408,678,629,,,1,0,1,,,,,,
409,679,654,409,679,654,,,0,0,0,,,,,,
410,679,679,410,679,678,,,0,0,1,,,,,,
411,680,703,411,680,703,,,0,0,0,,,,,,
412,680,728,412,680,728,,,0,0,0,,,,,,
413,681,753,413,681,753,,,0,0,0,,,,,,
414,682,778,414,681,778,,,0,1,0,,,,,,
415,702,188,415,702,188,,,0,0,0,,,,,,
415,702,189,415,702,188,,,0,0,1,,,,,,
415,702,192,415,702,192,,,0,0,0,,,,,,
415,702,198,415,702,199,,,0,0,-1,,,,,,
415,702,206,415,702,206,,,0,0,0,,,,,,
415,702,217,415,702,217,,,0,0,0,,,,,,
415,703,229,415,702,229,,,0,1,0,,,,,,
415,703,243,415,702,244,,,0,1,-1,,,,,,
416,703,259,415,703,259,,,1,0,0,,,,,,
416,703,277,415,703,277,,,1,0,0,,,,,,
416,703,295,416,703,295,,,0,0,0,,,,,,
416,703,314,416,703,314,,,0,0,0,,,,,,
417,703,334,417,703,334,,,0,0,0,,,,,,
417,704,355,417,703,355,,,0,1,0,,,,,,
417,704,376,417,704,376,,,0,0,0,,,,,,
418,704,398,417,704,398,,,1,0,0,,,,,,
418,704,420,418,704,420,,,0,0,0,,,,,,
419,704,443,418,704,443,,,1,0,0,,,,,,
419,705,466,419,705,466,,,0,0,0,,,,,,
420,705,489,419,705,489,,,1,0,0,,,,,,
420,705,512,420,705,512,,,0,0,0,,,,,,
421,706,536,420,705,536,,,1,1,0,,,,,,
421,706,559,421,706,559,,,0,0,0,,,,,,
422,706,583,422,706,583,,,0,0,0,,,,,,
423,707,607,423,707,607,,,0,0,0,,,,,,
423,707,632,423,707,631,,,0,0,1,,,,,,
424,708,656,424,708,656,,,0,0,0,,,,,,
425,708,680,425,708,680,,,0,0,0,,,,,,
426,709,705,426,709,705,,,0,0,0,,,,,,
427,709,730,426,709,729,,,1,0,1,,,,,,
427,710,754,427,710,754,,,0,0,0,,,,,,
428,710,779,428,710,779,,,0,0,0,,,,,,
430,732,196,430,732,196,,,0,0,0,,,,,,
430,732,197,430,732,196,,,0,0,1,,,,,,
430,732,200,430,732,200,,,0,0,0,,,,,,
430,732,205,430,732,206,,,0,0,-1,,,,,,
430,732,213,430,732,213,,,0,0,0,,,,,,
430,732,223,430,732,224,,,0,0,-1,,,,,,
431,732,235,431,732,235,,,0,0,0,,,,,,
431,732,249,431,732,250,,,0,0,-1,,,,,,
431,732,265,431,732,265,,,0,0,0,,,,,,
431,732,282,431,732,282,,,0,0,0,,,,,,
431,732,300,431,732,300,,,0,0,0,,,,,,
432,732,319,431,732,319,,,1,0,0,,,,,,
432,732,339,432,732,339,,,0,0,0,,,,,,
432,733,359,432,732,359,,,0,1,0,,,,,,
432,733,380,432,733,380,,,0,0,0,,,,,,
433,733,402,432,733,402,,,1,0,0,,,,,,
433,733,424,433,733,424,,,0,0,0,,,,,,
434,734,446,433,733,446,,,1,1,0,,,,,,
434,734,469,434,734,469,,,0,0,0,,,,,,
435,734,492,434,734,492,,,1,0,0,,,,,,
435,734,515,435,734,515,,,0,0,0,,,,,,
436,735,538,435,734,538,,,1,1,0,,,,,,
436,735,562,436,735,562,,,0,0,0,,,,,,
437,736,586,437,735,586,,,0,1,0,,,,,,
438,736,610,438,736,610,,,0,0,0,,,,,,
438,736,634,438,736,634,,,0,0,0,,,,,,
439,737,658,439,737,658,,,0,0,0,,,,,,
440,737,682,440,737,682,,,0,0,0,,,,,,
441,738,707,441,738,707,,,0,0,0,,,,,,
441,738,731,441,738,731,,,0,0,0,,,,,,
442,739,756,442,739,756,,,0,0,0,,,,,,
443,739,781,443,739,781,,,0,0,0,,,,,,
446,761,204,445,761,204,,,1,0,0,,,,,,
446,761,205,445,761,204,,,1,0,1,,,,,,
446,761,208,445,761,207,,,1,0,1,,,,,,
446,761,213,445,761,213,,,1,0,0,,,,,,
446,761,220,445,761,220,,,1,0,0,,,,,,
446,761,230,445,761,230,,,1,0,0,,,,,,
446,761,242,446,761,241,,,0,0,1,,,,,,
446,761,255,446,761,256,,,0,0,-1,,,,,,
446,761,271,446,761,270,,,0,0,1,,,,,,
446,761,287,446,761,287,,,0,0,0,,,,,,
447,761,305,446,761,305,,,1,0,0,,,,,,
447,762,323,447,761,324,,,0,1,-1,,,,,,
447,762,343,447,761,343,,,0,1,0,,,,,,
447,762,363,447,761,363,,,0,1,0,,,,,,
448,762,384,447,762,384,,,1,0,0,,,,,,
448,762,405,448,762,405,,,0,0,0,,,,,,
449,763,427,448,762,427,,,1,1,0,,,,,,
449,763,449,449,762,449,,,0,1,0,,,,,,
449,763,472,449,763,472,,,0,0,0,,,,,,
450,763,494,450,763,494,,,0,0,0,,,,,,
450,764,517,450,763,517,,,0,1,0,,,,,,
451,764,541,451,763,541,,,0,1,0,,,,,,
451,764,564,451,764,564,,,0,0,0,,,,,,
452,765,588,452,764,588,,,0,1,0,,,,,,
453,765,612,453,765,612,,,0,0,0,,,,,,
453,765,636,453,765,636,,,0,0,0,,,,,,
454,766,660,454,766,660,,,0,0,0,,,,,,
455,766,684,455,766,684,,,0,0,0,,,,,,
456,767,709,456,767,709,,,0,0,0,,,,,,
456,767,733,456,767,733,,,0,0,0,,,,,,
457,768,758,457,768,758,,,0,0,0,,,,,,
458,768,783,458,768,782,,,0,0,1,,,,,,
461,790,212,461,790,212,,,0,0,0,,,,,,
461,790,213,461,790,212,,,0,0,1,,,,,,
461,790,215,461,790,215,,,0,0,0,,,,,,
461,790,220,461,790,221,,,0,0,-1,,,,,,
461,790,227,461,790,227,,,0,0,0,,,,,,
461,790,237,461,790,237,,,0,0,0,,,,,,
461,790,248,461,790,248,,,0,0,0,,,,,,
462,790,261,461,790,262,,,1,0,-1,,,,,,
462,790,276,462,790,276,,,0,0,0,,,,,,
462,791,292,462,790,293,,,0,1,-1,,,,,,
462,791,310,462,791,310,,,0,0,0,,,,,,
462,791,328,462,791,328,,,0,0,0,,,,,,
463,791,347,463,791,347,,,0,0,0,,,,,,
463,791,367,463,791,367,,,0,0,0,,,,,,
463,791,388,463,791,388,,,0,0,0,,,,,,
464,792,409,463,791,409,,,1,1,0,,,,,,
464,792,430,464,792,430,,,0,0,0,,,,,,
464,792,452,464,792,452,,,0,0,0,,,,,,
465,792,475,465,792,475,,,0,0,0,,,,,,
465,793,497,465,792,497,,,0,1,0,,,,,,
466,793,520,466,793,520,,,0,0,0,,,,,,
466,793,543,466,793,543,,,0,0,0,,,,,,
467,793,567,467,793,567,,,0,0,0,,,,,,
467,794,590,467,793,590,,,0,1,0,,,,,,
468,794,614,468,794,614,,,0,0,0,,,,,,
469,794,638,468,794,638,,,1,0,0,,,,,,
469,795,662,469,795,662,,,0,0,0,,,,,,
470,795,686,470,795,686,,,0,0,0,,,,,,
471,796,711,471,796,711,,,0,0,0,,,,,,
471,796,735,471,796,735,,,0,0,0,,,,,,
472,797,760,472,797,760,,,0,0,0,,,,,,
473,797,784,473,797,784,,,0,0,0,,,,,,
477,819,220,476,819,219,,,1,0,1,,,,,,
477,819,220,476,819,219,,,1,0,1,,,,,,
477,819,223,476,819,223,,,1,0,0,,,,,,
477,820,228,476,819,228,,,1,1,0,,,,,,
477,820,235,476,819,234,,,1,1,1,,,,,,
477,820,244,476,819,244,,,1,1,0,,,,,,
477,820,255,477,819,255,,,0,1,0,,,,,,
477,820,268,477,819,268,,,0,1,0,,,,,,
477,820,282,477,819,282,,,0,1,0,,,,,,
477,820,298,477,819,298,,,0,1,0,,,,,,
478,820,315,477,820,315,,,1,0,0,,,,,,
478,820,333,478,820,333,,,0,0,0,,,,,,
478,820,352,478,820,352,,,0,0,0,,,,,,
478,820,371,478,820,372,,,0,0,-1,,,,,,
479,821,392,478,820,392,,,1,1,0,,,,,,
479,821,413,479,820,413,,,0,1,0,,,,,,
479,821,434,479,821,434,,,0,0,0,,,,,,
480,821,456,480,821,456,,,0,0,0,,,,,,
480,822,478,480,821,478,,,0,1,0,,,,,,
481,822,500,481,821,500,,,0,1,0,,,,,,
481,822,523,481,822,523,,,0,0,0,,,,,,
482,822,546,482,822,546,,,0,0,0,,,,,,
482,823,570,482,822,569,,,0,1,1,,,,,,
483,823,593,483,823,593,,,0,0,0,,,,,,
483,823,617,483,823,616,,,0,0,1,,,,,,
484,824,640,484,823,640,,,0,1,0,,,,,,
485,824,664,484,824,664,,,1,0,0,,,,,,
485,824,689,485,824,688,,,0,0,1,,,,,,
486,825,713,486,825,713,,,0,0,0,,,,,,
487,825,737,486,825,737,,,1,0,0,,,,,,
487,826,762,487,826,762,,,0,0,0,,,,,,
488,826,786,488,826,786,,,0,0,0,,,,,,
492,849,227,492,849,227,,,0,0,0,,,,,,
492,849,228,492,849,227,,,0,0,1,,,,,,
492,849,231,492,849,231,,,0,0,0,,,,,,
492,849,235,492,849,236,,,0,0,-1,,,,,,
492,849,242,492,849,242,,,0,0,0,,,,,,
492,849,251,492,849,252,,,0,0,-1,,,,,,
493,849,262,493,849,262,,,0,0,0,,,,,,
493,849,274,493,849,275,,,0,0,-1,,,,,,
493,849,288,493,849,288,,,0,0,0,,,,,,
493,849,304,493,849,304,,,0,0,0,,,,,,
493,849,320,493,849,320,,,0,0,0,,,,,,
493,850,338,493,849,338,,,0,1,0,,,,,,
494,850,357,494,850,357,,,0,0,0,,,,,,
494,850,376,494,850,376,,,0,0,0,,,,,,
494,850,396,494,850,396,,,0,0,0,,,,,,
495,850,417,494,850,417,,,1,0,0,,,,,,
495,850,438,495,850,438,,,0,0,0,,,,,,
495,851,459,495,850,459,,,0,1,0,,,,,,
496,851,481,496,851,481,,,0,0,0,,,,,,
496,851,504,496,851,503,,,0,0,1,,,,,,
497,851,526,497,851,526,,,0,0,0,,,,,,
497,852,549,497,851,549,,,0,1,0,,,,,,
498,852,572,498,852,572,,,0,0,0,,,,,,
498,852,596,498,852,595,,,0,0,1,,,,,,
499,853,619,499,853,619,,,0,0,0,,,,,,
499,853,643,499,853,643,,,0,0,0,,,,,,
500,853,667,500,853,667,,,0,0,0,,,,,,
501,854,691,500,853,691,,,1,1,0,,,,,,
501,854,715,501,854,715,,,0,0,0,,,,,,
502,854,739,502,854,739,,,0,0,0,,,,,,
503,855,764,503,855,764,,,0,0,0,,,,,,
503,855,788,503,855,788,,,0,0,0,,,,,,
508,878,235,508,878,235,,,0,0,0,,,,,,
508,878,236,508,878,235,,,0,0,1,,,,,,
508,878,238,508,878,238,,,0,0,0,,,,,,
508,878,243,508,878,244,,,0,0,-1,,,,,,
508,878,249,508,878,249,,,0,0,0,,,,,,
508,878,258,508,878,259,,,0,0,-1,,,,,,
508,878,268,508,878,268,,,0,0,0,,,,,,
508,879,280,508,878,281,,,0,1,-1,,,,,,
509,879,294,508,878,294,,,1,1,0,,,,,,
509,879,309,508,878,309,,,1,1,0,,,,,,
509,879,326,509,878,325,,,0,1,1,,,,,,
509,879,343,509,879,343,,,0,0,0,,,,,,
509,879,361,509,879,361,,,0,0,0,,,,,,
510,879,380,509,879,381,,,1,0,-1,,,,,,
510,879,400,510,879,400,,,0,0,0,,,,,,
510,880,421,510,879,421,,,0,1,0,,,,,,
511,880,442,510,879,442,,,1,1,0,,,,,,
511,880,463,511,880,463,,,0,0,0,,,,,,
511,880,485,511,880,484,,,0,0,1,,,,,,
512,880,507,512,880,507,,,0,0,0,,,,,,
512,881,529,512,880,529,,,0,1,0,,,,,,
513,881,552,513,881,552,,,0,0,0,,,,,,
513,881,575,513,881,575,,,0,0,0,,,,,,
514,882,598,514,881,598,,,0,1,0,,,,,,
514,882,622,514,882,621,,,0,0,1,,,,,,
515,882,645,515,882,645,,,0,0,0,,,,,,
515,883,669,515,882,669,,,0,1,0,,,,,,
516,883,693,516,883,693,,,0,0,0,,,,,,
517,883,717,516,883,717,,,1,0,0,,,,,,
517,884,741,517,883,741,,,0,1,0,,,,,,
518,884,766,518,884,766,,,0,0,0,,,,,,
519,885,790,518,884,790,,,1,1,0,,,,,,
178,49,27,178,49,27,,,0,0,0,,,,,,
178,49,33,178,49,27,,,0,0,6,,,,,,
178,50,50,178,49,50,,,0,1,0,,,,,,
178,50,71,178,50,71,,,0,0,0,,,,,,
179,51,93,178,51,93,,,1,0,0,,,,,,
179,52,116,179,52,116,,,0,0,0,,,,,,
179,53,139,179,53,139,,,0,0,0,,,,,,
180,55,163,179,55,163,,,1,0,0,,,,,,
180,57,187,180,56,186,,,0,1,1,,,,,,
180,58,211,180,58,210,,,0,0,1,,,,,,
181,61,235,181,61,235,,,0,0,0,,,,,,
182,63,259,182,63,259,,,0,0,0,,,,,,
182,65,284,183,65,284,,,-1,0,0,,,,,,
183,68,308,183,68,308,,,0,0,0,,,,,,
184,71,333,184,71,333,,,0,0,0,,,,,,
185,74,358,185,73,357,,,0,1,1,,,,,,
186,77,383,186,76,382,,,0,1,1,,,,,,
187,80,407,187,79,407,,,0,1,0,,,,,,
188,83,432,189,83,432,,,-1,0,0,,,,,,
190,86,457,190,86,457,,,0,0,0,,,,,,
191,90,482,191,90,482,,,0,0,0,,,,,,
192,93,508,192,93,507,,,0,0,1,,,,,,
194,96,533,194,96,533,,,0,0,0,,,,,,
195,100,558,195,100,558,,,0,0,0,,,,,,
197,103,583,197,103,583,,,0,0,0,,,,,,
199,107,608,199,107,608,,,0,0,0,,,,,,
200,111,634,201,111,634,,,-1,0,0,,,,,,
202,114,659,202,114,659,,,0,0,0,,,,,,
204,118,685,204,118,684,,,0,0,1,,,,,,
206,122,710,206,121,710,,,0,1,0,,,,,,
208,125,736,208,125,735,,,0,0,1,,,,,,
210,129,761,210,129,761,,,0,0,0,,,,,,
179,54,28,178,49,27,,,1,5,1,,,,,,
179,54,34,178,49,27,,,1,5,7,,,,,,
179,54,50,178,49,50,,,1,5,0,,,,,,
179,55,71,178,50,71,,,1,5,0,,,,,,
179,56,93,178,51,93,,,1,5,0,,,,,,
179,56,116,179,52,116,,,0,4,0,,,,,,
179,58,139,179,53,139,,,0,5,0,,,,,,
180,59,163,179,55,163,,,1,4,0,,,,,,
180,61,187,180,56,186,,,0,5,1,,,,,,
181,62,211,180,58,210,,,1,4,1,,,,,,
181,64,235,181,61,235,,,0,3,0,,,,,,
182,67,259,182,63,259,,,0,4,0,,,,,,
183,69,284,183,65,284,,,0,4,0,,,,,,
184,71,308,183,68,308,,,1,3,0,,,,,,
185,74,333,184,71,333,,,1,3,0,,,,,,
185,77,358,185,73,357,,,0,4,1,,,,,,
187,80,383,186,76,382,,,1,4,1,,,,,,
188,83,407,187,79,407,,,1,4,0,,,,,,
189,86,432,189,83,432,,,0,3,0,,,,,,
190,89,457,190,86,457,,,0,3,0,,,,,,
191,92,482,191,90,482,,,0,2,0,,,,,,
193,95,508,192,93,507,,,1,2,1,,,,,,
194,99,533,194,96,533,,,0,3,0,,,,,,
196,102,558,195,100,558,,,1,2,0,,,,,,
197,106,583,197,103,583,,,0,3,0,,,,,,
199,109,608,199,107,608,,,0,2,0,,,,,,
201,113,634,201,111,634,,,0,2,0,,,,,,
203,116,659,202,114,659,,,1,2,0,,,,,,
204,120,685,204,118,684,,,0,2,1,,,,,,
206,123,710,206,121,710,,,0,2,0,,,,,,
208,127,736,208,125,735,,,0,2,1,,,,,,
210,131,761,210,129,761,,,0,2,0,,,,,,
180,69,30,180,69,29,,,0,0,1,,,,,,
180,69,36,180,69,29,,,0,0,7,,,,,,
180,69,52,180,69,52,,,0,0,0,,,,,,
180,69,72,180,69,73,,,0,0,-1,,,,,,
180,70,94,180,70,94,,,0,0,0,,,,,,
180,71,116,180,71,116,,,0,0,0,,,,,,
181,72,140,181,72,139,,,0,0,1,,,,,,
181,73,163,181,73,163,,,0,0,0,,,,,,
182,74,187,182,74,187,,,0,0,0,,,,,,
182,75,211,182,76,211,,,0,-1,0,,,,,,
183,77,235,183,77,235,,,0,0,0,,,,,,
183,79,260,183,79,259,,,0,0,1,,,,,,
184,81,284,184,81,284,,,0,0,0,,,,,,
185,83,309,185,83,308,,,0,0,1,,,,,,
186,85,333,186,85,333,,,0,0,0,,,,,,
187,88,358,187,87,358,,,0,1,0,,,,,,
188,90,383,188,90,383,,,0,0,0,,,,,,
189,93,408,189,93,407,,,0,0,1,,,,,,
190,95,433,190,95,432,,,0,0,1,,,,,,
191,98,457,191,98,457,,,0,0,0,,,,,,
193,101,483,193,101,482,,,0,0,1,,,,,,
194,104,508,194,104,507,,,0,0,1,,,,,,
195,107,533,196,107,533,,,-1,0,0,,,,,,
197,110,558,197,110,558,,,0,0,0,,,,,,
199,113,583,199,113,583,,,0,0,0,,,,,,
200,117,609,200,116,608,,,0,1,1,,,,,,
202,120,634,202,120,634,,,0,0,0,,,,,,
204,123,659,204,123,659,,,0,0,0,,,,,,
206,127,685,206,126,685,,,0,1,0,,,,,,
207,130,710,208,130,710,,,-1,0,0,,,,,,
209,133,736,210,133,736,,,-1,0,0,,,,,,
211,137,761,212,137,761,,,-1,0,0,,,,,,
182,90,33,183,91,33,,,-1,-1,0,,,,,,
182,90,39,183,91,33,,,-1,-1,6,,,,,,
182,90,54,183,91,54,,,-1,-1,0,,,,,,
182,90,73,183,91,74,,,-1,-1,-1,,,,,,
183,90,95,183,92,95,,,0,-2,0,,,,,,
183,91,117,183,92,117,,,0,-1,0,,,,,,
183,92,140,184,93,140,,,-1,-1,0,,,,,,
184,92,164,184,94,164,,,0,-2,0,,,,,,
184,93,188,185,95,188,,,-1,-2,0,,,,,,
184,95,212,185,96,212,,,-1,-1,0,,,,,,
185,96,236,186,98,236,,,-1,-2,0,,,,,,
186,97,260,186,99,260,,,0,-2,0,,,,,,
186,99,284,187,100,284,,,-1,-1,0,,,,,,
187,101,309,188,102,309,,,-1,-1,0,,,,,,
188,102,333,188,104,333,,,0,-2,0,,,,,,
189,104,358,189,106,358,,,0,-2,0,,,,,,
190,106,383,191,108,383,,,-1,-2,0,,,,,,
191,109,408,192,110,408,,,-1,-1,0,,,,,,
192,111,433,193,113,432,,,-1,-2,1,,,,,,
193,113,458,194,115,457,,,-1,-2,1,,,,,,
195,116,483,195,118,482,,,0,-2,1,,,,,,
196,118,508,197,120,507,,,-1,-2,1,,,,,,
198,121,533,198,123,533,,,0,-2,0,,,,,,
199,124,558,200,125,558,,,-1,-1,0,,,,,,
201,126,583,201,128,583,,,0,-2,0,,,,,,
202,129,609,203,131,608,,,-1,-2,1,,,,,,
204,132,634,205,134,634,,,-1,-2,0,,,,,,
206,135,659,206,137,659,,,0,-2,0,,,,,,
208,138,685,208,140,685,,,0,-2,0,,,,,,
210,141,710,210,143,710,,,0,-2,0,,,,,,
211,145,736,212,146,736,,,-1,-1,0,,,,,,
213,148,761,214,149,761,,,-1,-1,0,,,,,,
186,113,38,186,113,38,,,0,0,0,,,,,,
186,113,43,186,113,38,,,0,0,5,,,,,,
186,113,56,186,113,56,,,0,0,0,,,,,,
186,114,75,186,113,76,,,0,1,-1,,,,,,
186,114,96,186,114,96,,,0,0,0,,,,,,
186,114,119,186,114,118,,,0,0,1,,,,,,
187,115,141,187,115,141,,,0,0,0,,,,,,
187,115,165,187,115,165,,,0,0,0,,,,,,
187,116,188,188,116,188,,,-1,0,0,,,,,,
188,117,212,188,117,212,,,0,0,0,,,,,,
189,118,236,189,118,236,,,0,0,0,,,,,,
189,119,260,189,119,260,,,0,0,0,,,,,,
190,121,285,190,120,285,,,0,1,0,,,,,,
191,122,309,190,122,309,,,1,0,0,,,,,,
191,123,334,191,123,334,,,0,0,0,,,,,,
192,125,359,192,125,358,,,0,0,1,,,,,,
193,127,383,194,126,383,,,-1,1,0,,,,,,
194,128,408,195,128,408,,,-1,0,0,,,,,,
196,130,433,196,130,433,,,0,0,0,,,,,,
197,132,458,197,132,458,,,0,0,0,,,,,,
198,134,483,198,134,483,,,0,0,0,,,,,,
199,137,508,200,136,508,,,-1,1,0,,,,,,
201,139,533,201,139,533,,,0,0,0,,,,,,
202,141,558,203,141,558,,,-1,0,0,,,,,,
204,144,584,204,143,583,,,0,1,1,,,,,,
205,146,609,206,146,608,,,-1,0,1,,,,,,
207,149,634,207,149,634,,,0,0,0,,,,,,
209,151,660,209,151,659,,,0,0,1,,,,,,
211,154,685,211,154,685,,,0,0,0,,,,,,
213,157,710,213,157,710,,,0,0,0,,,,,,
214,160,736,215,160,736,,,-1,0,0,,,,,,
216,162,761,217,162,761,,,-1,0,0,,,,,,
190,138,43,191,139,43,,,-1,-1,0,,,,,,
190,138,47,191,139,43,,,-1,-1,4,,,,,,
191,138,60,191,139,60,,,0,-1,0,,,,,,
191,139,78,191,139,79,,,0,0,-1,,,,,,
191,139,98,191,139,98,,,0,0,0,,,,,,
191,139,120,192,140,120,,,-1,-1,0,,,,,,
191,140,143,192,140,143,,,-1,0,0,,,,,,
192,140,166,192,141,166,,,0,-1,0,,,,,,
192,141,189,193,141,189,,,-1,0,0,,,,,,
193,142,213,193,142,213,,,0,0,0,,,,,,
193,142,237,194,143,237,,,-1,-1,0,,,,,,
194,143,261,194,144,261,,,0,-1,0,,,,,,
194,144,285,195,145,285,,,-1,-1,0,,,,,,
195,145,310,196,146,310,,,-1,-1,0,,,,,,
196,147,334,196,147,334,,,0,0,0,,,,,,
197,148,359,197,148,359,,,0,0,0,,,,,,
198,149,384,199,150,384,,,-1,-1,0,,,,,,
199,151,409,200,151,408,,,-1,0,1,,,,,,
200,152,433,201,153,433,,,-1,-1,0,,,,,,
201,154,458,202,155,458,,,-1,-1,0,,,,,,
202,156,483,203,157,483,,,-1,-1,0,,,,,,
204,158,508,204,158,508,,,0,0,0,,,,,,
205,160,533,206,160,533,,,-1,0,0,,,,,,
207,162,559,207,162,558,,,0,0,1,,,,,,
208,164,584,209,164,583,,,-1,0,1,,,,,,
210,166,609,210,167,609,,,0,-1,0,,,,,,
211,168,634,212,169,634,,,-1,-1,0,,,,,,
213,170,660,214,171,659,,,-1,-1,1,,,,,,
215,173,685,216,174,685,,,-1,-1,0,,,,,,
217,175,711,218,176,710,,,-1,-1,1,,,,,,
218,178,736,220,179,736,,,-2,-1,0,,,,,,
220,180,762,221,181,761,,,-1,-1,1,,,,,,
196,164,49,196,165,49,,,0,-1,0,,,,,,
196,164,53,196,165,49,,,0,-1,4,,,,,,
196,165,64,197,165,64,,,-1,0,0,,,,,,
196,165,81,197,165,82,,,-1,0,-1,,,,,,
197,165,101,197,165,101,,,0,0,0,,,,,,
197,165,122,197,165,122,,,0,0,0,,,,,,
197,166,144,197,166,144,,,0,0,0,,,,,,
197,166,167,198,166,167,,,-1,0,0,,,,,,
198,167,191,198,167,190,,,0,0,1,,,,,,
198,167,214,199,167,214,,,-1,0,0,,,,,,
199,168,238,199,168,238,,,0,0,0,,,,,,
199,169,262,200,168,262,,,-1,1,0,,,,,,
200,169,286,200,169,286,,,0,0,0,,,,,,
201,170,311,201,170,310,,,0,0,1,,,,,,
202,171,335,202,171,335,,,0,0,0,,,,,,
202,172,360,203,172,359,,,-1,0,1,,,,,,
203,174,384,204,174,384,,,-1,0,0,,,,,,
204,175,409,205,175,409,,,-1,0,0,,,,,,
205,176,434,206,176,434,,,-1,0,0,,,,,,
207,178,459,207,178,459,,,0,0,0,,,,,,
208,179,484,208,179,484,,,0,0,0,,,,,,
209,181,509,209,181,509,,,0,0,0,,,,,,
210,182,534,211,182,534,,,-1,0,0,,,,,,
212,184,559,212,184,559,,,0,0,0,,,,,,
213,186,584,214,186,584,,,-1,0,0,,,,,,
215,188,609,215,188,609,,,0,0,0,,,,,,
216,190,635,217,190,635,,,-1,0,0,,,,,,
218,192,660,219,192,660,,,-1,0,0,,,,,,
220,194,685,221,194,685,,,-1,0,0,,,,,,
222,196,711,222,196,710,,,0,0,1,,,,,,
223,198,736,224,198,736,,,-1,0,0,,,,,,
225,201,762,226,200,761,,,-1,1,1,,,,,,
203,191,56,203,191,56,,,0,0,0,,,,,,
203,191,59,203,191,56,,,0,0,3,,,,,,
203,191,69,204,191,69,,,-1,0,0,,,,,,
203,191,85,204,191,86,,,-1,0,-1,,,,,,
203,192,104,204,191,104,,,-1,1,0,,,,,,
204,192,125,204,192,125,,,0,0,0,,,,,,
204,192,146,204,192,146,,,0,0,0,,,,,,
204,192,169,205,193,169,,,-1,-1,0,,,,,,
205,193,192,205,193,192,,,0,0,0,,,,,,
205,193,215,206,193,215,,,-1,0,0,,,,,,
206,194,239,206,194,239,,,0,0,0,,,,,,
206,195,263,207,195,263,,,-1,0,0,,,,,,
207,195,287,207,195,287,,,0,0,0,,,,,,
207,196,311,208,196,311,,,-1,0,0,,,,,,
208,197,336,209,197,336,,,-1,0,0,,,,,,
209,198,360,210,198,360,,,-1,0,0,,,,,,
210,199,385,211,199,385,,,-1,0,0,,,,,,
211,200,410,212,200,409,,,-1,0,1,,,,,,
212,201,434,213,201,434,,,-1,0,0,,,,,,
213,202,459,214,203,459,,,-1,-1,0,,,,,,
214,204,484,215,204,484,,,-1,0,0,,,,,,
215,205,509,216,205,509,,,-1,0,0,,,,,,
217,207,534,217,207,534,,,0,0,0,,,,,,
218,208,559,219,208,559,,,-1,0,0,,,,,,
220,210,585,220,210,584,,,0,0,1,,,,,,
221,211,610,222,212,610,,,-1,-1,0,,,,,,
223,213,635,223,213,635,,,0,0,0,,,,,,
224,215,660,225,215,660,,,-1,0,0,,,,,,
226,217,686,227,217,685,,,-1,0,1,,,,,,
228,219,711,229,219,711,,,-1,0,0,,,,,,
229,220,737,230,221,736,,,-1,-1,1,,,,,,
231,223,762,232,223,762,,,-1,0,0,,,,,,
211,218,62,211,218,62,,,0,0,0,,,,,,
211,218,65,211,218,62,,,0,0,3,,,,,,
211,218,75,211,218,74,,,0,0,1,,,,,,
211,218,89,211,218,91,,,0,0,-2,,,,,,
211,219,107,212,218,107,,,-1,1,0,,,,,,
211,219,128,212,219,128,,,-1,0,0,,,,,,
212,219,149,212,219,149,,,0,0,0,,,,,,
212,219,171,212,219,171,,,0,0,0,,,,,,
212,220,194,213,219,193,,,-1,1,1,,,,,,
213,220,217,213,220,217,,,0,0,0,,,,,,
213,221,241,214,220,240,,,-1,1,1,,,,,,
214,221,264,214,221,264,,,0,0,0,,,,,,
214,222,288,215,222,288,,,-1,0,0,,,,,,
215,223,313,215,222,312,,,0,1,1,,,,,,
216,223,337,216,223,337,,,0,0,0,,,,,,
217,224,361,217,224,361,,,0,0,0,,,,,,
217,225,386,218,225,386,,,-1,0,0,,,,,,
218,226,410,219,226,410,,,-1,0,0,,,,,,
219,227,435,220,227,435,,,-1,0,0,,,,,,
220,228,460,221,228,460,,,-1,0,0,,,,,,
222,229,485,222,229,485,,,0,0,0,,,,,,
223,230,510,223,230,510,,,0,0,0,,,,,,
224,232,535,224,231,535,,,0,1,0,,,,,,
225,233,560,226,233,560,,,-1,0,0,,,,,,
227,234,585,227,234,585,,,0,0,0,,,,,,
228,236,610,228,236,610,,,0,0,0,,,,,,
230,237,636,230,237,636,,,0,0,0,,,,,,
231,239,661,231,239,661,,,0,0,0,,,,,,
233,241,686,233,240,686,,,0,1,0,,,,,,
234,242,712,235,242,711,,,-1,0,1,,,,,,
236,244,737,237,244,737,,,-1,0,0,,,,,,
238,246,763,239,246,762,,,-1,0,1,,,,,,
219,246,69,220,246,69,,,-1,0,0,,,,,,
219,246,72,220,246,69,,,-1,0,3,,,,,,
220,246,80,220,246,80,,,0,0,0,,,,,,
220,246,94,220,246,96,,,0,0,-2,,,,,,
220,246,111,221,246,111,,,-1,0,0,,,,,,
220,246,131,221,246,131,,,-1,0,0,,,,,,
220,246,152,221,246,151,,,-1,0,1,,,,,,
220,247,173,221,246,173,,,-1,1,0,,,,,,
221,247,196,222,247,196,,,-1,0,0,,,,,,
221,247,219,222,247,219,,,-1,0,0,,,,,,
222,248,242,223,247,242,,,-1,1,0,,,,,,
222,248,266,223,248,266,,,-1,0,0,,,,,,
223,249,290,224,249,289,,,-1,0,1,,,,,,
224,249,314,224,249,313,,,0,0,1,,,,,,
224,250,338,225,250,338,,,-1,0,0,,,,,,
225,251,362,226,251,362,,,-1,0,0,,,,,,
226,252,387,226,252,387,,,0,0,0,,,,,,
227,252,411,227,252,411,,,0,0,0,,,,,,
228,253,436,228,253,436,,,0,0,0,,,,,,
229,254,461,229,254,460,,,0,0,1,,,,,,
230,255,486,230,255,485,,,0,0,1,,,,,,
231,256,511,232,256,510,,,-1,0,1,,,,,,
232,258,536,233,257,535,,,-1,1,1,,,,,,
233,259,561,234,259,560,,,-1,0,1,,,,,,
235,260,586,236,260,585,,,-1,0,1,,,,,,
236,261,611,237,261,611,,,-1,0,0,,,,,,
238,263,636,238,263,636,,,0,0,0,,,,,,
239,264,661,240,264,661,,,-1,0,0,,,,,,
241,265,687,241,265,686,,,0,0,1,,,,,,
242,267,712,243,267,712,,,-1,0,0,,,,,,
244,269,738,245,269,737,,,-1,0,1,,,,,,
246,270,763,246,270,763,,,0,0,0,,,,,,
229,273,76,230,273,76,,,-1,0,0,,,,,,
229,273,78,230,273,76,,,-1,0,2,,,,,,
229,273,86,230,273,86,,,-1,0,0,,,,,,
229,273,99,230,273,101,,,-1,0,-2,,,,,,
229,274,116,230,274,115,,,-1,0,1,,,,,,
229,274,134,230,274,135,,,-1,0,-1,,,,,,
230,274,155,230,274,154,,,0,0,1,,,,,,
230,274,176,230,274,176,,,0,0,0,,,,,,
230,274,198,231,274,198,,,-1,0,0,,,,,,
231,275,221,231,274,221,,,0,1,0,,,,,,
231,275,244,232,275,244,,,-1,0,0,,,,,,
232,276,267,232,275,267,,,0,1,0,,,,,,
232,276,291,233,276,291,,,-1,0,0,,,,,,
233,277,315,233,276,315,,,0,1,0,,,,,,
233,277,339,234,277,339,,,-1,0,0,,,,,,
234,278,363,235,278,363,,,-1,0,0,,,,,,
235,279,388,235,279,388,,,0,0,0,,,,,,
236,279,412,236,279,412,,,0,0,0,,,,,,
237,280,437,237,280,437,,,0,0,0,,,,,,
238,281,462,238,281,461,,,0,0,1,,,,,,
239,282,487,239,282,486,,,0,0,1,,,,,,
240,283,511,240,283,511,,,0,0,0,,,,,,
241,284,536,242,284,536,,,-1,0,0,,,,,,
242,285,561,243,285,561,,,-1,0,0,,,,,,
243,286,586,244,286,586,,,-1,0,0,,,,,,
245,287,612,246,287,611,,,-1,0,1,,,,,,
246,288,637,247,289,637,,,-1,-1,0,,,,,,
248,290,662,248,290,662,,,0,0,0,,,,,,
249,291,687,250,291,687,,,-1,0,0,,,,,,
251,292,713,251,292,712,,,0,0,1,,,,,,
252,294,738,253,294,738,,,-1,0,0,,,,,,
254,295,764,254,295,763,,,0,0,1,,,,,,
239,301,83,240,301,83,,,-1,0,0,,,,,,
239,301,85,240,301,83,,,-1,0,2,,,,,,
239,301,93,240,301,92,,,-1,0,1,,,,,,
239,301,105,240,301,106,,,-1,0,-1,,,,,,
239,301,120,240,301,120,,,-1,0,0,,,,,,
240,302,138,240,301,139,,,0,1,-1,,,,,,
240,302,158,240,302,158,,,0,0,0,,,,,,
240,302,179,241,302,179,,,-1,0,0,,,,,,
240,302,201,241,302,201,,,-1,0,0,,,,,,
241,303,223,242,302,223,,,-1,1,0,,,,,,
241,303,246,242,303,246,,,-1,0,0,,,,,,
242,303,269,243,303,269,,,-1,0,0,,,,,,
242,304,293,243,303,292,,,-1,1,1,,,,,,
243,304,317,244,304,316,,,-1,0,1,,,,,,
243,305,341,244,304,340,,,-1,1,1,,,,,,
244,305,365,245,305,364,,,-1,0,1,,,,,,
245,306,389,245,306,389,,,0,0,0,,,,,,
246,307,414,246,306,413,,,0,1,1,,,,,,
247,307,438,247,307,438,,,0,0,0,,,,,,
248,308,463,248,308,462,,,0,0,1,,,,,,
248,309,487,249,309,487,,,-1,0,0,,,,,,
250,310,512,250,310,512,,,0,0,0,,,,,,
251,311,537,251,311,537,,,0,0,0,,,,,,
252,312,562,253,312,562,,,-1,0,0,,,,,,
253,313,587,254,313,587,,,-1,0,0,,,,,,
254,314,612,255,314,612,,,-1,0,0,,,,,,
256,315,638,257,315,637,,,-1,0,1,,,,,,
257,316,663,258,316,662,,,-1,0,1,,,,,,
258,317,688,259,317,688,,,-1,0,0,,,,,,
260,318,713,261,318,713,,,-1,0,0,,,,,,
261,320,739,262,320,738,,,-1,0,1,,,,,,
263,321,764,264,321,764,,,-1,0,0,,,,,,
250,329,91,250,329,91,,,0,0,0,,,,,,
250,329,92,250,329,91,,,0,0,1,,,,,,
250,329,99,251,329,99,,,-1,0,0,,,,,,
250,329,110,251,329,112,,,-1,0,-2,,,,,,
250,329,125,251,329,125,,,-1,0,0,,,,,,
250,330,143,251,329,143,,,-1,1,0,,,,,,
251,330,162,251,330,161,,,0,0,1,,,,,,
251,330,182,251,330,182,,,0,0,0,,,,,,
251,330,204,252,330,203,,,-1,0,1,,,,,,
251,330,226,252,330,226,,,-1,0,0,,,,,,
252,331,248,253,331,248,,,-1,0,0,,,,,,
252,331,271,253,331,271,,,-1,0,0,,,,,,
253,332,295,254,331,294,,,-1,1,1,,,,,,
253,332,318,254,332,318,,,-1,0,0,,,,,,
254,332,342,255,332,342,,,-1,0,0,,,,,,
255,333,366,255,333,366,,,0,0,0,,,,,,
255,334,390,256,333,390,,,-1,1,0,,,,,,
256,334,415,256,334,414,,,0,0,1,,,,,,
257,335,439,257,335,439,,,0,0,0,,,,,,
258,336,464,258,335,463,,,0,1,1,,,,,,
259,336,489,259,336,488,,,0,0,1,,,,,,
260,337,513,260,337,513,,,0,0,0,,,,,,
261,338,538,261,338,538,,,0,0,0,,,,,,
262,339,563,262,339,563,,,0,0,0,,,,,,
263,340,588,264,340,588,,,-1,0,0,,,,,,
264,341,613,265,341,613,,,-1,0,0,,,,,,
266,342,638,267,342,638,,,-1,0,0,,,,,,
267,343,663,268,343,663,,,-1,0,0,,,,,,
268,344,689,269,344,689,,,-1,0,0,,,,,,
270,345,714,270,345,714,,,0,0,0,,,,,,
271,346,739,272,346,739,,,-1,0,0,,,,,,
273,347,765,274,347,764,,,-1,0,1,,,,,,
261,357,98,262,357,98,,,-1,0,0,,,,,,
261,357,100,262,357,98,,,-1,0,2,,,,,,
261,357,106,262,357,105,,,-1,0,1,,,,,,
261,357,116,262,357,118,,,-1,0,-2,,,,,,
261,358,130,262,357,130,,,-1,1,0,,,,,,
262,358,147,262,357,148,,,0,1,-1,,,,,,
262,358,166,262,358,165,,,0,0,1,,,,,,
262,358,186,263,358,186,,,-1,0,0,,,,,,
262,358,207,263,358,206,,,-1,0,1,,,,,,
263,359,228,263,358,228,,,0,1,0,,,,,,
263,359,251,264,359,251,,,-1,0,0,,,,,,
264,359,274,264,359,273,,,0,0,1,,,,,,
264,359,297,265,359,296,,,-1,0,1,,,,,,
265,360,320,265,360,320,,,0,0,0,,,,,,
265,360,344,266,360,344,,,-1,0,0,,,,,,
266,361,368,266,361,368,,,0,0,0,,,,,,
267,361,392,267,361,392,,,0,0,0,,,,,,
267,362,416,268,362,416,,,-1,0,0,,,,,,
268,362,441,269,362,440,,,-1,0,1,,,,,,
269,363,465,269,363,465,,,0,0,0,,,,,,
270,364,490,270,363,489,,,0,1,1,,,,,,
271,365,514,271,364,514,,,0,1,0,,,,,,
272,365,539,272,365,539,,,0,0,0,,,,,,
273,366,564,273,366,564,,,0,0,0,,,,,,
274,367,589,275,367,589,,,-1,0,0,,,,,,
275,368,614,276,368,614,,,-1,0,0,,,,,,
276,369,639,277,369,639,,,-1,0,0,,,,,,
278,370,664,278,370,664,,,0,0,0,,,,,,
279,371,690,279,371,689,,,0,0,1,,,,,,
280,372,715,281,372,714,,,-1,0,1,,,,,,
282,373,740,283,373,740,,,-1,0,0,,,,,,
283,374,765,284,374,765,,,-1,0,0,,,,,,
273,386,105,273,385,105,,,0,1,0,,,,,,
273,386,107,273,385,105,,,0,1,2,,,,,,
273,386,113,274,386,112,,,-1,0,1,,,,,,
273,386,122,274,386,124,,,-1,0,-2,,,,,,
273,386,136,274,386,136,,,-1,0,0,,,,,,
273,386,152,274,386,152,,,-1,0,0,,,,,,
274,386,170,274,386,169,,,0,0,1,,,,,,
274,386,189,274,386,189,,,0,0,0,,,,,,
274,386,210,275,386,210,,,-1,0,0,,,,,,
275,387,231,275,386,231,,,0,1,0,,,,,,
275,387,253,275,387,253,,,0,0,0,,,,,,
275,387,276,276,387,276,,,-1,0,0,,,,,,
276,388,299,276,387,299,,,0,1,0,,,,,,
276,388,322,277,388,322,,,-1,0,0,,,,,,
277,388,346,277,388,346,,,0,0,0,,,,,,
277,389,370,278,389,369,,,-1,0,1,,,,,,
278,389,394,279,389,393,,,-1,0,1,,,,,,
279,390,418,279,390,417,,,0,0,1,,,,,,
280,390,442,280,390,442,,,0,0,0,,,,,,
280,391,466,281,391,466,,,-1,0,0,,,,,,
281,392,491,282,391,491,,,-1,1,0,,,,,,
282,392,516,283,392,515,,,-1,0,1,,,,,,
283,393,540,284,393,540,,,-1,0,0,,,,,,
284,394,565,285,393,565,,,-1,1,0,,,,,,
285,394,590,286,394,590,,,-1,0,0,,,,,,
286,395,615,287,395,615,,,-1,0,0,,,,,,
287,396,640,288,396,640,,,-1,0,0,,,,,,
289,397,665,289,397,665,,,0,0,0,,,,,,
290,398,690,290,398,690,,,0,0,0,,,,,,
291,399,716,292,399,715,,,-1,0,1,,,,,,
293,400,741,293,400,741,,,0,0,0,,,,,,
294,401,766,294,401,766,,,0,0,0,,,,,,
285,414,113,286,414,112,,,-1,0,1,,,,,,
285,414,114,286,414,112,,,-1,0,2,,,,,,
285,414,119,286,414,119,,,-1,0,0,,,,,,
286,414,129,286,414,130,,,0,0,-1,,,,,,
286,414,141,286,414,141,,,0,0,0,,,,,,
286,414,157,286,414,158,,,0,0,-1,,,,,,
286,414,174,287,414,174,,,-1,0,0,,,,,,
286,415,193,287,414,194,,,-1,1,-1,,,,,,
286,415,214,287,415,213,,,-1,0,1,,,,,,
287,415,235,287,415,235,,,0,0,0,,,,,,
287,415,256,288,415,256,,,-1,0,0,,,,,,
287,416,279,288,415,279,,,-1,1,0,,,,,,
288,416,301,289,416,301,,,-1,0,0,,,,,,
288,416,324,289,416,324,,,-1,0,0,,,,,,
289,417,348,290,416,348,,,-1,1,0,,,,,,
290,417,371,290,417,371,,,0,0,0,,,,,,
290,417,395,291,417,395,,,-1,0,0,,,,,,
291,418,419,291,418,419,,,0,0,0,,,,,,
292,418,444,292,418,443,,,0,0,1,,,,,,
292,419,468,293,419,468,,,-1,0,0,,,,,,
293,420,492,294,419,492,,,-1,1,0,,,,,,
294,420,517,295,420,517,,,-1,0,0,,,,,,
295,421,542,296,421,541,,,-1,0,1,,,,,,
296,422,566,297,421,566,,,-1,1,0,,,,,,
297,422,591,298,422,591,,,-1,0,0,,,,,,
298,423,616,299,423,616,,,-1,0,0,,,,,,
299,424,641,300,424,641,,,-1,0,0,,,,,,
300,425,666,301,424,666,,,-1,1,0,,,,,,
301,425,691,302,425,691,,,-1,0,0,,,,,,
303,426,717,303,426,716,,,0,0,1,,,,,,
304,427,742,305,427,742,,,-1,0,0,,,,,,
305,428,767,306,428,767,,,-1,0,0,,,,,,
298,443,120,299,442,120,,,-1,1,0,,,,,,
298,443,122,299,442,120,,,-1,1,2,,,,,,
298,443,127,299,442,126,,,-1,1,1,,,,,,
298,443,135,299,442,137,,,-1,1,-2,,,,,,
298,443,147,299,442,147,,,-1,1,0,,,,,,
298,443,162,299,442,163,,,-1,1,-1,,,,,,
299,443,179,299,443,179,,,0,0,0,,,,,,
299,443,198,299,443,198,,,0,0,0,,,,,,
299,443,217,300,443,217,,,-1,0,0,,,,,,
299,443,238,300,443,238,,,-1,0,0,,,,,,
300,444,259,300,443,259,,,0,1,0,,,,,,
300,444,281,301,444,281,,,-1,0,0,,,,,,
301,444,304,301,444,304,,,0,0,0,,,,,,
301,445,327,302,444,327,,,-1,1,0,,,,,,
301,445,350,302,445,350,,,-1,0,0,,,,,,
302,445,374,303,445,373,,,-1,0,1,,,,,,
303,446,397,303,445,397,,,0,1,0,,,,,,
303,446,421,304,446,421,,,-1,0,0,,,,,,
304,447,445,304,446,445,,,0,1,0,,,,,,
305,447,469,305,447,469,,,0,0,0,,,,,,
306,448,494,306,447,494,,,0,1,0,,,,,,
306,448,518,307,448,518,,,-1,0,0,,,,,,
307,449,543,308,449,543,,,-1,0,0,,,,,,
308,450,568,309,449,567,,,-1,1,1,,,,,,
309,450,592,310,450,592,,,-1,0,0,,,,,,
310,451,617,311,451,617,,,-1,0,0,,,,,,
311,452,642,312,451,642,,,-1,1,0,,,,,,
312,452,667,313,452,667,,,-1,0,0,,,,,,
313,453,692,314,453,692,,,-1,0,0,,,,,,
315,454,718,315,454,717,,,0,0,1,,,,,,
316,455,743,317,455,743,,,-1,0,0,,,,,,
317,456,768,318,455,768,,,-1,1,0,,,,,,
311,471,128,312,471,127,,,-1,0,1,,,,,,
311,471,129,312,471,127,,,-1,0,2,,,,,,
311,471,134,312,471,133,,,-1,0,1,,,,,,
311,471,142,312,471,143,,,-1,0,-1,,,,,,
311,471,153,312,471,153,,,-1,0,0,,,,,,
311,471,168,312,471,169,,,-1,0,-1,,,,,,
312,472,184,312,471,184,,,0,1,0,,,,,,
312,472,202,312,471,203,,,0,1,-1,,,,,,
312,472,221,313,472,221,,,-1,0,0,,,,,,
312,472,242,313,472,242,,,-1,0,0,,,,,,
313,472,263,313,472,262,,,0,0,1,,,,,,
313,472,284,314,472,284,,,-1,0,0,,,,,,
313,473,307,314,473,306,,,-1,0,1,,,,,,
314,473,329,315,473,329,,,-1,0,0,,,,,,
314,473,352,315,473,352,,,-1,0,0,,,,,,
315,474,376,316,473,375,,,-1,1,1,,,,,,
315,474,399,316,474,399,,,-1,0,0,,,,,,
316,475,423,317,474,423,,,-1,1,0,,,,,,
317,475,447,317,475,447,,,0,0,0,,,,,,
317,475,471,318,475,471,,,-1,0,0,,,,,,
318,476,495,319,476,495,,,-1,0,0,,,,,,
319,476,520,320,476,520,,,-1,0,0,,,,,,
320,477,544,321,477,544,,,-1,0,0,,,,,,
321,478,569,321,477,569,,,0,1,0,,,,,,
322,478,594,322,478,593,,,0,0,1,,,,,,
323,479,619,323,479,618,,,0,0,1,,,,,,
324,480,643,324,479,643,,,0,1,0,,,,,,
325,480,668,325,480,668,,,0,0,0,,,,,,
326,481,693,326,481,693,,,0,0,0,,,,,,
327,482,719,328,482,718,,,-1,0,1,,,,,,
328,483,744,329,482,744,,,-1,1,0,,,,,,
329,484,769,330,483,769,,,-1,1,0,,,,,,
324,500,135,325,500,135,,,-1,0,0,,,,,,
324,500,136,325,500,135,,,-1,0,1,,,,,,
325,500,141,325,500,141,,,0,0,0,,,,,,
325,500,149,325,500,150,,,0,0,-1,,,,,,
325,500,160,325,500,159,,,0,0,1,,,,,,
325,500,173,325,500,174,,,0,0,-1,,,,,,
325,500,189,325,500,189,,,0,0,0,,,,,,
325,500,207,326,500,207,,,-1,0,0,,,,,,
325,501,225,326,500,225,,,-1,1,0,,,,,,
326,501,245,326,500,245,,,0,1,0,,,,,,
326,501,266,326,500,266,,,0,1,0,,,,,,
326,501,288,327,501,287,,,-1,0,1,,,,,,
327,501,310,327,501,309,,,0,0,1,,,,,,
327,502,332,328,501,332,,,-1,1,0,,,,,,
328,502,355,328,502,355,,,0,0,0,,,,,,
328,502,378,329,502,378,,,-1,0,0,,,,,,
329,503,401,329,502,401,,,0,1,0,,,,,,
329,503,425,330,503,425,,,-1,0,0,,,,,,
330,503,449,330,503,449,,,0,0,0,,,,,,
331,504,473,331,504,473,,,0,0,0,,,,,,
331,504,497,332,504,497,,,-1,0,0,,,,,,
332,505,521,332,505,521,,,0,0,0,,,,,,
333,505,546,333,505,546,,,0,0,0,,,,,,
334,506,570,334,506,570,,,0,0,0,,,,,,
335,507,595,335,506,595,,,0,1,0,,,,,,
335,507,620,336,507,620,,,-1,0,0,,,,,,
336,508,645,337,507,645,,,-1,1,0,,,,,,
337,508,670,338,508,670,,,-1,0,0,,,,,,
339,509,695,339,509,695,,,0,0,0,,,,,,
340,510,720,340,510,720,,,0,0,0,,,,,,
341,511,745,342,510,745,,,-1,1,0,,,,,,
342,511,770,343,511,770,,,-1,0,0,,,,,,
338,529,143,339,528,143,,,-1,1,0,,,,,,
338,529,144,339,528,143,,,-1,1,1,,,,,,
338,529,148,339,528,148,,,-1,1,0,,,,,,
338,529,156,339,528,157,,,-1,1,-1,,,,,,
338,529,166,339,529,166,,,-1,0,0,,,,,,
338,529,179,339,529,180,,,-1,0,-1,,,,,,
339,529,194,339,529,194,,,0,0,0,,,,,,
339,529,211,339,529,212,,,0,0,-1,,,,,,
339,529,230,340,529,230,,,-1,0,0,,,,,,
339,529,249,340,529,249,,,-1,0,0,,,,,,
340,530,270,340,529,269,,,0,1,1,,,,,,
340,530,291,340,529,291,,,0,1,0,,,,,,
340,530,313,341,530,312,,,-1,0,1,,,,,,
341,530,335,341,530,335,,,0,0,0,,,,,,
341,531,358,342,530,357,,,-1,1,1,,,,,,
342,531,381,342,530,380,,,0,1,1,,,,,,
342,531,404,343,531,403,,,-1,0,1,,,,,,
343,532,427,343,531,427,,,0,1,0,,,,,,
343,532,451,344,532,451,,,-1,0,0,,,,,,
344,532,475,344,532,475,,,0,0,0,,,,,,
345,533,499,345,533,499,,,0,0,0,,,,,,
345,533,523,346,533,523,,,-1,0,0,,,,,,
346,534,548,347,534,547,,,-1,0,1,,,,,,
347,534,572,347,534,572,,,0,0,0,,,,,,
348,535,597,348,535,596,,,0,0,1,,,,,,
349,535,621,349,535,621,,,0,0,0,,,,,,
350,536,646,350,536,646,,,0,0,0,,,,,,
351,537,671,351,536,671,,,0,1,0,,,,,,
352,537,696,352,537,696,,,0,0,0,,,,,,
353,538,721,353,538,721,,,0,0,0,,,,,,
354,539,746,355,539,746,,,-1,0,0,,,,,,
355,540,771,356,539,771,,,-1,1,0,,,,,,
352,558,150,352,557,150,,,0,1,0,,,,,,
352,558,152,352,557,150,,,0,1,2,,,,,,
352,558,155,352,557,155,,,0,1,0,,,,,,
352,558,162,352,557,164,,,0,1,-2,,,,,,
352,558,172,353,557,172,,,-1,1,0,,,,,,
352,558,185,353,557,186,,,-1,1,-1,,,,,,
352,558,200,353,557,199,,,-1,1,1,,,,,,
353,558,216,353,558,217,,,0,0,-1,,,,,,
353,558,234,353,558,234,,,0,0,0,,,,,,
353,558,254,354,558,254,,,-1,0,0,,,,,,
353,558,274,354,558,273,,,-1,0,1,,,,,,
354,559,294,354,558,294,,,0,1,0,,,,,,
354,559,316,354,558,316,,,0,1,0,,,,,,
354,559,338,355,559,338,,,-1,0,0,,,,,,
355,559,360,355,559,360,,,0,0,0,,,,,,
355,560,383,356,559,383,,,-1,1,0,,,,,,
356,560,406,356,559,406,,,0,1,0,,,,,,
356,560,430,357,560,429,,,-1,0,1,,,,,,
357,561,453,357,560,453,,,0,1,0,,,,,,
358,561,477,358,561,477,,,0,0,0,,,,,,
358,561,501,359,561,501,,,-1,0,0,,,,,,
359,562,525,359,562,525,,,0,0,0,,,,,,
360,562,549,360,562,549,,,0,0,0,,,,,,
360,563,574,361,563,573,,,-1,0,1,,,,,,
361,563,598,362,563,598,,,-1,0,0,,,,,,
362,564,623,363,564,622,,,-1,0,1,,,,,,
363,565,648,364,564,647,,,-1,1,1,,,,,,
364,565,672,365,565,672,,,-1,0,0,,,,,,
365,566,697,366,565,697,,,-1,1,0,,,,,,
366,566,722,367,566,722,,,-1,0,0,,,,,,
367,567,747,368,567,747,,,-1,0,0,,,,,,
368,568,772,369,568,772,,,-1,0,0,,,,,,
366,586,158,367,586,158,,,-1,0,0,,,,,,
366,586,159,367,586,158,,,-1,0,1,,,,,,
366,586,163,367,586,163,,,-1,0,0,,,,,,
366,586,170,367,586,171,,,-1,0,-1,,,,,,
366,587,179,367,586,179,,,-1,1,0,,,,,,
366,587,191,367,586,192,,,-1,1,-1,,,,,,
367,587,205,367,586,205,,,0,1,0,,,,,,
367,587,222,367,586,222,,,0,1,0,,,,,,
367,587,239,367,587,239,,,0,0,0,,,,,,
367,587,258,368,587,258,,,-1,0,0,,,,,,
367,587,278,368,587,277,,,-1,0,1,,,,,,
368,587,298,368,587,298,,,0,0,0,,,,,,
368,588,319,368,587,319,,,0,1,0,,,,,,
368,588,341,369,587,341,,,-1,1,0,,,,,,
369,588,363,369,588,363,,,0,0,0,,,,,,
369,588,386,370,588,386,,,-1,0,0,,,,,,
370,589,409,370,588,408,,,0,1,1,,,,,,
370,589,432,371,589,432,,,-1,0,0,,,,,,
371,589,455,371,589,455,,,0,0,0,,,,,,
371,590,479,372,589,479,,,-1,1,0,,,,,,
372,590,503,373,590,503,,,-1,0,0,,,,,,
373,591,527,373,590,527,,,0,1,0,,,,,,
373,591,551,374,591,551,,,-1,0,0,,,,,,
374,591,575,375,591,575,,,-1,0,0,,,,,,
375,592,600,376,592,600,,,-1,0,0,,,,,,
376,593,624,376,592,624,,,0,1,0,,,,,,
377,593,649,377,593,649,,,0,0,0,,,,,,
378,594,674,378,593,673,,,0,1,1,,,,,,
378,594,699,379,594,698,,,-1,0,1,,,,,,
379,595,724,380,594,723,,,-1,1,1,,,,,,
380,595,749,381,595,748,,,-1,0,1,,,,,,
381,596,774,382,596,773,,,-1,0,1,,,,,,
380,615,166,381,615,165,,,-1,0,1,,,,,,
380,615,167,381,615,165,,,-1,0,2,,,,,,
380,615,170,381,615,170,,,-1,0,0,,,,,,
380,615,177,381,615,178,,,-1,0,-1,,,,,,
381,616,186,381,615,185,,,0,1,1,,,,,,
381,616,197,381,615,198,,,0,1,-1,,,,,,
381,616,211,381,615,211,,,0,1,0,,,,,,
381,616,227,381,615,227,,,0,1,0,,,,,,
381,616,244,382,615,244,,,-1,1,0,,,,,,
381,616,262,382,616,263,,,-1,0,-1,,,,,,
382,616,282,382,616,282,,,0,0,0,,,,,,
382,616,302,382,616,302,,,0,0,0,,,,,,
382,617,323,383,616,323,,,-1,1,0,,,,,,
383,617,344,383,616,344,,,0,1,0,,,,,,
383,617,366,383,617,366,,,0,0,0,,,,,,
383,617,389,384,617,389,,,-1,0,0,,,,,,
384,618,412,384,617,411,,,0,1,1,,,,,,
384,618,435,385,618,434,,,-1,0,1,,,,,,
385,618,458,385,618,458,,,0,0,0,,,,,,
385,619,481,386,618,481,,,-1,1,0,,,,,,
386,619,505,387,619,505,,,-1,0,0,,,,,,
387,619,529,387,619,529,,,0,0,0,,,,,,
387,620,553,388,619,553,,,-1,1,0,,,,,,
388,620,577,389,620,577,,,-1,0,0,,,,,,
389,621,602,390,620,602,,,-1,1,0,,,,,,
390,621,626,390,621,626,,,0,0,0,,,,,,
390,622,651,391,621,651,,,-1,1,0,,,,,,
391,622,675,392,622,675,,,-1,0,0,,,,,,
392,623,700,393,622,700,,,-1,1,0,,,,,,
393,623,725,394,623,725,,,-1,0,0,,,,,,
394,624,750,395,624,750,,,-1,0,0,,,,,,
395,625,775,396,624,775,,,-1,1,0,,,,,,
395,644,173,396,644,173,,,-1,0,0,,,,,,
395,644,174,396,644,173,,,-1,0,1,,,,,,
395,644,178,396,644,178,,,-1,0,0,,,,,,
395,644,184,396,644,185,,,-1,0,-1,,,,,,
395,645,193,396,644,192,,,-1,1,1,,,,,,
395,645,204,396,644,205,,,-1,1,-1,,,,,,
395,645,217,396,644,217,,,-1,1,0,,,,,,
395,645,232,396,644,233,,,-1,1,-1,,,,,,
396,645,249,396,644,249,,,0,1,0,,,,,,
396,645,267,396,645,267,,,0,0,0,,,,,,
396,645,286,397,645,286,,,-1,0,0,,,,,,
396,645,306,397,645,306,,,-1,0,0,,,,,,
397,646,327,397,645,326,,,0,1,1,,,,,,
397,646,348,397,645,348,,,0,1,0,,,,,,
397,646,370,398,646,369,,,-1,0,1,,,,,,
398,646,392,398,646,392,,,0,0,0,,,,,,
398,646,414,399,646,414,,,-1,0,0,,,,,,
399,647,437,399,647,437,,,0,0,0,,,,,,
399,647,460,400,647,460,,,-1,0,0,,,,,,
400,647,484,400,647,484,,,0,0,0,,,,,,
400,648,507,401,647,507,,,-1,1,0,,,,,,
401,648,531,401,648,531,,,0,0,0,,,,,,
402,649,555,402,648,555,,,0,1,0,,,,,,
402,649,579,403,649,579,,,-1,0,0,,,,,,
403,649,604,404,649,603,,,-1,0,1,,,,,,
404,650,628,404,650,628,,,0,0,0,,,,,,
405,650,652,405,650,652,,,0,0,0,,,,,,
405,651,677,406,651,677,,,-1,0,0,,,,,,
406,651,702,407,651,701,,,-1,0,1,,,,,,
407,652,727,408,652,726,,,-1,0,1,,,,,,
408,653,751,409,652,751,,,-1,1,0,,,,,,
409,653,776,410,653,776,,,-1,0,0,,,,,,
410,674,181,410,673,181,,,0,1,0,,,,,,
410,674,182,410,673,181,,,0,1,1,,,,,,
410,674,185,410,673,185,,,0,1,0,,,,,,
410,674,191,410,673,192,,,0,1,-1,,,,,,
410,674,200,410,673,199,,,0,1,1,,,,,,
410,674,210,410,673,211,,,0,1,-1,,,,,,
410,674,223,410,673,223,,,0,1,0,,,,,,
410,674,238,410,673,239,,,0,1,-1,,,,,,
410,674,254,410,674,254,,,0,0,0,,,,,,
410,674,272,411,674,272,,,-1,0,0,,,,,,
411,674,291,411,674,290,,,0,0,1,,,,,,
411,674,310,411,674,310,,,0,0,0,,,,,,
411,675,331,412,674,330,,,-1,1,1,,,,,,
412,675,352,412,674,351,,,0,1,1,,,,,,
412,675,373,412,675,373,,,0,0,0,,,,,,
412,675,395,413,675,395,,,-1,0,0,,,,,,
413,675,417,413,675,417,,,0,0,0,,,,,,
413,676,440,414,676,440,,,-1,0,0,,,,,,
414,676,463,414,676,463,,,0,0,0,,,,,,
414,676,486,415,676,486,,,-1,0,0,,,,,,
415,677,510,415,676,510,,,0,1,0,,,,,,
415,677,533,416,677,533,,,-1,0,0,,,,,,
416,677,557,416,677,557,,,0,0,0,,,,,,
417,678,581,417,678,581,,,0,0,0,,,,,,
417,678,606,418,678,605,,,-1,0,1,,,,,,
418,679,630,418,679,629,,,0,0,1,,,,,,
419,679,654,419,679,654,,,0,0,0,,,,,,
420,680,679,420,680,678,,,0,0,1,,,,,,
420,680,703,421,680,703,,,-1,0,0,,,,,,
421,681,728,422,681,728,,,-1,0,0,,,,,,
422,681,753,423,681,753,,,-1,0,0,,,,,,
423,682,778,424,682,778,,,-1,0,0,,,,,,
424,703,189,425,702,189,,,-1,1,0,,,,,,
424,703,190,425,702,189,,,-1,1,1,,,,,,
424,703,193,425,702,193,,,-1,1,0,,,,,,
424,703,198,425,702,199,,,-1,1,-1,,,,,,
424,703,206,425,702,206,,,-1,1,0,,,,,,
425,703,217,425,702,218,,,0,1,-1,,,,,,
425,703,229,425,702,229,,,0,1,0,,,,,,
425,703,244,425,703,244,,,0,0,0,,,,,,
425,703,260,425,703,260,,,0,0,0,,,,,,
425,703,277,425,703,277,,,0,0,0,,,,,,
425,703,295,426,703,295,,,-1,0,0,,,,,,
426,704,315,426,703,315,,,0,1,0,,,,,,
426,704,335,426,703,334,,,0,1,1,,,,,,
426,704,355,427,703,355,,,-1,1,0,,,,,,
427,704,377,427,704,376,,,0,0,1,,,,,,
427,704,398,427,704,398,,,0,0,0,,,,,,
427,705,420,428,704,420,,,-1,1,0,,,,,,
428,705,443,428,705,443,,,0,0,0,,,,,,
428,705,466,429,705,466,,,-1,0,0,,,,,,
429,705,489,429,705,489,,,0,0,0,,,,,,
429,706,512,430,705,512,,,-1,1,0,,,,,,
430,706,536,430,706,536,,,0,0,0,,,,,,
431,706,560,431,706,559,,,0,0,1,,,,,,
431,707,584,431,707,583,,,0,0,1,,,,,,
432,707,608,432,707,607,,,0,0,1,,,,,,
433,708,632,433,707,631,,,0,1,1,,,,,,
433,708,656,434,708,656,,,-1,0,0,,,,,,
434,709,681,434,708,680,,,0,1,1,,,,,,
435,709,705,435,709,705,,,0,0,0,,,,,,
436,710,730,436,709,729,,,0,1,1,,,,,,
437,710,755,437,710,754,,,0,0,1,,,,,,
437,711,779,438,710,779,,,-1,1,0,,,,,,
439,732,197,440,732,196,,,-1,0,1,,,,,,
439,732,197,440,732,196,,,-1,0,1,,,,,,
439,732,200,440,732,200,,,-1,0,0,,,,,,
439,732,206,440,732,207,,,-1,0,-1,,,,,,
439,732,214,440,732,213,,,-1,0,1,,,,,,
439,732,224,440,732,224,,,-1,0,0,,,,,,
440,732,236,440,732,235,,,0,0,1,,,,,,
440,732,250,440,732,250,,,0,0,0,,,,,,
440,732,265,440,732,265,,,0,0,0,,,,,,
440,732,282,440,732,282,,,0,0,0,,,,,,
440,733,300,441,732,300,,,-1,1,0,,,,,,
441,733,319,441,732,319,,,0,1,0,,,,,,
441,733,339,441,732,339,,,0,1,0,,,,,,
441,733,359,441,733,359,,,0,0,0,,,,,,
441,733,380,442,733,380,,,-1,0,0,,,,,,
442,733,402,442,733,402,,,0,0,0,,,,,,
442,734,424,443,733,424,,,-1,1,0,,,,,,
443,734,446,443,734,446,,,0,0,0,,,,,,
443,734,469,443,734,469,,,0,0,0,,,,,,
444,734,492,444,734,492,,,0,0,0,,,,,,
444,735,515,444,734,515,,,0,1,0,,,,,,
445,735,538,445,735,538,,,0,0,0,,,,,,
445,735,562,445,735,562,,,0,0,0,,,,,,
446,736,586,446,736,586,,,0,0,0,,,,,,
446,736,610,447,736,610,,,-1,0,0,,,,,,
447,737,634,448,736,634,,,-1,1,0,,,,,,
448,737,658,448,737,658,,,0,0,0,,,,,,
449,738,682,449,737,682,,,0,1,0,,,,,,
449,738,707,450,738,707,,,-1,0,0,,,,,,
450,738,732,451,738,731,,,-1,0,1,,,,,,
451,739,756,451,739,756,,,0,0,0,,,,,,
452,740,781,452,739,781,,,0,1,0,,,,,,
454,761,204,455,761,204,,,-1,0,0,,,,,,
454,761,205,455,761,204,,,-1,0,1,,,,,,
454,761,208,455,761,208,,,-1,0,0,,,,,,
454,761,213,455,761,214,,,-1,0,-1,,,,,,
454,761,221,455,761,220,,,-1,0,1,,,,,,
454,761,230,455,761,231,,,-1,0,-1,,,,,,
455,761,242,455,761,242,,,0,0,0,,,,,,
455,761,256,455,761,256,,,0,0,0,,,,,,
455,762,271,455,761,271,,,0,1,0,,,,,,
455,762,287,455,761,288,,,0,1,-1,,,,,,
455,762,305,456,761,305,,,-1,1,0,,,,,,
456,762,324,456,761,324,,,0,1,0,,,,,,
456,762,343,456,762,343,,,0,0,0,,,,,,
456,762,363,456,762,363,,,0,0,0,,,,,,
456,762,384,457,762,384,,,-1,0,0,,,,,,
457,763,405,457,762,405,,,0,1,0,,,,,,
457,763,427,458,762,427,,,-1,1,0,,,,,,
458,763,449,458,763,449,,,0,0,0,,,,,,
458,763,472,458,763,472,,,0,0,0,,,,,,
458,764,495,459,763,494,,,-1,1,1,,,,,,
459,764,518,459,763,517,,,0,1,1,,,,,,
459,764,541,460,764,541,,,-1,0,0,,,,,,
460,765,564,460,764,564,,,0,1,0,,,,,,
461,765,588,461,765,588,,,0,0,0,,,,,,
461,765,612,462,765,612,,,-1,0,0,,,,,,
462,766,636,462,765,636,,,0,1,0,,,,,,
463,766,660,463,766,660,,,0,0,0,,,,,,
463,767,684,464,766,684,,,-1,1,0,,,,,,
464,767,709,465,767,709,,,-1,0,0,,,,,,
465,767,733,465,767,733,,,0,0,0,,,,,,
466,768,758,466,768,758,,,0,0,0,,,,,,
466,768,783,467,768,782,,,-1,0,1,,,,,,
469,790,212,470,790,212,,,-1,0,0,,,,,,
469,790,213,470,790,212,,,-1,0,1,,,,,,
469,790,216,470,790,215,,,-1,0,1,,,,,,
469,790,221,470,790,221,,,-1,0,0,,,,,,
470,791,228,470,790,227,,,0,1,1,,,,,,
470,791,237,470,790,238,,,0,1,-1,,,,,,
470,791,249,470,790,248,,,0,1,1,,,,,,
470,791,262,470,790,262,,,0,1,0,,,,,,
470,791,277,471,790,276,,,-1,1,1,,,,,,
470,791,293,471,790,293,,,-1,1,0,,,,,,
470,791,310,471,791,310,,,-1,0,0,,,,,,
471,791,328,471,791,328,,,0,0,0,,,,,,
471,791,347,472,791,347,,,-1,0,0,,,,,,
471,791,367,472,791,367,,,-1,0,0,,,,,,
471,792,388,472,791,388,,,-1,1,0,,,,,,
472,792,409,472,791,409,,,0,1,0,,,,,,
472,792,431,473,792,430,,,-1,0,1,,,,,,
473,792,453,473,792,452,,,0,0,1,,,,,,
473,793,475,474,792,475,,,-1,1,0,,,,,,
473,793,497,474,792,497,,,-1,1,0,,,,,,
474,793,520,475,793,520,,,-1,0,0,,,,,,
474,793,544,475,793,543,,,-1,0,1,,,,,,
475,794,567,476,793,567,,,-1,1,0,,,,,,
476,794,591,476,794,590,,,0,0,1,,,,,,
476,794,614,477,794,614,,,-1,0,0,,,,,,
477,795,638,477,795,638,,,0,0,0,,,,,,
477,795,662,478,795,662,,,-1,0,0,,,,,,
478,796,687,478,795,686,,,0,1,1,,,,,,
479,796,711,479,796,711,,,0,0,0,,,,,,
480,796,735,480,796,735,,,0,0,0,,,,,,
480,797,760,481,797,760,,,-1,0,0,,,,,,
481,797,785,481,797,784,,,0,0,1,,,,,,
485,820,220,485,819,220,,,0,1,0,,,,,,
485,820,221,485,819,220,,,0,1,1,,,,,,
485,820,223,485,820,223,,,0,0,0,,,,,,
485,820,228,485,820,229,,,0,0,-1,,,,,,
485,820,235,485,820,235,,,0,0,0,,,,,,
485,820,244,485,820,245,,,0,0,-1,,,,,,
485,820,255,485,820,255,,,0,0,0,,,,,,
485,820,268,485,820,268,,,0,0,0,,,,,,
485,820,282,486,820,282,,,-1,0,0,,,,,,
485,820,298,486,820,298,,,-1,0,0,,,,,,
486,820,315,486,820,315,,,0,0,0,,,,,,
486,820,333,486,820,333,,,0,0,0,,,,,,
486,821,352,487,820,352,,,-1,1,0,,,,,,
486,821,372,487,820,372,,,-1,1,0,,,,,,
487,821,392,487,821,392,,,0,0,0,,,,,,
487,821,413,487,821,413,,,0,0,0,,,,,,
487,821,434,488,821,434,,,-1,0,0,,,,,,
488,822,456,488,821,456,,,0,1,0,,,,,,
488,822,478,489,821,478,,,-1,1,0,,,,,,
489,822,501,489,822,500,,,0,0,1,,,,,,
489,822,523,490,822,523,,,-1,0,0,,,,,,
490,823,546,490,822,546,,,0,1,0,,,,,,
490,823,570,491,823,569,,,-1,0,1,,,,,,
491,823,593,491,823,593,,,0,0,0,,,,,,
491,824,617,492,823,616,,,-1,1,1,,,,,,
492,824,641,492,824,640,,,0,0,1,,,,,,
492,824,665,493,824,664,,,-1,0,1,,,,,,
493,825,689,493,824,688,,,0,1,1,,,,,,
494,825,713,494,825,713,,,0,0,0,,,,,,
495,826,737,495,825,737,,,0,1,0,,,,,,
495,826,762,496,826,762,,,-1,0,0,,,,,,
496,827,786,496,826,786,,,0,1,0,,,,,,
500,849,228,500,849,227,,,0,0,1,,,,,,
500,849,228,500,849,227,,,0,0,1,,,,,,
500,849,231,500,849,231,,,0,0,0,,,,,,
500,849,236,500,849,236,,,0,0,0,,,,,,
500,849,242,500,849,242,,,0,0,0,,,,,,
500,849,251,500,849,252,,,0,0,-1,,,,,,
500,849,262,501,849,262,,,-1,0,0,,,,,,
500,849,274,501,849,275,,,-1,0,-1,,,,,,
501,849,288,501,849,288,,,0,0,0,,,,,,
501,850,304,501,849,304,,,0,1,0,,,,,,
501,850,320,501,849,320,,,0,1,0,,,,,,
501,850,338,501,849,338,,,0,1,0,,,,,,
501,850,357,502,850,357,,,-1,0,0,,,,,,
502,850,376,502,850,376,,,0,0,0,,,,,,
502,850,396,502,850,396,,,0,0,0,,,,,,
502,850,417,503,850,417,,,-1,0,0,,,,,,
503,851,438,503,850,438,,,0,1,0,,,,,,
503,851,459,503,850,459,,,0,1,0,,,,,,
503,851,481,504,851,481,,,-1,0,0,,,,,,
504,851,504,504,851,504,,,0,0,0,,,,,,
504,852,526,505,851,526,,,-1,1,0,,,,,,
505,852,549,505,852,549,,,0,0,0,,,,,,
505,852,572,506,852,572,,,-1,0,0,,,,,,
506,853,596,506,852,595,,,0,1,1,,,,,,
506,853,619,507,853,619,,,-1,0,0,,,,,,
507,853,643,507,853,643,,,0,0,0,,,,,,
508,854,667,508,853,667,,,0,1,0,,,,,,
508,854,691,508,854,691,,,0,0,0,,,,,,
509,854,715,509,854,715,,,0,0,0,,,,,,
510,855,739,510,855,739,,,0,0,0,,,,,,
510,855,764,511,855,764,,,-1,0,0,,,,,,
511,856,788,511,855,788,,,0,1,0,,,,,,
515,879,236,516,878,235,,,-1,1,1,,,,,,
515,879,236,516,878,235,,,-1,1,1,,,,,,
516,879,239,516,878,238,,,0,1,1,,,,,,
516,879,243,516,878,244,,,0,1,-1,,,,,,
516,879,250,516,878,249,,,0,1,1,,,,,,
516,879,258,516,878,259,,,0,1,-1,,,,,,
516,879,269,516,879,268,,,0,0,1,,,,,,
516,879,281,516,879,281,,,0,0,0,,,,,,
516,879,294,516,879,294,,,0,0,0,,,,,,
516,879,310,516,879,310,,,0,0,0,,,,,,
516,879,326,517,879,326,,,-1,0,0,,,,,,
517,879,343,517,879,343,,,0,0,0,,,,,,
517,879,362,517,879,361,,,0,0,1,,,,,,
517,880,381,517,879,381,,,0,1,0,,,,,,
517,880,400,518,879,400,,,-1,1,0,,,,,,
518,880,421,518,879,421,,,0,1,0,,,,,,
518,880,442,518,880,442,,,0,0,0,,,,,,
518,880,463,519,880,463,,,-1,0,0,,,,,,
519,880,485,519,880,485,,,0,0,0,,,,,,
519,881,507,519,880,507,,,0,1,0,,,,,,
520,881,529,520,881,529,,,0,0,0,,,,,,
520,881,552,520,881,552,,,0,0,0,,,,,,
520,882,575,521,881,575,,,-1,1,0,,,,,,
521,882,598,521,882,598,,,0,0,0,,,,,,
522,882,622,522,882,621,,,0,0,1,,,,,,
522,882,646,522,882,645,,,0,0,1,,,,,,
523,883,669,523,882,669,,,0,1,0,,,,,,
523,883,693,524,883,693,,,-1,0,0,,,,,,
524,884,717,524,883,717,,,0,1,0,,,,,,
525,884,742,525,884,741,,,0,0,1,,,,,,
525,884,766,526,884,766,,,-1,0,0,,,,,,
526,885,790,526,884,790,,,0,1,0,,,,,,
205,57,31,205,57,31,,,0,0,0,,,,,,
205,57,37,205,57,31,,,0,0,6,,,,,,
205,57,52,205,57,52,,,0,0,0,,,,,,
205,57,72,205,57,73,,,0,0,-1,,,,,,
205,58,94,205,58,94,,,0,0,0,,,,,,
205,59,117,205,59,117,,,0,0,0,,,,,,
206,60,140,206,60,140,,,0,0,0,,,,,,
206,61,163,206,61,163,,,0,0,0,,,,,,
206,63,187,206,63,187,,,0,0,0,,,,,,
207,65,211,206,65,211,,,1,0,0,,,,,,
207,67,235,207,67,235,,,0,0,0,,,,,,
208,69,260,208,69,259,,,0,0,1,,,,,,
209,71,284,209,71,284,,,0,0,0,,,,,,
209,73,309,209,73,308,,,0,0,1,,,,,,
210,76,333,210,76,333,,,0,0,0,,,,,,
211,79,358,211,78,358,,,0,1,0,,,,,,
212,81,383,212,81,383,,,0,0,0,,,,,,
213,84,408,213,84,408,,,0,0,0,,,,,,
214,87,433,214,87,433,,,0,0,0,,,,,,
215,90,458,215,90,458,,,0,0,0,,,,,,
216,94,483,216,94,483,,,0,0,0,,,,,,
217,97,508,217,97,508,,,0,0,0,,,,,,
218,100,533,218,100,533,,,0,0,0,,,,,,
220,103,558,219,103,558,,,1,0,0,,,,,,
221,107,583,221,107,583,,,0,0,0,,,,,,
223,110,609,222,110,608,,,1,0,1,,,,,,
224,114,634,224,114,634,,,0,0,0,,,,,,
226,117,659,225,117,659,,,1,0,0,,,,,,
227,121,685,227,121,685,,,0,0,0,,,,,,
229,124,710,229,124,710,,,0,0,0,,,,,,
231,128,736,231,128,736,,,0,0,0,,,,,,
233,132,761,233,131,761,,,0,1,0,,,,,,
205,61,32,205,57,31,,,0,4,1,,,,,,
205,61,37,205,57,31,,,0,4,6,,,,,,
205,61,53,205,57,52,,,0,4,1,,,,,,
205,61,73,205,57,73,,,0,4,0,,,,,,
205,62,94,205,58,94,,,0,4,0,,,,,,
206,63,117,205,59,117,,,1,4,0,,,,,,
206,64,140,206,60,140,,,0,4,0,,,,,,
206,65,164,206,61,163,,,0,4,1,,,,,,
207,67,187,206,63,187,,,1,4,0,,,,,,
207,68,211,206,65,211,,,1,3,0,,,,,,
208,70,236,207,67,235,,,1,3,1,,,,,,
208,72,260,208,69,259,,,0,3,1,,,,,,
209,74,284,209,71,284,,,0,3,0,,,,,,
210,77,309,209,73,308,,,1,4,1,,,,,,
210,79,333,210,76,333,,,0,3,0,,,,,,
211,82,358,211,78,358,,,0,4,0,,,,,,
212,84,383,212,81,383,,,0,3,0,,,,,,
213,87,408,213,84,408,,,0,3,0,,,,,,
214,90,433,214,87,433,,,0,3,0,,,,,,
215,93,458,215,90,458,,,0,3,0,,,,,,
216,96,483,216,94,483,,,0,2,0,,,,,,
217,99,508,217,97,508,,,0,2,0,,,,,,
219,102,533,218,100,533,,,1,2,0,,,,,,
220,106,558,219,103,558,,,1,3,0,,,,,,
222,109,583,221,107,583,,,1,2,0,,,,,,
223,112,609,222,110,608,,,1,2,1,,,,,,
225,116,634,224,114,634,,,1,2,0,,,,,,
226,119,659,225,117,659,,,1,2,0,,,,,,
228,123,685,227,121,685,,,1,2,0,,,,,,
229,126,710,229,124,710,,,0,2,0,,,,,,
231,130,736,231,128,736,,,0,2,0,,,,,,
233,133,761,233,131,761,,,0,2,0,,,,,,
206,74,33,206,74,33,,,0,0,0,,,,,,
206,74,39,206,74,33,,,0,0,6,,,,,,
206,74,54,206,74,54,,,0,0,0,,,,,,
206,75,73,206,74,74,,,0,1,-1,,,,,,
207,75,95,207,75,95,,,0,0,0,,,,,,
207,76,117,207,76,117,,,0,0,0,,,,,,
207,77,140,207,77,140,,,0,0,0,,,,,,
207,78,164,207,78,164,,,0,0,0,,,,,,
208,79,188,208,79,188,,,0,0,0,,,,,,
208,80,212,208,80,212,,,0,0,0,,,,,,
209,82,236,209,82,236,,,0,0,0,,,,,,
209,83,260,209,83,260,,,0,0,0,,,,,,
210,85,284,210,85,284,,,0,0,0,,,,,,
211,87,309,210,87,308,,,1,0,1,,,,,,
211,89,333,211,89,333,,,0,0,0,,,,,,
212,92,358,212,91,358,,,0,1,0,,,,,,
213,94,383,213,94,383,,,0,0,0,,,,,,
214,97,408,214,96,408,,,0,1,0,,,,,,
215,99,433,215,99,433,,,0,0,0,,,,,,
216,102,458,216,102,458,,,0,0,0,,,,,,
217,105,483,217,105,483,,,0,0,0,,,,,,
219,107,508,218,107,508,,,1,0,0,,,,,,
220,110,533,220,110,533,,,0,0,0,,,,,,
221,113,558,221,113,558,,,0,0,0,,,,,,
223,116,583,223,116,583,,,0,0,0,,,,,,
224,120,609,224,119,608,,,0,1,1,,,,,,
226,123,634,226,123,634,,,0,0,0,,,,,,
227,126,659,227,126,659,,,0,0,0,,,,,,
229,129,685,229,129,685,,,0,0,0,,,,,,
230,133,710,230,132,710,,,0,1,0,,,,,,
232,136,736,232,136,736,,,0,0,0,,,,,,
234,139,761,234,139,761,,,0,0,0,,,,,,
208,94,37,208,95,37,,,0,-1,0,,,,,,
208,94,41,208,95,37,,,0,-1,4,,,,,,
208,94,56,208,95,56,,,0,-1,0,,,,,,
209,94,75,209,95,76,,,0,-1,-1,,,,,,
209,94,96,209,96,96,,,0,-2,0,,,,,,
209,95,118,209,96,118,,,0,-1,0,,,,,,
209,96,141,209,97,141,,,0,-1,0,,,,,,
209,96,164,210,98,164,,,-1,-2,0,,,,,,
210,97,188,210,99,188,,,0,-2,0,,,,,,
210,98,212,211,100,212,,,-1,-2,0,,,,,,
211,100,236,211,101,236,,,0,-1,0,,,,,,
211,101,260,212,102,260,,,-1,-1,0,,,,,,
212,102,285,212,104,284,,,0,-2,1,,,,,,
213,104,309,213,105,309,,,0,-1,0,,,,,,
213,106,334,213,107,333,,,0,-1,1,,,,,,
214,108,358,214,109,358,,,0,-1,0,,,,,,
215,110,383,215,111,383,,,0,-1,0,,,,,,
216,112,408,216,113,408,,,0,-1,0,,,,,,
217,114,433,217,116,433,,,0,-2,0,,,,,,
218,116,458,218,118,458,,,0,-2,0,,,,,,
219,119,483,219,121,483,,,0,-2,0,,,,,,
220,121,508,221,123,508,,,-1,-2,0,,,,,,
222,124,533,222,125,533,,,0,-1,0,,,,,,
223,126,558,223,128,558,,,0,-2,0,,,,,,
224,129,584,225,131,583,,,-1,-2,1,,,,,,
226,132,609,226,134,608,,,0,-2,1,,,,,,
227,135,634,228,137,634,,,-1,-2,0,,,,,,
229,138,659,229,139,659,,,0,-1,0,,,,,,
231,141,685,231,142,685,,,0,-1,0,,,,,,
232,144,710,232,145,710,,,0,-1,0,,,,,,
234,147,736,234,149,736,,,0,-2,0,,,,,,
236,150,761,236,152,761,,,0,-2,0,,,,,,
211,116,41,211,116,41,,,0,0,0,,,,,,
211,116,45,211,116,41,,,0,0,4,,,,,,
211,116,58,211,116,58,,,0,0,0,,,,,,
212,117,77,211,116,77,,,1,1,0,,,,,,
212,117,97,212,117,97,,,0,0,0,,,,,,
212,117,119,212,117,119,,,0,0,0,,,,,,
212,118,142,212,118,142,,,0,0,0,,,,,,
212,119,165,212,118,165,,,0,1,0,,,,,,
213,119,189,213,119,189,,,0,0,0,,,,,,
213,120,213,213,120,213,,,0,0,0,,,,,,
214,121,237,214,121,237,,,0,0,0,,,,,,
214,122,261,214,122,261,,,0,0,0,,,,,,
215,123,285,215,123,285,,,0,0,0,,,,,,
216,125,310,215,124,309,,,1,1,1,,,,,,
216,126,334,216,126,334,,,0,0,0,,,,,,
217,128,359,217,127,359,,,0,1,0,,,,,,
218,129,384,218,129,384,,,0,0,0,,,,,,
219,131,408,219,131,408,,,0,0,0,,,,,,
220,133,433,220,133,433,,,0,0,0,,,,,,
221,135,458,221,135,458,,,0,0,0,,,,,,
222,137,483,222,137,483,,,0,0,0,,,,,,
223,139,508,223,139,508,,,0,0,0,,,,,,
225,141,533,225,141,533,,,0,0,0,,,,,,
226,144,559,226,143,558,,,0,1,1,,,,,,
227,146,584,227,146,584,,,0,0,0,,,,,,
229,148,609,228,148,609,,,1,0,0,,,,,,
230,151,634,230,151,634,,,0,0,0,,,,,,
232,154,660,231,153,659,,,1,1,1,,,,,,
233,156,685,233,156,685,,,0,0,0,,,,,,
235,159,711,235,159,710,,,0,0,1,,,,,,
237,162,736,237,162,736,,,0,0,0,,,,,,
238,165,762,238,164,761,,,0,1,1,,,,,,
215,141,46,215,141,46,,,0,0,0,,,,,,
215,141,50,215,141,46,,,0,0,4,,,,,,
216,141,62,216,141,62,,,0,0,0,,,,,,
216,141,79,216,141,80,,,0,0,-1,,,,,,
216,141,99,216,142,99,,,0,-1,0,,,,,,
216,142,121,216,142,121,,,0,0,0,,,,,,
216,142,143,216,143,143,,,0,-1,0,,,,,,
217,143,166,217,143,166,,,0,0,0,,,,,,
217,143,190,217,144,190,,,0,-1,0,,,,,,
217,144,214,218,144,213,,,-1,0,1,,,,,,
218,145,237,218,145,237,,,0,0,0,,,,,,
218,146,262,219,146,261,,,-1,0,1,,,,,,
219,147,286,219,147,286,,,0,0,0,,,,,,
220,148,310,220,148,310,,,0,0,0,,,,,,
220,149,335,220,149,334,,,0,0,1,,,,,,
221,150,359,221,151,359,,,0,-1,0,,,,,,
222,152,384,222,152,384,,,0,0,0,,,,,,
223,153,409,223,154,409,,,0,-1,0,,,,,,
224,155,434,224,155,433,,,0,0,1,,,,,,
225,156,459,225,157,458,,,0,-1,1,,,,,,
226,158,483,226,159,483,,,0,-1,0,,,,,,
227,160,509,227,160,508,,,0,0,1,,,,,,
228,162,534,229,162,533,,,-1,0,1,,,,,,
230,164,559,230,164,558,,,0,0,1,,,,,,
231,166,584,231,167,584,,,0,-1,0,,,,,,
232,168,609,232,169,609,,,0,-1,0,,,,,,
234,170,635,234,171,634,,,0,-1,1,,,,,,
235,172,660,235,173,660,,,0,-1,0,,,,,,
237,175,685,237,176,685,,,0,-1,0,,,,,,
239,177,711,239,178,710,,,0,-1,1,,,,,,
240,180,736,241,181,736,,,-1,-1,0,,,,,,
242,182,762,242,183,761,,,0,-1,1,,,,,,
220,167,52,220,167,52,,,0,0,0,,,,,,
221,167,55,220,167,52,,,1,0,3,,,,,,
221,167,66,221,167,66,,,0,0,0,,,,,,
221,167,83,221,167,84,,,0,0,-1,,,,,,
221,167,102,221,167,102,,,0,0,0,,,,,,
221,167,123,221,167,123,,,0,0,0,,,,,,
221,168,145,221,168,145,,,0,0,0,,,,,,
222,168,168,221,168,168,,,1,0,0,,,,,,
222,169,191,222,169,191,,,0,0,0,,,,,,
222,169,215,222,169,214,,,0,0,1,,,,,,
223,170,238,223,170,238,,,0,0,0,,,,,,
223,171,262,223,170,262,,,0,1,0,,,,,,
224,171,287,224,171,287,,,0,0,0,,,,,,
225,172,311,224,172,311,,,1,0,0,,,,,,
225,173,335,225,173,335,,,0,0,0,,,,,,
226,174,360,226,174,360,,,0,0,0,,,,,,
227,176,385,227,176,385,,,0,0,0,,,,,,
228,177,409,228,177,409,,,0,0,0,,,,,,
229,178,434,229,178,434,,,0,0,0,,,,,,
230,180,459,230,179,459,,,0,1,0,,,,,,
231,181,484,231,181,484,,,0,0,0,,,,,,
232,183,509,232,182,509,,,0,1,0,,,,,,
233,184,534,233,184,534,,,0,0,0,,,,,,
234,186,559,234,186,559,,,0,0,0,,,,,,
236,188,584,236,188,584,,,0,0,0,,,,,,
237,190,610,237,190,609,,,0,0,1,,,,,,
238,192,635,238,192,635,,,0,0,0,,,,,,
240,194,660,240,194,660,,,0,0,0,,,,,,
242,196,686,242,196,686,,,0,0,0,,,,,,
243,198,711,243,198,711,,,0,0,0,,,,,,
245,200,736,245,200,736,,,0,0,0,,,,,,
246,202,762,246,202,762,,,0,0,0,,,,,,
227,193,58,226,193,58,,,1,0,0,,,,,,
227,193,61,226,193,58,,,1,0,3,,,,,,
227,193,71,227,193,71,,,0,0,0,,,,,,
227,193,86,227,193,88,,,0,0,-2,,,,,,
227,193,105,227,193,105,,,0,0,0,,,,,,
227,194,125,227,194,126,,,0,0,-1,,,,,,
227,194,147,227,194,147,,,0,0,0,,,,,,
228,194,170,228,194,170,,,0,0,0,,,,,,
228,195,193,228,195,192,,,0,0,1,,,,,,
228,195,216,229,195,216,,,-1,0,0,,,,,,
229,196,240,229,196,239,,,0,0,1,,,,,,
229,196,263,230,196,263,,,-1,0,0,,,,,,
230,197,288,230,197,288,,,0,0,0,,,,,,
230,198,312,231,198,312,,,-1,0,0,,,,,,
231,199,336,231,199,336,,,0,0,0,,,,,,
232,200,361,232,200,360,,,0,0,1,,,,,,
233,201,385,233,201,385,,,0,0,0,,,,,,
234,202,410,234,202,410,,,0,0,0,,,,,,
234,203,435,235,203,434,,,-1,0,1,,,,,,
235,204,460,236,204,459,,,-1,0,1,,,,,,
236,205,484,237,206,484,,,-1,-1,0,,,,,,
238,207,509,238,207,509,,,0,0,0,,,,,,
239,208,535,239,208,534,,,0,0,1,,,,,,
240,210,560,240,210,559,,,0,0,1,,,,,,
241,211,585,242,212,584,,,-1,-1,1,,,,,,
243,213,610,243,213,610,,,0,0,0,,,,,,
244,215,635,244,215,635,,,0,0,0,,,,,,
245,216,661,245,217,660,,,0,-1,1,,,,,,
247,218,686,247,219,686,,,0,-1,0,,,,,,
249,220,711,249,220,711,,,0,0,0,,,,,,
250,222,737,250,222,736,,,0,0,1,,,,,,
252,224,762,252,224,762,,,0,0,0,,,,,,
233,220,64,233,220,64,,,0,0,0,,,,,,
233,220,67,233,220,64,,,0,0,3,,,,,,
233,220,76,233,220,76,,,0,0,0,,,,,,
234,220,91,233,220,92,,,1,0,-1,,,,,,
234,220,108,234,220,108,,,0,0,0,,,,,,
234,220,128,234,220,129,,,0,0,-1,,,,,,
234,221,150,234,221,150,,,0,0,0,,,,,,
234,221,172,234,221,172,,,0,0,0,,,,,,
235,221,194,235,221,194,,,0,0,0,,,,,,
235,222,217,235,221,217,,,0,1,0,,,,,,
236,222,241,236,222,241,,,0,0,0,,,,,,
236,223,265,236,222,265,,,0,1,0,,,,,,
237,223,289,237,223,289,,,0,0,0,,,,,,
237,224,313,237,224,313,,,0,0,0,,,,,,
238,225,337,238,225,337,,,0,0,0,,,,,,
239,226,361,238,225,361,,,1,1,0,,,,,,
239,226,386,239,226,386,,,0,0,0,,,,,,
240,227,411,240,227,410,,,0,0,1,,,,,,
241,228,435,241,228,435,,,0,0,0,,,,,,
242,230,460,242,229,460,,,0,1,0,,,,,,
243,231,485,243,231,485,,,0,0,0,,,,,,
244,232,510,244,232,510,,,0,0,0,,,,,,
245,233,535,245,233,535,,,0,0,0,,,,,,
246,234,560,246,234,560,,,0,0,0,,,,,,
248,236,585,248,236,585,,,0,0,0,,,,,,
249,237,611,249,237,610,,,0,0,1,,,,,,
250,239,636,250,239,636,,,0,0,0,,,,,,
252,240,661,251,240,661,,,1,0,0,,,,,,
253,242,686,253,242,686,,,0,0,0,,,,,,
255,244,712,254,243,711,,,1,1,1,,,,,,
256,245,737,256,245,737,,,0,0,0,,,,,,
258,247,763,258,247,762,,,0,0,1,,,,,,
241,247,71,241,247,71,,,0,0,0,,,,,,
241,247,73,241,247,71,,,0,0,2,,,,,,
241,247,82,241,247,82,,,0,0,0,,,,,,
241,247,95,241,247,97,,,0,0,-2,,,,,,
241,247,112,242,247,112,,,-1,0,0,,,,,,
242,247,132,242,247,132,,,0,0,0,,,,,,
242,248,152,242,248,152,,,0,0,0,,,,,,
242,248,174,242,248,174,,,0,0,0,,,,,,
242,248,196,243,248,196,,,-1,0,0,,,,,,
243,249,219,243,248,219,,,0,1,0,,,,,,
243,249,243,244,249,242,,,-1,0,1,,,,,,
244,250,266,244,249,266,,,0,1,0,,,,,,
244,250,290,245,250,290,,,-1,0,0,,,,,,
245,251,314,245,250,314,,,0,1,0,,,,,,
245,251,338,246,251,338,,,-1,0,0,,,,,,
246,252,363,246,252,362,,,0,0,1,,,,,,
247,253,387,247,253,387,,,0,0,0,,,,,,
248,254,412,248,253,411,,,0,1,1,,,,,,
249,255,436,249,254,436,,,0,1,0,,,,,,
250,256,461,250,255,461,,,0,1,0,,,,,,
251,257,486,251,257,486,,,0,0,0,,,,,,
252,258,511,252,258,511,,,0,0,0,,,,,,
253,259,536,253,259,536,,,0,0,0,,,,,,
254,260,561,254,260,561,,,0,0,0,,,,,,
255,261,586,255,261,586,,,0,0,0,,,,,,
256,262,611,256,263,611,,,0,-1,0,,,,,,
258,264,636,258,264,636,,,0,0,0,,,,,,
259,265,662,259,265,661,,,0,0,1,,,,,,
260,267,687,260,267,686,,,0,0,1,,,,,,
262,268,712,262,268,712,,,0,0,0,,,,,,
263,270,738,263,270,737,,,0,0,1,,,,,,
265,271,763,265,271,763,,,0,0,0,,,,,,
250,275,78,250,275,78,,,0,0,0,,,,,,
250,275,80,250,275,78,,,0,0,2,,,,,,
250,275,88,250,275,88,,,0,0,0,,,,,,
250,275,100,250,275,102,,,0,0,-2,,,,,,
250,275,116,250,275,116,,,0,0,0,,,,,,
250,275,135,250,275,135,,,0,0,0,,,,,,
250,275,155,250,275,155,,,0,0,0,,,,,,
251,275,177,250,275,177,,,1,0,0,,,,,,
251,276,199,251,276,199,,,0,0,0,,,,,,
251,276,221,251,276,221,,,0,0,0,,,,,,
252,276,244,252,276,244,,,0,0,0,,,,,,
252,277,268,252,276,267,,,0,1,1,,,,,,
253,277,291,253,277,291,,,0,0,0,,,,,,
253,278,315,253,277,315,,,0,1,0,,,,,,
254,278,339,254,278,339,,,0,0,0,,,,,,
255,279,364,254,279,363,,,1,0,1,,,,,,
255,280,388,255,280,388,,,0,0,0,,,,,,
256,281,413,256,280,412,,,0,1,1,,,,,,
257,281,437,257,281,437,,,0,0,0,,,,,,
258,282,462,258,282,462,,,0,0,0,,,,,,
259,283,487,259,283,487,,,0,0,0,,,,,,
260,284,512,260,284,512,,,0,0,0,,,,,,
261,285,537,261,285,537,,,0,0,0,,,,,,
262,286,562,262,286,562,,,0,0,0,,,,,,
263,287,587,263,287,587,,,0,0,0,,,,,,
264,288,612,264,288,612,,,0,0,0,,,,,,
266,290,637,266,290,637,,,0,0,0,,,,,,
267,291,662,267,291,662,,,0,0,0,,,,,,
268,292,687,268,292,687,,,0,0,0,,,,,,
270,294,713,269,293,712,,,1,1,1,,,,,,
271,295,738,271,295,738,,,0,0,0,,,,,,
273,296,764,272,296,763,,,1,0,1,,,,,,
259,302,85,259,302,85,,,0,0,0,,,,,,
259,302,87,259,302,85,,,0,0,2,,,,,,
259,302,94,259,302,94,,,0,0,0,,,,,,
259,302,106,259,302,107,,,0,0,-1,,,,,,
259,302,121,259,302,121,,,0,0,0,,,,,,
259,303,139,259,302,139,,,0,1,0,,,,,,
260,303,159,259,303,158,,,1,0,1,,,,,,
260,303,180,260,303,180,,,0,0,0,,,,,,
260,303,201,260,303,201,,,0,0,0,,,,,,
260,304,224,261,303,224,,,-1,1,0,,,,,,
261,304,246,261,304,246,,,0,0,0,,,,,,
261,304,270,262,304,269,,,-1,0,1,,,,,,
262,305,293,262,304,293,,,0,1,0,,,,,,
262,305,317,263,305,316,,,-1,0,1,,,,,,
263,306,341,263,305,340,,,0,1,1,,,,,,
264,306,365,264,306,365,,,0,0,0,,,,,,
264,307,389,264,307,389,,,0,0,0,,,,,,
265,308,414,265,307,413,,,0,1,1,,,,,,
266,308,438,266,308,438,,,0,0,0,,,,,,
267,309,463,267,309,463,,,0,0,0,,,,,,
268,310,488,268,310,488,,,0,0,0,,,,,,
269,311,512,269,311,512,,,0,0,0,,,,,,
270,312,537,270,312,537,,,0,0,0,,,,,,
271,313,562,271,313,562,,,0,0,0,,,,,,
272,314,587,272,314,587,,,0,0,0,,,,,,
273,315,612,273,315,612,,,0,0,0,,,,,,
274,316,638,275,316,637,,,-1,0,1,,,,,,
275,317,663,276,317,662,,,-1,0,1,,,,,,
277,318,688,277,318,688,,,0,0,0,,,,,,
278,319,713,278,319,713,,,0,0,0,,,,,,
280,321,739,280,321,738,,,0,0,1,,,,,,
281,322,764,281,322,764,,,0,0,0,,,,,,
269,330,92,269,330,92,,,0,0,0,,,,,,
269,330,94,269,330,92,,,0,0,2,,,,,,
269,330,100,269,330,100,,,0,0,0,,,,,,
269,330,111,269,330,113,,,0,0,-2,,,,,,
269,330,126,269,330,126,,,0,0,0,,,,,,
269,331,143,269,330,144,,,0,1,-1,,,,,,
269,331,162,269,331,162,,,0,0,0,,,,,,
270,331,183,269,331,183,,,1,0,0,,,,,,
270,331,204,270,331,204,,,0,0,0,,,,,,
270,331,226,270,331,226,,,0,0,0,,,,,,
271,332,249,271,332,249,,,0,0,0,,,,,,
271,332,272,271,332,272,,,0,0,0,,,,,,
272,332,295,272,332,295,,,0,0,0,,,,,,
272,333,319,272,332,318,,,0,1,1,,,,,,
273,333,342,273,333,342,,,0,0,0,,,,,,
273,334,366,273,333,366,,,0,1,0,,,,,,
274,334,391,274,334,391,,,0,0,0,,,,,,
275,335,415,274,335,415,,,1,0,0,,,,,,
275,336,439,275,336,439,,,0,0,0,,,,,,
276,336,464,276,336,464,,,0,0,0,,,,,,
277,337,489,277,337,489,,,0,0,0,,,,,,
278,338,513,278,338,513,,,0,0,0,,,,,,
279,339,538,279,339,538,,,0,0,0,,,,,,
280,340,563,280,340,563,,,0,0,0,,,,,,
281,341,588,281,341,588,,,0,0,0,,,,,,
282,342,613,282,342,613,,,0,0,0,,,,,,
284,343,638,284,343,638,,,0,0,0,,,,,,
285,344,664,285,344,663,,,0,0,1,,,,,,
286,345,689,286,345,689,,,0,0,0,,,,,,
287,346,714,287,346,714,,,0,0,0,,,,,,
289,347,739,289,347,739,,,0,0,0,,,,,,
290,348,765,290,348,764,,,0,0,1,,,,,,
279,358,99,279,358,99,,,0,0,0,,,,,,
279,358,101,279,358,99,,,0,0,2,,,,,,
279,358,107,279,358,106,,,0,0,1,,,,,,
280,358,117,279,358,119,,,1,0,-2,,,,,,
280,358,131,280,358,131,,,0,0,0,,,,,,
280,359,148,280,358,148,,,0,1,0,,,,,,
280,359,166,280,359,166,,,0,0,0,,,,,,
280,359,186,280,359,186,,,0,0,0,,,,,,
280,359,207,280,359,207,,,0,0,0,,,,,,
281,359,229,281,359,229,,,0,0,0,,,,,,
281,360,251,281,360,251,,,0,0,0,,,,,,
282,360,274,282,360,274,,,0,0,0,,,,,,
282,360,297,282,360,297,,,0,0,0,,,,,,
283,361,320,283,360,320,,,0,1,0,,,,,,
283,361,344,283,361,344,,,0,0,0,,,,,,
284,362,368,284,361,368,,,0,1,0,,,,,,
284,362,392,284,362,392,,,0,0,0,,,,,,
285,363,416,285,362,416,,,0,1,0,,,,,,
286,363,441,286,363,440,,,0,0,1,,,,,,
287,364,465,286,364,465,,,1,0,0,,,,,,
287,365,490,287,364,490,,,0,1,0,,,,,,
288,365,515,288,365,514,,,0,0,1,,,,,,
289,366,539,289,366,539,,,0,0,0,,,,,,
290,367,564,290,367,564,,,0,0,0,,,,,,
291,368,589,291,368,589,,,0,0,0,,,,,,
292,369,614,292,369,614,,,0,0,0,,,,,,
293,370,639,294,370,639,,,-1,0,0,,,,,,
295,371,664,295,371,664,,,0,0,0,,,,,,
296,372,690,296,372,690,,,0,0,0,,,,,,
297,373,715,297,373,715,,,0,0,0,,,,,,
298,374,740,299,374,740,,,-1,0,0,,,,,,
300,375,766,300,375,765,,,0,0,1,,,,,,
290,386,106,290,386,106,,,0,0,0,,,,,,
290,387,108,290,386,106,,,0,1,2,,,,,,
290,387,113,290,387,113,,,0,0,0,,,,,,
291,387,123,290,387,125,,,1,0,-2,,,,,,
291,387,137,291,387,137,,,0,0,0,,,,,,
291,387,152,291,387,153,,,0,0,-1,,,,,,
291,387,170,291,387,170,,,0,0,0,,,,,,
291,387,190,291,387,190,,,0,0,0,,,,,,
291,387,210,291,387,210,,,0,0,0,,,,,,
292,388,232,291,387,232,,,1,1,0,,,,,,
292,388,254,292,388,254,,,0,0,0,,,,,,
293,388,276,292,388,276,,,1,0,0,,,,,,
293,388,299,293,388,299,,,0,0,0,,,,,,
293,389,323,293,388,322,,,0,1,1,,,,,,
294,389,346,294,389,346,,,0,0,0,,,,,,
295,390,370,294,389,370,,,1,1,0,,,,,,
295,390,394,295,390,394,,,0,0,0,,,,,,
296,391,418,296,390,418,,,0,1,0,,,,,,
297,391,442,297,391,442,,,0,0,0,,,,,,
297,392,467,297,391,466,,,0,1,1,,,,,,
298,392,491,298,392,491,,,0,0,0,,,,,,
299,393,516,299,393,515,,,0,0,1,,,,,,
300,394,540,300,394,540,,,0,0,0,,,,,,
301,394,565,301,394,565,,,0,0,0,,,,,,
302,395,590,302,395,590,,,0,0,0,,,,,,
303,396,615,303,396,615,,,0,0,0,,,,,,
304,397,640,304,397,640,,,0,0,0,,,,,,
305,398,665,305,398,665,,,0,0,0,,,,,,
306,399,691,306,399,691,,,0,0,0,,,,,,
307,400,716,307,400,716,,,0,0,0,,,,,,
309,401,741,309,401,741,,,0,0,0,,,,,,
310,402,766,310,402,766,,,0,0,0,,,,,,
302,415,114,302,414,113,,,0,1,1,,,,,,
302,415,115,302,414,113,,,0,1,2,,,,,,
302,415,120,302,415,120,,,0,0,0,,,,,,
302,415,130,302,415,131,,,0,0,-1,,,,,,
302,415,142,302,415,142,,,0,0,0,,,,,,
302,415,157,302,415,158,,,0,0,-1,,,,,,
302,415,175,302,415,175,,,0,0,0,,,,,,
303,415,194,302,415,194,,,1,0,0,,,,,,
303,416,214,303,415,214,,,0,1,0,,,,,,
303,416,235,303,415,235,,,0,1,0,,,,,,
304,416,257,303,416,257,,,1,0,0,,,,,,
304,416,279,304,416,279,,,0,0,0,,,,,,
304,417,302,304,416,301,,,0,1,1,,,,,,
305,417,325,305,417,324,,,0,0,1,,,,,,
305,417,348,305,417,348,,,0,0,0,,,,,,
306,418,372,306,417,371,,,0,1,1,,,,,,
306,418,396,306,418,395,,,0,0,1,,,,,,
307,419,420,307,418,419,,,0,1,1,,,,,,
308,419,444,308,419,443,,,0,0,1,,,,,,
309,420,468,308,419,468,,,1,1,0,,,,,,
309,420,493,309,420,492,,,0,0,1,,,,,,
310,421,517,310,421,517,,,0,0,0,,,,,,
311,422,542,311,422,541,,,0,0,1,,,,,,
312,422,566,312,422,566,,,0,0,0,,,,,,
313,423,591,313,423,591,,,0,0,0,,,,,,
314,424,616,314,423,616,,,0,1,0,,,,,,
315,425,641,315,424,641,,,0,1,0,,,,,,
316,425,666,316,425,666,,,0,0,0,,,,,,
317,426,691,317,426,691,,,0,0,0,,,,,,
318,427,717,318,427,716,,,0,0,1,,,,,,
320,428,742,320,428,742,,,0,0,0,,,,,,
321,429,767,321,429,767,,,0,0,0,,,,,,
314,443,121,314,443,121,,,0,0,0,,,,,,
314,443,122,314,443,121,,,0,0,1,,,,,,
314,443,127,314,443,127,,,0,0,0,,,,,,
314,443,136,314,443,137,,,0,0,-1,,,,,,
314,443,148,314,443,148,,,0,0,0,,,,,,
314,444,163,314,443,164,,,0,1,-1,,,,,,
314,444,180,314,444,180,,,0,0,0,,,,,,
315,444,198,314,444,199,,,1,0,-1,,,,,,
315,444,218,315,444,218,,,0,0,0,,,,,,
315,444,238,315,444,239,,,0,0,-1,,,,,,
315,444,260,315,444,260,,,0,0,0,,,,,,
316,445,282,315,444,282,,,1,1,0,,,,,,
316,445,304,316,445,304,,,0,0,0,,,,,,
317,445,327,316,445,327,,,1,0,0,,,,,,
317,446,350,317,446,350,,,0,0,0,,,,,,
318,446,374,317,446,373,,,1,0,1,,,,,,
318,446,397,318,446,397,,,0,0,0,,,,,,
319,447,421,318,446,421,,,1,1,0,,,,,,
319,447,445,319,447,445,,,0,0,0,,,,,,
320,448,470,320,447,469,,,0,1,1,,,,,,
321,448,494,321,448,494,,,0,0,0,,,,,,
322,449,518,322,449,518,,,0,0,0,,,,,,
323,450,543,323,450,543,,,0,0,0,,,,,,
323,450,568,323,450,568,,,0,0,0,,,,,,
324,451,593,324,451,593,,,0,0,0,,,,,,
325,452,617,325,451,617,,,0,1,0,,,,,,
326,452,642,326,452,642,,,0,0,0,,,,,,
327,453,667,327,453,667,,,0,0,0,,,,,,
328,454,692,328,454,692,,,0,0,0,,,,,,
330,455,718,329,455,717,,,1,0,1,,,,,,
331,456,743,331,456,743,,,0,0,0,,,,,,
332,456,768,332,456,768,,,0,0,0,,,,,,
326,472,128,326,472,128,,,0,0,0,,,,,,
326,472,130,326,472,128,,,0,0,2,,,,,,
326,472,134,326,472,134,,,0,0,0,,,,,,
326,472,143,326,472,144,,,0,0,-1,,,,,,
326,472,154,326,472,154,,,0,0,0,,,,,,
327,472,168,326,472,169,,,1,0,-1,,,,,,
327,472,184,326,472,185,,,1,0,-1,,,,,,
327,472,202,327,472,203,,,0,0,-1,,,,,,
327,472,222,327,472,222,,,0,0,0,,,,,,
327,473,242,327,472,242,,,0,1,0,,,,,,
328,473,263,327,472,263,,,1,1,0,,,,,,
328,473,285,328,473,285,,,0,0,0,,,,,,
328,473,307,328,473,307,,,0,0,0,,,,,,
329,474,330,329,474,329,,,0,0,1,,,,,,
329,474,353,329,474,352,,,0,0,1,,,,,,
330,474,376,330,474,376,,,0,0,0,,,,,,
330,475,399,330,474,399,,,0,1,0,,,,,,
331,475,423,331,475,423,,,0,0,0,,,,,,
332,476,447,331,475,447,,,1,1,0,,,,,,
332,476,471,332,476,471,,,0,0,0,,,,,,
333,477,496,333,476,495,,,0,1,1,,,,,,
334,477,520,334,477,520,,,0,0,0,,,,,,
335,478,545,335,478,544,,,0,0,1,,,,,,
335,478,569,335,478,569,,,0,0,0,,,,,,
336,479,594,336,479,594,,,0,0,0,,,,,,
337,480,619,337,479,618,,,0,1,1,,,,,,
338,480,644,338,480,643,,,0,0,1,,,,,,
339,481,669,339,481,668,,,0,0,1,,,,,,
340,482,694,340,482,693,,,0,0,1,,,,,,
341,483,719,341,482,718,,,0,1,1,,,,,,
342,483,744,343,483,744,,,-1,0,0,,,,,,
344,484,769,344,484,769,,,0,0,0,,,,,,
339,501,136,339,501,136,,,0,0,0,,,,,,
339,501,137,339,501,136,,,0,0,1,,,,,,
339,501,142,339,501,142,,,0,0,0,,,,,,
339,501,149,339,501,151,,,0,0,-2,,,,,,
339,501,160,339,501,160,,,0,0,0,,,,,,
339,501,174,339,501,175,,,0,0,-1,,,,,,
339,501,190,339,501,190,,,0,0,0,,,,,,
340,501,207,339,501,208,,,1,0,-1,,,,,,
340,501,226,340,501,226,,,0,0,0,,,,,,
340,501,246,340,501,246,,,0,0,0,,,,,,
340,501,266,340,501,266,,,0,0,0,,,,,,
341,502,288,340,501,288,,,1,1,0,,,,,,
341,502,310,341,502,310,,,0,0,0,,,,,,
341,502,332,341,502,332,,,0,0,0,,,,,,
342,503,355,342,503,355,,,0,0,0,,,,,,
342,503,378,342,503,378,,,0,0,0,,,,,,
343,503,402,343,503,402,,,0,0,0,,,,,,
343,504,425,343,503,425,,,0,1,0,,,,,,
344,504,449,344,504,449,,,0,0,0,,,,,,
345,504,473,344,504,473,,,1,0,0,,,,,,
345,505,497,345,505,497,,,0,0,0,,,,,,
346,505,522,346,505,521,,,0,0,1,,,,,,
347,506,546,347,506,546,,,0,0,0,,,,,,
348,507,571,348,506,570,,,0,1,1,,,,,,
349,507,595,349,507,595,,,0,0,0,,,,,,
349,508,620,349,507,620,,,0,1,0,,,,,,
350,508,645,350,508,645,,,0,0,0,,,,,,
351,509,670,351,509,670,,,0,0,0,,,,,,
352,510,695,352,510,695,,,0,0,0,,,,,,
353,511,720,353,510,720,,,0,1,0,,,,,,
355,511,745,355,511,745,,,0,0,0,,,,,,
356,512,770,356,512,770,,,0,0,0,,,,,,
352,529,143,352,529,143,,,0,0,0,,,,,,
352,529,145,352,529,143,,,0,0,2,,,,,,
352,529,149,352,529,149,,,0,0,0,,,,,,
352,529,156,352,529,157,,,0,0,-1,,,,,,
352,529,167,352,529,166,,,0,0,1,,,,,,
352,529,180,352,529,180,,,0,0,0,,,,,,
352,530,195,352,529,195,,,0,1,0,,,,,,
353,530,212,352,529,212,,,1,1,0,,,,,,
353,530,230,353,530,230,,,0,0,0,,,,,,
353,530,250,353,530,250,,,0,0,0,,,,,,
353,530,270,353,530,270,,,0,0,0,,,,,,
354,530,291,353,530,291,,,1,0,0,,,,,,
354,531,313,354,530,313,,,0,1,0,,,,,,
354,531,335,354,531,335,,,0,0,0,,,,,,
355,531,358,355,531,358,,,0,0,0,,,,,,
355,531,381,355,531,381,,,0,0,0,,,,,,
356,532,404,356,531,404,,,0,1,0,,,,,,
356,532,427,356,532,427,,,0,0,0,,,,,,
357,533,451,357,532,451,,,0,1,0,,,,,,
358,533,475,357,533,475,,,1,0,0,,,,,,
358,533,499,358,533,499,,,0,0,0,,,,,,
359,534,523,359,534,523,,,0,0,0,,,,,,
360,534,548,360,534,547,,,0,0,1,,,,,,
360,535,572,360,535,572,,,0,0,0,,,,,,
361,535,597,361,535,596,,,0,0,1,,,,,,
362,536,621,362,536,621,,,0,0,0,,,,,,
363,537,646,363,536,646,,,0,1,0,,,,,,
364,537,671,364,537,671,,,0,0,0,,,,,,
365,538,696,365,538,696,,,0,0,0,,,,,,
366,539,721,366,538,721,,,0,1,0,,,,,,
367,539,746,367,539,746,,,0,0,0,,,,,,
368,540,771,368,540,771,,,0,0,0,,,,,,
365,558,151,365,558,151,,,0,0,0,,,,,,
365,558,152,365,558,151,,,0,0,1,,,,,,
365,558,156,365,558,156,,,0,0,0,,,,,,
365,558,163,365,558,164,,,0,0,-1,,,,,,
365,558,173,365,558,173,,,0,0,0,,,,,,
366,558,186,365,558,186,,,1,0,0,,,,,,
366,558,200,366,558,200,,,0,0,0,,,,,,
366,558,217,366,558,217,,,0,0,0,,,,,,
366,559,235,366,559,235,,,0,0,0,,,,,,
366,559,254,366,559,254,,,0,0,0,,,,,,
367,559,274,367,559,274,,,0,0,0,,,,,,
367,559,295,367,559,295,,,0,0,0,,,,,,
367,559,316,367,559,316,,,0,0,0,,,,,,
368,560,338,367,559,338,,,1,1,0,,,,,,
368,560,361,368,560,361,,,0,0,0,,,,,,
368,560,383,368,560,383,,,0,0,0,,,,,,
369,560,406,369,560,406,,,0,0,0,,,,,,
369,561,430,369,560,429,,,0,1,1,,,,,,
370,561,453,370,561,453,,,0,0,0,,,,,,
371,562,477,370,561,477,,,1,1,0,,,,,,
371,562,501,371,562,501,,,0,0,0,,,,,,
372,562,525,372,562,525,,,0,0,0,,,,,,
373,563,549,373,563,549,,,0,0,0,,,,,,
373,563,574,373,563,573,,,0,0,1,,,,,,
374,564,598,374,564,598,,,0,0,0,,,,,,
375,564,623,375,564,623,,,0,0,0,,,,,,
376,565,648,376,565,648,,,0,0,0,,,,,,
377,566,672,377,565,672,,,0,1,0,,,,,,
378,566,697,378,566,697,,,0,0,0,,,,,,
379,567,722,379,567,722,,,0,0,0,,,,,,
380,568,747,380,568,747,,,0,0,0,,,,,,
381,568,772,381,568,772,,,0,0,0,,,,,,
379,587,159,379,587,158,,,0,0,1,,,,,,
379,587,160,379,587,158,,,0,0,2,,,,,,
379,587,163,379,587,163,,,0,0,0,,,,,,
379,587,170,379,587,171,,,0,0,-1,,,,,,
379,587,180,379,587,179,,,0,0,1,,,,,,
379,587,192,379,587,192,,,0,0,0,,,,,,
379,587,206,379,587,206,,,0,0,0,,,,,,
379,587,222,379,587,222,,,0,0,0,,,,,,
380,587,240,379,587,239,,,1,0,1,,,,,,
380,588,258,380,587,258,,,0,1,0,,,,,,
380,588,278,380,588,278,,,0,0,0,,,,,,
380,588,298,380,588,298,,,0,0,0,,,,,,
381,588,320,380,588,319,,,1,0,1,,,,,,
381,588,341,381,588,341,,,0,0,0,,,,,,
381,589,364,381,588,364,,,0,1,0,,,,,,
382,589,386,382,588,386,,,0,1,0,,,,,,
382,589,409,382,589,409,,,0,0,0,,,,,,
383,590,432,383,589,432,,,0,1,0,,,,,,
383,590,456,383,590,455,,,0,0,1,,,,,,
384,590,479,384,590,479,,,0,0,0,,,,,,
385,591,503,384,590,503,,,1,1,0,,,,,,
385,591,527,385,591,527,,,0,0,0,,,,,,
386,592,551,386,591,551,,,0,1,0,,,,,,
387,592,576,386,592,575,,,1,0,1,,,,,,
387,592,600,387,592,600,,,0,0,0,,,,,,
388,593,625,388,593,624,,,0,0,1,,,,,,
389,594,649,389,593,649,,,0,1,0,,,,,,
390,594,674,390,594,674,,,0,0,0,,,,,,
391,595,699,391,594,698,,,0,1,1,,,,,,
392,595,724,392,595,723,,,0,0,1,,,,,,
393,596,749,393,596,748,,,0,0,1,,,,,,
394,597,774,394,596,773,,,0,1,1,,,,,,
393,616,166,393,616,166,,,0,0,0,,,,,,
393,616,167,393,616,166,,,0,0,1,,,,,,
393,616,171,393,616,171,,,0,0,0,,,,,,
393,616,177,393,616,178,,,0,0,-1,,,,,,
393,616,186,393,616,186,,,0,0,0,,,,,,
393,616,198,393,616,199,,,0,0,-1,,,,,,
393,616,212,393,616,212,,,0,0,0,,,,,,
393,616,227,393,616,228,,,0,0,-1,,,,,,
393,616,244,393,616,244,,,0,0,0,,,,,,
394,616,263,393,616,263,,,1,0,0,,,,,,
394,617,282,394,617,282,,,0,0,0,,,,,,
394,617,302,394,617,302,,,0,0,0,,,,,,
394,617,323,394,617,323,,,0,0,0,,,,,,
395,617,345,394,617,345,,,1,0,0,,,,,,
395,617,367,395,617,367,,,0,0,0,,,,,,
396,618,389,395,617,389,,,1,1,0,,,,,,
396,618,412,396,618,412,,,0,0,0,,,,,,
396,618,435,396,618,435,,,0,0,0,,,,,,
397,619,458,397,619,458,,,0,0,0,,,,,,
398,619,482,397,619,481,,,1,0,1,,,,,,
398,619,505,398,619,505,,,0,0,0,,,,,,
399,620,529,398,619,529,,,1,1,0,,,,,,
399,620,553,399,620,553,,,0,0,0,,,,,,
400,621,577,400,620,577,,,0,1,0,,,,,,
401,621,602,401,621,602,,,0,0,0,,,,,,
402,622,626,401,621,626,,,1,1,0,,,,,,
402,622,651,402,622,651,,,0,0,0,,,,,,
403,623,676,403,622,675,,,0,1,1,,,,,,
404,623,700,404,623,700,,,0,0,0,,,,,,
405,624,725,405,623,725,,,0,1,0,,,,,,
406,624,750,406,624,750,,,0,0,0,,,,,,
407,625,775,407,625,775,,,0,0,0,,,,,,
407,645,174,407,645,174,,,0,0,0,,,,,,
407,645,175,407,645,174,,,0,0,1,,,,,,
407,645,178,407,645,178,,,0,0,0,,,,,,
407,645,184,407,645,185,,,0,0,-1,,,,,,
407,645,193,407,645,193,,,0,0,0,,,,,,
407,645,204,407,645,205,,,0,0,-1,,,,,,
407,645,218,407,645,218,,,0,0,0,,,,,,
407,645,233,407,645,233,,,0,0,0,,,,,,
407,645,249,407,645,249,,,0,0,0,,,,,,
408,645,267,407,645,268,,,1,0,-1,,,,,,
408,646,286,408,646,286,,,0,0,0,,,,,,
408,646,306,408,646,306,,,0,0,0,,,,,,
408,646,327,408,646,327,,,0,0,0,,,,,,
409,646,348,408,646,348,,,1,0,0,,,,,,
409,646,370,409,646,370,,,0,0,0,,,,,,
409,647,392,409,646,392,,,0,1,0,,,,,,
410,647,415,410,647,415,,,0,0,0,,,,,,
410,647,437,410,647,437,,,0,0,0,,,,,,
411,648,461,411,648,460,,,0,0,1,,,,,,
411,648,484,411,648,484,,,0,0,0,,,,,,
412,648,508,412,648,507,,,0,0,1,,,,,,
412,649,531,412,648,531,,,0,1,0,,,,,,
413,649,555,413,649,555,,,0,0,0,,,,,,
414,649,579,413,649,579,,,1,0,0,,,,,,
414,650,604,414,650,604,,,0,0,0,,,,,,
415,650,628,415,650,628,,,0,0,0,,,,,,
416,651,653,416,651,652,,,0,0,1,,,,,,
417,651,677,416,651,677,,,1,0,0,,,,,,
418,652,702,417,652,702,,,1,0,0,,,,,,
418,652,727,418,652,726,,,0,0,1,,,,,,
419,653,752,419,653,751,,,0,0,1,,,,,,
420,654,776,420,653,776,,,0,1,0,,,,,,
421,674,182,421,674,182,,,0,0,0,,,,,,
421,674,183,421,674,182,,,0,0,1,,,,,,
421,674,186,421,674,186,,,0,0,0,,,,,,
421,674,192,421,674,193,,,0,0,-1,,,,,,
421,674,200,421,674,200,,,0,0,0,,,,,,
421,674,211,421,674,212,,,0,0,-1,,,,,,
421,674,224,421,674,224,,,0,0,0,,,,,,
421,674,238,421,674,239,,,0,0,-1,,,,,,
421,674,255,421,674,255,,,0,0,0,,,,,,
422,675,272,421,674,273,,,1,1,-1,,,,,,
422,675,291,422,675,291,,,0,0,0,,,,,,
422,675,311,422,675,311,,,0,0,0,,,,,,
422,675,331,422,675,331,,,0,0,0,,,,,,
423,675,352,422,675,352,,,1,0,0,,,,,,
423,675,373,423,675,373,,,0,0,0,,,,,,
423,676,395,423,675,395,,,0,1,0,,,,,,
424,676,418,424,676,418,,,0,0,0,,,,,,
424,676,440,424,676,440,,,0,0,0,,,,,,
425,677,463,425,677,463,,,0,0,0,,,,,,
425,677,486,425,677,486,,,0,0,0,,,,,,
426,677,510,426,677,510,,,0,0,0,,,,,,
426,678,534,426,677,533,,,0,1,1,,,,,,
427,678,557,427,678,557,,,0,0,0,,,,,,
428,678,582,427,678,581,,,1,0,1,,,,,,
428,679,606,428,679,606,,,0,0,0,,,,,,
429,679,630,429,679,630,,,0,0,0,,,,,,
430,680,654,430,680,654,,,0,0,0,,,,,,
431,680,679,430,680,679,,,1,0,0,,,,,,
431,681,704,431,681,704,,,0,0,0,,,,,,
432,681,728,432,681,728,,,0,0,0,,,,,,
433,682,753,433,682,753,,,0,0,0,,,,,,
434,682,778,434,682,778,,,0,0,0,,,,,,
435,703,189,435,703,189,,,0,0,0,,,,,,
435,703,190,435,703,189,,,0,0,1,,,,,,
435,703,193,435,703,193,,,0,0,0,,,,,,
435,703,199,435,703,200,,,0,0,-1,,,,,,
435,703,207,435,703,207,,,0,0,0,,,,,,
435,703,217,435,703,218,,,0,0,-1,,,,,,
435,703,230,435,703,230,,,0,0,0,,,,,,
436,703,244,435,703,245,,,1,0,-1,,,,,,
436,704,260,435,703,260,,,1,1,0,,,,,,
436,704,277,436,703,278,,,0,1,-1,,,,,,
436,704,296,436,704,295,,,0,0,1,,,,,,
436,704,315,436,704,315,,,0,0,0,,,,,,
437,704,335,436,704,335,,,1,0,0,,,,,,
437,704,356,437,704,355,,,0,0,1,,,,,,
437,704,377,437,704,376,,,0,0,1,,,,,,
438,705,399,438,704,398,,,0,1,1,,,,,,
438,705,421,438,705,421,,,0,0,0,,,,,,
439,705,443,438,705,443,,,1,0,0,,,,,,
439,706,466,439,706,466,,,0,0,0,,,,,,
440,706,489,439,706,489,,,1,0,0,,,,,,
440,706,512,440,706,512,,,0,0,0,,,,,,
441,706,536,440,706,536,,,1,0,0,,,,,,
441,707,560,441,707,559,,,0,0,1,,,,,,
442,707,584,441,707,583,,,1,0,1,,,,,,
442,708,608,442,708,608,,,0,0,0,,,,,,
443,708,632,443,708,632,,,0,0,0,,,,,,
444,709,656,444,708,656,,,0,1,0,,,,,,
445,709,681,444,709,680,,,1,0,1,,,,,,
445,709,705,445,709,705,,,0,0,0,,,,,,
446,710,730,446,710,730,,,0,0,0,,,,,,
447,711,755,447,710,754,,,0,1,1,,,,,,
448,711,780,448,711,779,,,0,0,1,,,,,,
450,732,197,450,732,197,,,0,0,0,,,,,,
450,732,198,450,732,197,,,0,0,1,,,,,,
450,732,201,450,732,201,,,0,0,0,,,,,,
450,732,206,450,732,207,,,0,0,-1,,,,,,
450,732,214,450,732,214,,,0,0,0,,,,,,
450,732,224,450,732,225,,,0,0,-1,,,,,,
450,732,236,450,732,236,,,0,0,0,,,,,,
450,733,250,450,732,251,,,0,1,-1,,,,,,
450,733,266,450,733,266,,,0,0,0,,,,,,
450,733,282,450,733,283,,,0,0,-1,,,,,,
451,733,300,451,733,300,,,0,0,0,,,,,,
451,733,319,451,733,319,,,0,0,0,,,,,,
451,733,339,451,733,339,,,0,0,0,,,,,,
451,733,359,451,733,359,,,0,0,0,,,,,,
452,734,380,452,734,380,,,0,0,0,,,,,,
452,734,402,452,734,402,,,0,0,0,,,,,,
453,734,424,453,734,424,,,0,0,0,,,,,,
453,734,446,453,734,446,,,0,0,0,,,,,,
453,735,469,453,735,469,,,0,0,0,,,,,,
454,735,492,453,735,492,,,1,0,0,,,,,,
454,735,515,454,735,515,,,0,0,0,,,,,,
455,736,538,454,735,538,,,1,1,0,,,,,,
455,736,562,455,736,562,,,0,0,0,,,,,,
456,736,586,456,736,586,,,0,0,0,,,,,,
457,737,610,457,737,610,,,0,0,0,,,,,,
457,737,634,457,737,634,,,0,0,0,,,,,,
458,737,658,458,737,658,,,0,0,0,,,,,,
459,738,683,459,737,682,,,0,1,1,,,,,,
460,738,707,460,738,707,,,0,0,0,,,,,,
460,739,732,460,738,731,,,0,1,1,,,,,,
461,739,756,461,739,756,,,0,0,0,,,,,,
462,740,781,462,739,781,,,0,1,0,,,,,,
464,762,205,464,761,205,,,0,1,0,,,,,,
464,762,206,464,761,205,,,0,1,1,,,,,,
464,762,208,464,761,208,,,0,1,0,,,,,,
464,762,214,464,761,214,,,0,1,0,,,,,,
464,762,221,464,761,221,,,0,1,0,,,,,,
465,762,231,464,761,231,,,1,1,0,,,,,,
465,762,242,464,761,242,,,1,1,0,,,,,,
465,762,256,464,761,257,,,1,1,-1,,,,,,
465,762,271,465,762,271,,,0,0,0,,,,,,
465,762,288,465,762,288,,,0,0,0,,,,,,
465,762,305,465,762,305,,,0,0,0,,,,,,
466,762,324,465,762,324,,,1,0,0,,,,,,
466,762,343,466,762,343,,,0,0,0,,,,,,
466,763,363,466,762,363,,,0,1,0,,,,,,
466,763,384,466,763,384,,,0,0,0,,,,,,
467,763,406,467,763,405,,,0,0,1,,,,,,
467,763,427,467,763,427,,,0,0,0,,,,,,
468,763,449,467,763,449,,,1,0,0,,,,,,
468,764,472,468,764,472,,,0,0,0,,,,,,
468,764,495,468,764,495,,,0,0,0,,,,,,
469,764,518,469,764,518,,,0,0,0,,,,,,
469,765,541,469,764,541,,,0,1,0,,,,,,
470,765,565,470,765,564,,,0,0,1,,,,,,
471,765,588,470,765,588,,,1,0,0,,,,,,
471,766,612,471,766,612,,,0,0,0,,,,,,
472,766,636,472,766,636,,,0,0,0,,,,,,
472,766,660,472,766,660,,,0,0,0,,,,,,
473,767,685,473,766,684,,,0,1,1,,,,,,
474,767,709,474,767,709,,,0,0,0,,,,,,
475,768,734,474,767,733,,,1,1,1,,,,,,
475,768,758,475,768,758,,,0,0,0,,,,,,
476,769,783,476,768,782,,,0,1,1,,,,,,
479,791,213,479,791,213,,,0,0,0,,,,,,
479,791,213,479,791,213,,,0,0,0,,,,,,
479,791,216,479,791,216,,,0,0,0,,,,,,
479,791,221,479,791,222,,,0,0,-1,,,,,,
479,791,228,479,791,228,,,0,0,0,,,,,,
479,791,238,479,791,238,,,0,0,0,,,,,,
479,791,249,479,791,249,,,0,0,0,,,,,,
480,791,262,479,791,263,,,1,0,-1,,,,,,
480,791,277,480,791,277,,,0,0,0,,,,,,
480,791,293,480,791,293,,,0,0,0,,,,,,
480,791,310,480,791,310,,,0,0,0,,,,,,
480,792,329,480,791,329,,,0,1,0,,,,,,
481,792,348,481,792,348,,,0,0,0,,,,,,
481,792,368,481,792,368,,,0,0,0,,,,,,
481,792,388,481,792,388,,,0,0,0,,,,,,
481,792,409,481,792,409,,,0,0,0,,,,,,
482,792,431,482,792,431,,,0,0,0,,,,,,
482,793,453,482,792,453,,,0,1,0,,,,,,
483,793,475,483,793,475,,,0,0,0,,,,,,
483,793,498,483,793,498,,,0,0,0,,,,,,
484,793,521,484,793,521,,,0,0,0,,,,,,
484,794,544,484,793,544,,,0,1,0,,,,,,
485,794,567,485,794,567,,,0,0,0,,,,,,
485,794,591,485,794,590,,,0,0,1,,,,,,
486,795,614,486,795,614,,,0,0,0,,,,,,
486,795,638,486,795,638,,,0,0,0,,,,,,
487,796,662,487,796,662,,,0,0,0,,,,,,
488,796,687,487,796,686,,,1,0,1,,,,,,
488,796,711,488,796,711,,,0,0,0,,,,,,
489,797,735,489,796,735,,,0,1,0,,,,,,
490,797,760,490,797,760,,,0,0,0,,,,,,
491,798,785,490,797,784,,,1,1,1,,,,,,
494,820,220,494,820,220,,,0,0,0,,,,,,
494,820,221,494,820,220,,,0,0,1,,,,,,
494,820,224,494,820,223,,,0,0,1,,,,,,
494,820,228,494,820,229,,,0,0,-1,,,,,,
494,820,235,494,820,235,,,0,0,0,,,,,,
494,820,244,494,820,245,,,0,0,-1,,,,,,
494,820,256,494,820,255,,,0,0,1,,,,,,
494,820,268,494,820,269,,,0,0,-1,,,,,,
495,820,283,495,820,283,,,0,0,0,,,,,,
495,821,298,495,820,299,,,0,1,-1,,,,,,
495,821,315,495,820,315,,,0,1,0,,,,,,
495,821,333,495,820,334,,,0,1,-1,,,,,,
495,821,352,495,821,352,,,0,0,0,,,,,,
496,821,372,495,821,372,,,1,0,0,,,,,,
496,821,392,496,821,392,,,0,0,0,,,,,,
496,821,413,496,821,413,,,0,0,0,,,,,,
497,822,434,497,821,434,,,0,1,0,,,,,,
497,822,456,497,821,456,,,0,1,0,,,,,,
497,822,478,497,822,478,,,0,0,0,,,,,,
498,822,501,498,822,501,,,0,0,0,,,,,,
498,823,523,498,822,524,,,0,1,-1,,,,,,
499,823,547,499,823,547,,,0,0,0,,,,,,
499,823,570,499,823,570,,,0,0,0,,,,,,
500,824,593,500,823,593,,,0,1,0,,,,,,
500,824,617,500,824,616,,,0,0,1,,,,,,
501,824,641,501,824,640,,,0,0,1,,,,,,
502,825,665,501,825,664,,,1,0,1,,,,,,
502,825,689,502,825,688,,,0,0,1,,,,,,
503,826,713,503,825,713,,,0,1,0,,,,,,
504,826,737,503,826,737,,,1,0,0,,,,,,
504,826,762,504,826,762,,,0,0,0,,,,,,
505,827,786,505,826,786,,,0,1,0,,,,,,
509,849,228,509,849,228,,,0,0,0,,,,,,
509,850,229,509,849,228,,,0,1,1,,,,,,
509,850,231,509,850,231,,,0,0,0,,,,,,
509,850,236,509,850,237,,,0,0,-1,,,,,,
509,850,243,509,850,243,,,0,0,0,,,,,,
509,850,251,509,850,252,,,0,0,-1,,,,,,
509,850,262,509,850,262,,,0,0,0,,,,,,
510,850,275,509,850,275,,,1,0,0,,,,,,
510,850,289,510,850,289,,,0,0,0,,,,,,
510,850,304,510,850,305,,,0,0,-1,,,,,,
510,850,321,510,850,321,,,0,0,0,,,,,,
510,850,338,510,850,339,,,0,0,-1,,,,,,
510,850,357,510,850,357,,,0,0,0,,,,,,
511,850,376,510,850,376,,,1,0,0,,,,,,
511,851,396,511,851,396,,,0,0,0,,,,,,
511,851,417,511,851,417,,,0,0,0,,,,,,
512,851,438,512,851,438,,,0,0,0,,,,,,
512,851,460,512,851,460,,,0,0,0,,,,,,
512,851,482,512,851,482,,,0,0,0,,,,,,
513,852,504,512,851,504,,,1,1,0,,,,,,
513,852,527,513,852,527,,,0,0,0,,,,,,
514,852,549,513,852,550,,,1,0,-1,,,,,,
514,853,573,514,853,573,,,0,0,0,,,,,,
515,853,596,514,853,596,,,1,0,0,,,,,,
515,853,619,515,853,619,,,0,0,0,,,,,,
516,854,643,515,853,643,,,1,1,0,,,,,,
516,854,667,516,854,667,,,0,0,0,,,,,,
517,854,691,517,854,691,,,0,0,0,,,,,,
518,855,715,518,855,715,,,0,0,0,,,,,,
518,855,739,518,855,739,,,0,0,0,,,,,,
519,856,764,519,856,764,,,0,0,0,,,,,,
520,856,788,520,856,788,,,0,0,0,,,,,,
524,879,236,524,878,236,,,0,1,0,,,,,,
524,879,237,524,878,236,,,0,1,1,,,,,,
524,879,239,524,879,239,,,0,0,0,,,,,,
524,879,244,524,879,244,,,0,0,0,,,,,,
524,879,250,524,879,250,,,0,0,0,,,,,,
524,879,258,524,879,259,,,0,0,-1,,,,,,
525,879,269,524,879,269,,,1,0,0,,,,,,
525,879,281,524,879,282,,,1,0,-1,,,,,,
525,879,295,525,879,295,,,0,0,0,,,,,,
525,879,310,525,879,310,,,0,0,0,,,,,,
525,879,326,525,879,326,,,0,0,0,,,,,,
525,880,343,525,879,344,,,0,1,-1,,,,,,
526,880,362,525,879,362,,,1,1,0,,,,,,
526,880,381,525,879,381,,,1,1,0,,,,,,
526,880,401,526,880,400,,,0,0,1,,,,,,
526,880,421,526,880,421,,,0,0,0,,,,,,
527,880,442,527,880,442,,,0,0,0,,,,,,
527,881,463,527,880,463,,,0,1,0,,,,,,
527,881,485,527,880,485,,,0,1,0,,,,,,
528,881,507,527,881,507,,,1,0,0,,,,,,
528,881,530,528,881,530,,,0,0,0,,,,,,
529,882,552,528,881,552,,,1,1,0,,,,,,
529,882,575,529,882,575,,,0,0,0,,,,,,
530,882,599,529,882,598,,,1,0,1,,,,,,
530,882,622,530,882,622,,,0,0,0,,,,,,
531,883,646,530,882,645,,,1,1,1,,,,,,
531,883,669,531,883,669,,,0,0,0,,,,,,
532,884,693,532,883,693,,,0,1,0,,,,,,
533,884,717,533,884,717,,,0,0,0,,,,,,
533,884,742,533,884,741,,,0,0,1,,,,,,
534,885,766,534,885,766,,,0,0,0,,,,,,
535,885,790,534,885,790,,,1,0,0,,,,,,
232,64,35,232,64,35,,,0,0,0,,,,,,
232,64,40,232,64,35,,,0,0,5,,,,,,
232,64,55,232,64,54,,,0,0,1,,,,,,
232,65,74,232,65,75,,,0,0,-1,,,,,,
232,65,95,232,65,95,,,0,0,0,,,,,,
232,66,118,232,66,118,,,0,0,0,,,,,,
232,67,141,232,67,141,,,0,0,0,,,,,,
233,68,164,232,68,164,,,1,0,0,,,,,,
233,70,188,233,69,188,,,0,1,0,,,,,,
233,71,212,233,71,211,,,0,0,1,,,,,,
234,73,236,234,73,235,,,0,0,1,,,,,,
234,75,260,234,75,260,,,0,0,0,,,,,,
235,77,285,235,77,284,,,0,0,1,,,,,,
236,79,309,235,79,309,,,1,0,0,,,,,,
236,81,334,236,81,333,,,0,0,1,,,,,,
237,84,358,237,84,358,,,0,0,0,,,,,,
238,87,383,238,86,383,,,0,1,0,,,,,,
239,89,408,239,89,408,,,0,0,0,,,,,,
239,92,433,240,92,433,,,-1,0,0,,,,,,
240,95,458,240,95,458,,,0,0,0,,,,,,
241,98,483,241,98,483,,,0,0,0,,,,,,
243,101,508,242,101,508,,,1,0,0,,,,,,
244,104,533,243,104,533,,,1,0,0,,,,,,
245,107,558,244,107,558,,,1,0,0,,,,,,
246,111,583,246,111,583,,,0,0,0,,,,,,
247,114,609,247,114,608,,,0,0,1,,,,,,
249,117,634,249,117,634,,,0,0,0,,,,,,
250,121,659,250,121,659,,,0,0,0,,,,,,
252,124,685,251,124,685,,,1,0,0,,,,,,
253,128,710,253,128,710,,,0,0,0,,,,,,
255,131,736,255,131,736,,,0,0,0,,,,,,
256,135,761,256,135,761,,,0,0,0,,,,,,
232,68,36,232,64,35,,,0,4,1,,,,,,
232,68,41,232,64,35,,,0,4,6,,,,,,
232,68,55,232,64,54,,,0,4,1,,,,,,
232,68,74,232,65,75,,,0,3,-1,,,,,,
232,69,96,232,65,95,,,0,4,1,,,,,,
232,70,118,232,66,118,,,0,4,0,,,,,,
233,71,141,232,67,141,,,1,4,0,,,,,,
233,72,164,232,68,164,,,1,4,0,,,,,,
233,73,188,233,69,188,,,0,4,0,,,,,,
234,74,212,233,71,211,,,1,3,1,,,,,,
234,76,236,234,73,235,,,0,3,1,,,,,,
235,78,260,234,75,260,,,1,3,0,,,,,,
235,80,285,235,77,284,,,0,3,1,,,,,,
236,82,309,235,79,309,,,1,3,0,,,,,,
236,84,334,236,81,333,,,0,3,1,,,,,,
237,87,358,237,84,358,,,0,3,0,,,,,,
238,89,383,238,86,383,,,0,3,0,,,,,,
239,92,408,239,89,408,,,0,3,0,,,,,,
240,95,433,240,92,433,,,0,3,0,,,,,,
241,97,458,240,95,458,,,1,2,0,,,,,,
242,100,483,241,98,483,,,1,2,0,,,,,,
243,103,508,242,101,508,,,1,2,0,,,,,,
244,106,533,243,104,533,,,1,2,0,,,,,,
245,109,558,244,107,558,,,1,2,0,,,,,,
246,113,583,246,111,583,,,0,2,0,,,,,,
248,116,609,247,114,608,,,1,2,1,,,,,,
249,119,634,249,117,634,,,0,2,0,,,,,,
250,123,659,250,121,659,,,0,2,0,,,,,,
252,126,685,251,124,685,,,1,2,0,,,,,,
253,129,710,253,128,710,,,0,1,0,,,,,,
255,133,736,255,131,736,,,0,2,0,,,,,,
257,136,761,256,135,761,,,1,1,0,,,,,,
233,80,37,233,80,37,,,0,0,0,,,,,,
233,80,42,233,80,37,,,0,0,5,,,,,,
233,80,56,233,80,56,,,0,0,0,,,,,,
233,80,75,233,80,76,,,0,0,-1,,,,,,
233,81,96,233,81,96,,,0,0,0,,,,,,
233,81,118,233,81,118,,,0,0,0,,,,,,
234,82,141,233,82,141,,,1,0,0,,,,,,
234,83,165,234,83,164,,,0,0,1,,,,,,
234,84,188,234,84,188,,,0,0,0,,,,,,
235,85,212,235,85,212,,,0,0,0,,,,,,
235,87,236,235,87,236,,,0,0,0,,,,,,
236,88,260,236,88,260,,,0,0,0,,,,,,
236,90,285,236,90,284,,,0,0,1,,,,,,
237,92,309,237,92,309,,,0,0,0,,,,,,
237,94,334,237,94,333,,,0,0,1,,,,,,
238,96,358,238,96,358,,,0,0,0,,,,,,
239,98,383,239,98,383,,,0,0,0,,,,,,
240,101,408,240,101,408,,,0,0,0,,,,,,
241,103,433,241,103,433,,,0,0,0,,,,,,
242,106,458,241,106,458,,,1,0,0,,,,,,
243,108,483,242,109,483,,,1,-1,0,,,,,,
244,111,508,243,111,508,,,1,0,0,,,,,,
245,114,533,245,114,533,,,0,0,0,,,,,,
246,117,558,246,117,558,,,0,0,0,,,,,,
247,120,584,247,120,583,,,0,0,1,,,,,,
249,123,609,249,123,608,,,0,0,1,,,,,,
250,126,634,250,126,634,,,0,0,0,,,,,,
251,129,660,251,129,659,,,0,0,1,,,,,,
253,132,685,253,132,685,,,0,0,0,,,,,,
254,136,710,254,135,710,,,0,1,0,,,,,,
256,139,736,256,139,736,,,0,0,0,,,,,,
258,142,761,257,142,761,,,1,0,0,,,,,,
235,98,40,235,100,40,,,0,-2,0,,,,,,
235,98,44,235,100,40,,,0,-2,4,,,,,,
235,98,58,235,100,58,,,0,-2,0,,,,,,
235,98,76,235,100,77,,,0,-2,-1,,,,,,
235,99,97,235,100,97,,,0,-1,0,,,,,,
235,99,119,235,101,119,,,0,-2,0,,,,,,
235,100,142,235,102,142,,,0,-2,0,,,,,,
236,101,165,236,102,165,,,0,-1,0,,,,,,
236,102,189,236,103,189,,,0,-1,0,,,,,,
236,103,213,237,104,213,,,-1,-1,0,,,,,,
237,104,237,237,105,237,,,0,-1,0,,,,,,
237,105,261,238,107,261,,,-1,-2,0,,,,,,
238,106,285,238,108,285,,,0,-2,0,,,,,,
238,108,310,239,110,309,,,-1,-2,1,,,,,,
239,110,334,239,111,334,,,0,-1,0,,,,,,
240,112,359,240,113,358,,,0,-1,1,,,,,,
241,113,383,241,115,383,,,0,-2,0,,,,,,
241,115,408,242,117,408,,,-1,-2,0,,,,,,
242,118,433,243,119,433,,,-1,-1,0,,,,,,
243,120,458,243,122,458,,,0,-2,0,,,,,,
244,122,483,244,124,483,,,0,-2,0,,,,,,
245,125,508,246,126,508,,,-1,-1,0,,,,,,
247,127,533,247,129,533,,,0,-2,0,,,,,,
248,130,558,248,131,558,,,0,-1,0,,,,,,
249,132,584,249,134,583,,,0,-2,1,,,,,,
250,135,609,251,137,609,,,-1,-2,0,,,,,,
252,138,634,252,140,634,,,0,-2,0,,,,,,
253,141,660,253,143,659,,,0,-2,1,,,,,,
254,144,685,255,145,685,,,-1,-1,0,,,,,,
256,147,710,256,148,710,,,0,-1,0,,,,,,
258,150,736,258,151,736,,,0,-1,0,,,,,,
259,153,761,259,154,761,,,0,-1,0,,,,,,
237,120,44,237,120,44,,,0,0,0,,,,,,
237,120,48,237,120,44,,,0,0,4,,,,,,
237,120,60,237,120,60,,,0,0,0,,,,,,
238,120,78,237,120,79,,,1,0,-1,,,,,,
238,120,99,238,120,98,,,0,0,1,,,,,,
238,121,120,238,121,120,,,0,0,0,,,,,,
238,121,143,238,121,143,,,0,0,0,,,,,,
238,122,166,238,122,166,,,0,0,0,,,,,,
239,123,189,239,122,189,,,0,1,0,,,,,,
239,124,213,239,123,213,,,0,1,0,,,,,,
239,124,237,240,124,237,,,-1,0,0,,,,,,
240,126,261,240,125,261,,,0,1,0,,,,,,
241,127,286,240,126,285,,,1,1,1,,,,,,
241,128,310,241,128,310,,,0,0,0,,,,,,
242,129,334,242,129,334,,,0,0,0,,,,,,
242,131,359,242,131,359,,,0,0,0,,,,,,
243,132,384,243,132,384,,,0,0,0,,,,,,
244,134,409,244,134,408,,,0,0,1,,,,,,
245,136,433,245,136,433,,,0,0,0,,,,,,
246,138,458,246,138,458,,,0,0,0,,,,,,
247,140,483,247,140,483,,,0,0,0,,,,,,
248,142,508,248,142,508,,,0,0,0,,,,,,
249,144,534,249,144,533,,,0,0,1,,,,,,
250,146,559,250,146,558,,,0,0,1,,,,,,
251,149,584,251,149,584,,,0,0,0,,,,,,
253,151,609,253,151,609,,,0,0,0,,,,,,
254,154,634,254,154,634,,,0,0,0,,,,,,
255,156,660,255,156,659,,,0,0,1,,,,,,
257,159,685,257,159,685,,,0,0,0,,,,,,
258,161,711,258,161,710,,,0,0,1,,,,,,
260,164,736,260,164,736,,,0,0,0,,,,,,
262,167,762,262,167,761,,,0,0,1,,,,,,
241,144,49,241,144,49,,,0,0,0,,,,,,
241,144,52,241,144,49,,,0,0,3,,,,,,
241,144,64,241,144,64,,,0,0,0,,,,,,
241,144,81,241,144,82,,,0,0,-1,,,,,,
241,144,101,242,145,100,,,-1,-1,1,,,,,,
241,145,122,242,145,122,,,-1,0,0,,,,,,
242,145,144,242,146,144,,,0,-1,0,,,,,,
242,145,167,242,146,167,,,0,-1,0,,,,,,
242,146,190,243,147,190,,,-1,-1,0,,,,,,
243,147,214,243,147,214,,,0,0,0,,,,,,
243,148,238,244,148,238,,,-1,0,0,,,,,,
244,148,262,244,149,262,,,0,-1,0,,,,,,
244,149,286,244,150,286,,,0,-1,0,,,,,,
245,150,310,245,151,310,,,0,-1,0,,,,,,
245,152,335,246,152,335,,,-1,0,0,,,,,,
246,153,360,246,153,359,,,0,0,1,,,,,,
247,154,384,247,155,384,,,0,-1,0,,,,,,
248,156,409,248,156,409,,,0,0,0,,,,,,
248,157,434,249,158,434,,,-1,-1,0,,,,,,
249,159,459,250,160,458,,,-1,-1,1,,,,,,
250,161,484,251,161,483,,,-1,0,1,,,,,,
251,162,509,252,163,508,,,-1,-1,1,,,,,,
252,164,534,253,165,533,,,-1,-1,1,,,,,,
254,166,559,254,167,559,,,0,-1,0,,,,,,
255,168,584,255,169,584,,,0,-1,0,,,,,,
256,170,609,256,171,609,,,0,-1,0,,,,,,
257,172,635,258,174,634,,,-1,-2,1,,,,,,
259,175,660,259,176,660,,,0,-1,0,,,,,,
260,177,685,261,178,685,,,-1,-1,0,,,,,,
262,179,711,262,180,710,,,0,-1,1,,,,,,
263,182,736,264,183,736,,,-1,-1,0,,,,,,
265,184,762,265,185,761,,,0,-1,1,,,,,,
245,169,54,245,169,54,,,0,0,0,,,,,,
245,169,57,245,169,54,,,0,0,3,,,,,,
245,169,68,246,169,68,,,-1,0,0,,,,,,
246,169,84,246,169,85,,,0,0,-1,,,,,,
246,169,103,246,169,103,,,0,0,0,,,,,,
246,170,124,246,170,124,,,0,0,0,,,,,,
246,170,146,246,170,146,,,0,0,0,,,,,,
246,170,169,246,171,168,,,0,-1,1,,,,,,
247,171,192,247,171,191,,,0,0,1,,,,,,
247,171,215,247,172,215,,,0,-1,0,,,,,,
247,172,239,248,172,238,,,-1,0,1,,,,,,
248,173,263,248,173,262,,,0,0,1,,,,,,
248,174,287,249,173,287,,,-1,1,0,,,,,,
249,175,311,249,174,311,,,0,1,0,,,,,,
250,176,336,250,175,335,,,0,1,1,,,,,,
250,177,360,250,176,360,,,0,1,0,,,,,,
251,178,385,251,178,385,,,0,0,0,,,,,,
252,179,410,252,179,409,,,0,0,1,,,,,,
253,180,434,253,180,434,,,0,0,0,,,,,,
254,182,459,254,182,459,,,0,0,0,,,,,,
255,183,484,255,183,484,,,0,0,0,,,,,,
256,185,509,256,185,509,,,0,0,0,,,,,,
257,186,534,257,186,534,,,0,0,0,,,,,,
258,188,559,258,188,559,,,0,0,0,,,,,,
259,190,585,259,190,584,,,0,0,1,,,,,,
260,192,610,260,192,609,,,0,0,1,,,,,,
262,194,635,261,194,635,,,1,0,0,,,,,,
263,196,660,263,196,660,,,0,0,0,,,,,,
264,198,686,265,198,686,,,-1,0,0,,,,,,
266,200,711,266,200,711,,,0,0,0,,,,,,
267,202,737,268,202,736,,,-1,0,1,,,,,,
269,204,762,269,204,762,,,0,0,0,,,,,,
251,195,60,251,195,60,,,0,0,0,,,,,,
251,195,63,251,195,60,,,0,0,3,,,,,,
251,195,73,251,195,72,,,0,0,1,,,,,,
251,195,88,251,195,89,,,0,0,-1,,,,,,
251,195,106,251,195,106,,,0,0,0,,,,,,
251,196,126,251,196,127,,,0,0,-1,,,,,,
251,196,148,252,196,148,,,-1,0,0,,,,,,
252,196,170,252,196,170,,,0,0,0,,,,,,
252,197,193,252,197,193,,,0,0,0,,,,,,
252,197,216,253,197,216,,,-1,0,0,,,,,,
253,198,240,253,198,240,,,0,0,0,,,,,,
253,198,264,254,198,264,,,-1,0,0,,,,,,
254,199,288,254,199,288,,,0,0,0,,,,,,
254,200,312,255,200,312,,,-1,0,0,,,,,,
255,201,336,255,201,336,,,0,0,0,,,,,,
256,202,361,256,202,361,,,0,0,0,,,,,,
256,203,385,257,203,385,,,-1,0,0,,,,,,
257,204,410,257,204,410,,,0,0,0,,,,,,
258,205,435,258,205,435,,,0,0,0,,,,,,
259,206,460,259,206,459,,,0,0,1,,,,,,
260,207,485,260,208,484,,,0,-1,1,,,,,,
261,209,510,261,209,509,,,0,0,1,,,,,,
262,210,535,262,210,534,,,0,0,1,,,,,,
263,212,560,263,212,559,,,0,0,1,,,,,,
264,213,585,265,213,585,,,-1,0,0,,,,,,
265,215,610,266,215,610,,,-1,0,0,,,,,,
267,216,635,267,217,635,,,0,-1,0,,,,,,
268,218,661,268,219,660,,,0,-1,1,,,,,,
269,220,686,270,220,686,,,-1,0,0,,,,,,
271,222,712,271,222,711,,,0,0,1,,,,,,
272,224,737,273,224,736,,,-1,0,1,,,,,,
274,226,762,274,226,762,,,0,0,0,,,,,,
257,222,66,257,222,66,,,0,0,0,,,,,,
257,222,69,257,222,66,,,0,0,3,,,,,,
257,222,78,257,222,77,,,0,0,1,,,,,,
257,222,92,257,222,93,,,0,0,-1,,,,,,
257,222,109,257,222,109,,,0,0,0,,,,,,
257,222,129,257,222,130,,,0,0,-1,,,,,,
258,222,150,258,222,150,,,0,0,0,,,,,,
258,223,172,258,222,172,,,0,1,0,,,,,,
258,223,195,258,223,195,,,0,0,0,,,,,,
258,223,218,259,223,218,,,-1,0,0,,,,,,
259,224,241,259,224,241,,,0,0,0,,,,,,
259,224,265,260,224,265,,,-1,0,0,,,,,,
260,225,289,260,225,289,,,0,0,0,,,,,,
260,226,313,261,225,313,,,-1,1,0,,,,,,
261,227,337,261,226,337,,,0,1,0,,,,,,
262,227,362,262,227,362,,,0,0,0,,,,,,
262,228,386,262,228,386,,,0,0,0,,,,,,
263,229,411,263,229,411,,,0,0,0,,,,,,
264,230,436,264,230,435,,,0,0,1,,,,,,
265,231,460,265,231,460,,,0,0,0,,,,,,
266,232,485,266,232,485,,,0,0,0,,,,,,
267,233,510,267,233,510,,,0,0,0,,,,,,
268,235,535,268,235,535,,,0,0,0,,,,,,
269,236,560,269,236,560,,,0,0,0,,,,,,
270,237,585,270,237,585,,,0,0,0,,,,,,
271,239,611,271,239,610,,,0,0,1,,,,,,
272,240,636,272,240,636,,,0,0,0,,,,,,
274,242,661,274,242,661,,,0,0,0,,,,,,
275,244,687,275,243,686,,,0,1,1,,,,,,
276,245,712,276,245,711,,,0,0,1,,,,,,
278,247,737,278,247,737,,,0,0,0,,,,,,
279,249,763,279,248,762,,,0,1,1,,,,,,
264,249,72,264,249,72,,,0,0,0,,,,,,
264,249,75,264,249,72,,,0,0,3,,,,,,
264,249,83,264,249,83,,,0,0,0,,,,,,
264,249,96,264,249,98,,,0,0,-2,,,,,,
264,249,113,265,249,113,,,-1,0,0,,,,,,
264,249,132,265,249,133,,,-1,0,-1,,,,,,
265,249,153,265,249,153,,,0,0,0,,,,,,
265,250,175,265,249,175,,,0,1,0,,,,,,
265,250,197,266,250,197,,,-1,0,0,,,,,,
265,250,220,266,250,220,,,-1,0,0,,,,,,
266,251,243,266,250,243,,,0,1,0,,,,,,
266,251,267,267,251,266,,,-1,0,1,,,,,,
267,252,290,267,251,290,,,0,1,0,,,,,,
267,252,314,268,252,314,,,-1,0,0,,,,,,
268,253,338,268,253,338,,,0,0,0,,,,,,
268,254,363,269,253,363,,,-1,1,0,,,,,,
269,254,387,269,254,387,,,0,0,0,,,,,,
270,255,412,270,255,412,,,0,0,0,,,,,,
271,256,436,271,256,436,,,0,0,0,,,,,,
272,257,461,272,257,461,,,0,0,0,,,,,,
272,258,486,273,258,486,,,-1,0,0,,,,,,
273,259,511,274,259,511,,,-1,0,0,,,,,,
274,260,536,275,260,536,,,-1,0,0,,,,,,
275,261,561,276,261,561,,,-1,0,0,,,,,,
277,263,586,277,263,586,,,0,0,0,,,,,,
278,264,611,278,264,611,,,0,0,0,,,,,,
279,265,636,279,265,636,,,0,0,0,,,,,,
280,267,662,281,267,661,,,-1,0,1,,,,,,
281,268,687,282,268,687,,,-1,0,0,,,,,,
283,270,712,283,270,712,,,0,0,0,,,,,,
284,271,738,285,271,737,,,-1,0,1,,,,,,
286,273,763,286,273,763,,,0,0,0,,,,,,
272,276,79,272,276,79,,,0,0,0,,,,,,
272,276,81,272,276,79,,,0,0,2,,,,,,
272,276,89,272,276,89,,,0,0,0,,,,,,
272,276,101,272,276,103,,,0,0,-2,,,,,,
272,276,117,272,276,117,,,0,0,0,,,,,,
272,276,136,272,276,136,,,0,0,0,,,,,,
272,276,156,272,276,156,,,0,0,0,,,,,,
273,277,177,273,277,177,,,0,0,0,,,,,,
273,277,199,273,277,199,,,0,0,0,,,,,,
273,277,222,273,277,222,,,0,0,0,,,,,,
274,278,245,274,277,244,,,0,1,1,,,,,,
274,278,268,274,278,268,,,0,0,0,,,,,,
274,279,292,275,278,291,,,-1,1,1,,,,,,
275,279,316,275,279,315,,,0,0,1,,,,,,
275,280,340,276,279,339,,,-1,1,1,,,,,,
276,280,364,276,280,364,,,0,0,0,,,,,,
277,281,388,277,281,388,,,0,0,0,,,,,,
277,282,413,278,282,413,,,-1,0,0,,,,,,
278,283,437,279,282,437,,,-1,1,0,,,,,,
279,284,462,279,283,462,,,0,1,0,,,,,,
280,284,487,280,284,487,,,0,0,0,,,,,,
281,285,512,281,285,512,,,0,0,0,,,,,,
282,286,537,282,286,537,,,0,0,0,,,,,,
283,287,562,283,287,562,,,0,0,0,,,,,,
284,289,587,284,288,587,,,0,1,0,,,,,,
285,290,612,285,289,612,,,0,1,0,,,,,,
286,291,637,287,291,637,,,-1,0,0,,,,,,
287,292,662,288,292,662,,,-1,0,0,,,,,,
289,293,688,289,293,687,,,0,0,1,,,,,,
290,295,713,290,295,712,,,0,0,1,,,,,,
291,296,738,292,296,738,,,-1,0,0,,,,,,
293,298,764,293,298,763,,,0,0,1,,,,,,
280,303,86,281,303,86,,,-1,0,0,,,,,,
280,303,88,281,303,86,,,-1,0,2,,,,,,
280,304,95,281,303,95,,,-1,1,0,,,,,,
280,304,107,281,303,108,,,-1,1,-1,,,,,,
280,304,122,281,304,122,,,-1,0,0,,,,,,
281,304,140,281,304,140,,,0,0,0,,,,,,
281,304,159,281,304,159,,,0,0,0,,,,,,
281,304,180,281,304,180,,,0,0,0,,,,,,
281,305,202,282,304,202,,,-1,1,0,,,,,,
282,305,224,282,305,224,,,0,0,0,,,,,,
282,305,247,282,305,247,,,0,0,0,,,,,,
282,306,270,283,305,270,,,-1,1,0,,,,,,
283,306,293,283,306,293,,,0,0,0,,,,,,
283,306,317,284,306,317,,,-1,0,0,,,,,,
284,307,341,284,307,341,,,0,0,0,,,,,,
284,308,365,285,307,365,,,-1,1,0,,,,,,
285,308,390,285,308,389,,,0,0,1,,,,,,
286,309,414,286,309,414,,,0,0,0,,,,,,
286,310,438,287,309,438,,,-1,1,0,,,,,,
287,310,463,288,310,463,,,-1,0,0,,,,,,
288,311,488,289,311,488,,,-1,0,0,,,,,,
289,312,513,290,312,512,,,-1,0,1,,,,,,
290,313,538,291,313,537,,,-1,0,1,,,,,,
291,314,563,291,314,562,,,0,0,1,,,,,,
292,315,588,292,315,587,,,0,0,1,,,,,,
293,316,613,294,316,612,,,-1,0,1,,,,,,
294,317,638,295,317,637,,,-1,0,1,,,,,,
295,318,663,296,318,663,,,-1,0,0,,,,,,
297,319,688,297,319,688,,,0,0,0,,,,,,
298,321,714,298,321,713,,,0,0,1,,,,,,
299,322,739,300,322,738,,,-1,0,1,,,,,,
301,323,764,301,323,764,,,0,0,0,,,,,,
289,331,93,290,331,93,,,-1,0,0,,,,,,
289,331,95,290,331,93,,,-1,0,2,,,,,,
289,331,101,290,331,101,,,-1,0,0,,,,,,
289,331,112,290,331,114,,,-1,0,-2,,,,,,
290,332,127,290,331,127,,,0,1,0,,,,,,
290,332,144,290,331,145,,,0,1,-1,,,,,,
290,332,163,290,332,163,,,0,0,0,,,,,,
290,332,183,290,332,183,,,0,0,0,,,,,,
290,332,205,291,332,204,,,-1,0,1,,,,,,
291,333,227,291,332,227,,,0,1,0,,,,,,
291,333,249,291,333,249,,,0,0,0,,,,,,
291,333,272,292,333,272,,,-1,0,0,,,,,,
292,334,295,292,333,295,,,0,1,0,,,,,,
292,334,319,293,334,319,,,-1,0,0,,,,,,
293,334,343,293,334,342,,,0,0,1,,,,,,
293,335,367,294,335,366,,,-1,0,1,,,,,,
294,336,391,294,335,391,,,0,1,0,,,,,,
295,336,415,295,336,415,,,0,0,0,,,,,,
295,337,440,295,337,439,,,0,0,1,,,,,,
296,338,464,296,337,464,,,0,1,0,,,,,,
297,338,489,297,338,489,,,0,0,0,,,,,,
298,339,514,298,339,513,,,0,0,1,,,,,,
299,340,538,299,340,538,,,0,0,0,,,,,,
300,341,563,300,341,563,,,0,0,0,,,,,,
301,342,588,301,342,588,,,0,0,0,,,,,,
302,343,613,302,343,613,,,0,0,0,,,,,,
303,344,639,303,344,638,,,0,0,1,,,,,,
304,345,664,304,345,663,,,0,0,1,,,,,,
305,346,689,305,346,689,,,0,0,0,,,,,,
306,347,714,307,347,714,,,-1,0,0,,,,,,
308,348,740,308,348,739,,,0,0,1,,,,,,
309,349,765,309,349,765,,,0,0,0,,,,,,
299,359,100,299,359,100,,,0,0,0,,,,,,
299,359,102,299,359,100,,,0,0,2,,,,,,
299,359,108,299,359,108,,,0,0,0,,,,,,
299,359,118,300,359,120,,,-1,0,-2,,,,,,
299,359,132,300,359,132,,,-1,0,0,,,,,,
299,360,148,300,359,149,,,-1,1,-1,,,,,,
300,360,167,300,360,167,,,0,0,0,,,,,,
300,360,187,300,360,187,,,0,0,0,,,,,,
300,360,208,300,360,207,,,0,0,1,,,,,,
300,360,229,301,360,229,,,-1,0,0,,,,,,
301,361,252,301,361,252,,,0,0,0,,,,,,
301,361,274,302,361,274,,,-1,0,0,,,,,,
301,361,297,302,361,297,,,-1,0,0,,,,,,
302,362,321,302,361,321,,,0,1,0,,,,,,
302,362,344,303,362,344,,,-1,0,0,,,,,,
303,363,368,303,362,368,,,0,1,0,,,,,,
304,363,392,304,363,392,,,0,0,0,,,,,,
304,364,417,305,363,416,,,-1,1,1,,,,,,
305,364,441,305,364,441,,,0,0,0,,,,,,
306,365,465,306,365,465,,,0,0,0,,,,,,
306,366,490,307,365,490,,,-1,1,0,,,,,,
307,366,515,308,366,514,,,-1,0,1,,,,,,
308,367,540,309,367,539,,,-1,0,1,,,,,,
309,368,564,310,368,564,,,-1,0,0,,,,,,
310,369,589,310,369,589,,,0,0,0,,,,,,
311,370,614,311,370,614,,,0,0,0,,,,,,
312,371,639,313,371,639,,,-1,0,0,,,,,,
313,372,665,314,372,664,,,-1,0,1,,,,,,
314,373,690,315,373,690,,,-1,0,0,,,,,,
316,374,715,316,374,715,,,0,0,0,,,,,,
317,375,740,317,375,740,,,0,0,0,,,,,,
318,376,766,319,376,765,,,-1,0,1,,,,,,
309,387,107,309,387,107,,,0,0,0,,,,,,
309,387,109,309,387,107,,,0,0,2,,,,,,
309,387,114,309,388,114,,,0,-1,0,,,,,,
309,388,124,310,388,126,,,-1,0,-2,,,,,,
309,388,137,310,388,137,,,-1,0,0,,,,,,
310,388,153,310,388,154,,,0,0,-1,,,,,,
310,388,171,310,388,171,,,0,0,0,,,,,,
310,388,190,310,388,191,,,0,0,-1,,,,,,
310,388,211,310,388,211,,,0,0,0,,,,,,
310,388,232,311,388,232,,,-1,0,0,,,,,,
311,389,254,311,389,254,,,0,0,0,,,,,,
311,389,277,312,389,277,,,-1,0,0,,,,,,
312,389,300,312,389,299,,,0,0,1,,,,,,
312,390,323,312,389,323,,,0,1,0,,,,,,
313,390,346,313,390,346,,,0,0,0,,,,,,
313,391,370,313,390,370,,,0,1,0,,,,,,
314,391,394,314,391,394,,,0,0,0,,,,,,
314,392,418,315,391,418,,,-1,1,0,,,,,,
315,392,442,316,392,442,,,-1,0,0,,,,,,
316,393,467,316,392,467,,,0,1,0,,,,,,
316,393,491,317,393,491,,,-1,0,0,,,,,,
317,394,516,318,394,516,,,-1,0,0,,,,,,
318,395,541,319,395,540,,,-1,0,1,,,,,,
319,395,565,319,395,565,,,0,0,0,,,,,,
320,396,590,320,396,590,,,0,0,0,,,,,,
321,397,615,321,397,615,,,0,0,0,,,,,,
322,398,640,322,398,640,,,0,0,0,,,,,,
323,399,665,323,399,665,,,0,0,0,,,,,,
324,400,691,324,400,691,,,0,0,0,,,,,,
325,401,716,325,401,716,,,0,0,0,,,,,,
326,402,741,327,402,741,,,-1,0,0,,,,,,
328,403,766,328,403,766,,,0,0,0,,,,,,
320,416,115,320,415,114,,,0,1,1,,,,,,
320,416,116,320,415,114,,,0,1,2,,,,,,
320,416,121,320,416,121,,,0,0,0,,,,,,
320,416,130,321,416,132,,,-1,0,-2,,,,,,
320,416,143,321,416,143,,,-1,0,0,,,,,,
320,416,158,321,416,159,,,-1,0,-1,,,,,,
321,416,176,321,416,175,,,0,0,1,,,,,,
321,416,194,321,416,195,,,0,0,-1,,,,,,
321,416,214,321,416,214,,,0,0,0,,,,,,
321,417,235,322,416,236,,,-1,1,-1,,,,,,
322,417,257,322,417,257,,,0,0,0,,,,,,
322,417,279,322,417,279,,,0,0,0,,,,,,
322,417,302,323,417,302,,,-1,0,0,,,,,,
323,418,325,323,417,325,,,0,1,0,,,,,,
323,418,348,324,418,348,,,-1,0,0,,,,,,
324,419,372,324,418,372,,,0,1,0,,,,,,
324,419,396,325,419,395,,,-1,0,1,,,,,,
325,420,420,325,419,419,,,0,1,1,,,,,,
325,420,444,326,420,444,,,-1,0,0,,,,,,
326,421,468,327,420,468,,,-1,1,0,,,,,,
327,421,493,327,421,492,,,0,0,1,,,,,,
328,422,517,328,421,517,,,0,1,0,,,,,,
328,422,542,329,422,541,,,-1,0,1,,,,,,
329,423,567,330,423,566,,,-1,0,1,,,,,,
330,424,592,331,424,591,,,-1,0,1,,,,,,
331,425,616,332,424,616,,,-1,1,0,,,,,,
332,425,641,333,425,641,,,-1,0,0,,,,,,
333,426,666,334,426,666,,,-1,0,0,,,,,,
334,427,692,335,427,691,,,-1,0,1,,,,,,
335,428,717,336,428,716,,,-1,0,1,,,,,,
337,429,742,337,429,742,,,0,0,0,,,,,,
338,430,767,338,430,767,,,0,0,0,,,,,,
331,444,122,332,444,122,,,-1,0,0,,,,,,
331,444,123,332,444,122,,,-1,0,1,,,,,,
331,444,128,332,444,128,,,-1,0,0,,,,,,
331,444,137,332,444,138,,,-1,0,-1,,,,,,
331,444,149,332,444,149,,,-1,0,0,,,,,,
332,444,163,332,444,164,,,0,0,-1,,,,,,
332,444,180,332,444,180,,,0,0,0,,,,,,
332,445,199,332,444,199,,,0,1,0,,,,,,
332,445,218,333,445,218,,,-1,0,0,,,,,,
332,445,239,333,445,239,,,-1,0,0,,,,,,
333,445,260,333,445,260,,,0,0,0,,,,,,
333,445,282,333,445,282,,,0,0,0,,,,,,
333,446,305,334,446,304,,,-1,0,1,,,,,,
334,446,327,334,446,327,,,0,0,0,,,,,,
334,446,351,335,446,350,,,-1,0,1,,,,,,
335,447,374,335,446,374,,,0,1,0,,,,,,
335,447,398,336,447,397,,,-1,0,1,,,,,,
336,448,422,336,447,421,,,0,1,1,,,,,,
337,448,446,337,448,445,,,0,0,1,,,,,,
337,449,470,337,448,469,,,0,1,1,,,,,,
338,449,494,338,449,494,,,0,0,0,,,,,,
339,450,519,339,449,518,,,0,1,1,,,,,,
339,450,543,340,450,543,,,-1,0,0,,,,,,
340,451,568,341,451,568,,,-1,0,0,,,,,,
341,452,593,341,452,593,,,0,0,0,,,,,,
342,452,618,342,452,617,,,0,0,1,,,,,,
343,453,643,343,453,642,,,0,0,1,,,,,,
344,454,668,344,454,667,,,0,0,1,,,,,,
345,455,693,345,455,692,,,0,0,1,,,,,,
346,455,718,346,455,717,,,0,0,1,,,,,,
347,456,743,348,456,743,,,-1,0,0,,,,,,
348,457,768,349,457,768,,,-1,0,0,,,,,,
343,473,129,343,472,129,,,0,1,0,,,,,,
343,473,131,343,472,129,,,0,1,2,,,,,,
343,473,135,343,472,135,,,0,1,0,,,,,,
343,473,143,343,472,145,,,0,1,-2,,,,,,
343,473,155,343,472,155,,,0,1,0,,,,,,
343,473,169,343,472,170,,,0,1,-1,,,,,,
343,473,185,344,473,185,,,-1,0,0,,,,,,
344,473,203,344,473,204,,,0,0,-1,,,,,,
344,473,222,344,473,222,,,0,0,0,,,,,,
344,473,242,344,473,243,,,0,0,-1,,,,,,
344,474,263,345,473,263,,,-1,1,0,,,,,,
345,474,285,345,473,285,,,0,1,0,,,,,,
345,474,307,345,474,307,,,0,0,0,,,,,,
345,474,330,346,474,330,,,-1,0,0,,,,,,
346,475,353,346,475,353,,,0,0,0,,,,,,
346,475,376,347,475,376,,,-1,0,0,,,,,,
347,476,400,347,475,399,,,0,1,1,,,,,,
347,476,424,348,476,423,,,-1,0,1,,,,,,
348,476,447,348,476,447,,,0,0,0,,,,,,
349,477,472,349,476,471,,,0,1,1,,,,,,
349,477,496,350,477,495,,,-1,0,1,,,,,,
350,478,520,350,477,520,,,0,1,0,,,,,,
351,478,545,351,478,544,,,0,0,1,,,,,,
352,479,569,352,479,569,,,0,0,0,,,,,,
352,480,594,353,480,594,,,-1,0,0,,,,,,
353,480,619,354,480,619,,,-1,0,0,,,,,,
354,481,644,355,481,643,,,-1,0,1,,,,,,
355,482,669,355,481,668,,,0,1,1,,,,,,
356,482,694,356,482,693,,,0,0,1,,,,,,
357,483,719,358,483,718,,,-1,0,1,,,,,,
358,484,744,359,484,744,,,-1,0,0,,,,,,
359,485,769,360,485,769,,,-1,0,0,,,,,,
355,501,137,355,501,137,,,0,0,0,,,,,,
355,501,138,355,501,137,,,0,0,1,,,,,,
355,501,142,355,501,142,,,0,0,0,,,,,,
355,501,150,355,501,151,,,0,0,-1,,,,,,
355,501,161,355,501,161,,,0,0,0,,,,,,
355,501,174,355,501,175,,,0,0,-1,,,,,,
355,502,190,356,501,190,,,-1,1,0,,,,,,
356,502,208,356,501,208,,,0,1,0,,,,,,
356,502,226,356,502,226,,,0,0,0,,,,,,
356,502,246,356,502,246,,,0,0,0,,,,,,
356,502,267,357,502,266,,,-1,0,1,,,,,,
357,502,288,357,502,288,,,0,0,0,,,,,,
357,503,310,357,502,310,,,0,1,0,,,,,,
357,503,333,358,503,333,,,-1,0,0,,,,,,
358,503,355,358,503,355,,,0,0,0,,,,,,
358,504,379,359,503,378,,,-1,1,1,,,,,,
359,504,402,359,504,402,,,0,0,0,,,,,,
359,504,426,360,504,425,,,-1,0,1,,,,,,
360,505,449,360,505,449,,,0,0,0,,,,,,
360,505,473,361,505,473,,,-1,0,0,,,,,,
361,506,498,361,505,497,,,0,1,1,,,,,,
362,506,522,362,506,521,,,0,0,1,,,,,,
363,507,546,363,506,546,,,0,1,0,,,,,,
363,507,571,364,507,570,,,-1,0,1,,,,,,
364,508,595,365,508,595,,,-1,0,0,,,,,,
365,508,620,365,508,620,,,0,0,0,,,,,,
366,509,645,366,509,645,,,0,0,0,,,,,,
367,510,670,367,509,670,,,0,1,0,,,,,,
368,510,695,368,510,695,,,0,0,0,,,,,,
369,511,720,369,511,720,,,0,0,0,,,,,,
370,512,745,370,512,745,,,0,0,0,,,,,,
371,513,770,371,512,770,,,0,1,0,,,,,,
367,530,144,368,530,144,,,-1,0,0,,,,,,
367,530,145,368,530,144,,,-1,0,1,,,,,,
367,530,150,368,530,149,,,-1,0,1,,,,,,
367,530,157,368,530,158,,,-1,0,-1,,,,,,
368,530,167,368,530,167,,,0,0,0,,,,,,
368,530,180,368,530,181,,,0,0,-1,,,,,,
368,530,195,368,530,195,,,0,0,0,,,,,,
368,530,212,368,530,213,,,0,0,-1,,,,,,
368,530,231,369,530,231,,,-1,0,0,,,,,,
368,531,250,369,530,250,,,-1,1,0,,,,,,
369,531,271,369,530,270,,,0,1,1,,,,,,
369,531,292,369,531,292,,,0,0,0,,,,,,
369,531,313,370,531,313,,,-1,0,0,,,,,,
370,532,336,370,531,335,,,0,1,1,,,,,,
370,532,358,371,532,358,,,-1,0,0,,,,,,
370,532,381,371,532,381,,,-1,0,0,,,,,,
371,532,404,372,532,404,,,-1,0,0,,,,,,
371,533,428,372,533,427,,,-1,0,1,,,,,,
372,533,451,372,533,451,,,0,0,0,,,,,,
373,534,475,373,533,475,,,0,1,0,,,,,,
373,534,499,374,534,499,,,-1,0,0,,,,,,
374,535,524,374,534,523,,,0,1,1,,,,,,
375,535,548,375,535,547,,,0,0,1,,,,,,
375,536,572,376,535,572,,,-1,1,0,,,,,,
376,536,597,377,536,597,,,-1,0,0,,,,,,
377,537,622,377,536,621,,,0,1,1,,,,,,
378,537,646,378,537,646,,,0,0,0,,,,,,
379,538,671,379,538,671,,,0,0,0,,,,,,
380,539,696,380,538,696,,,0,1,0,,,,,,
381,539,721,381,539,721,,,0,0,0,,,,,,
382,540,746,382,540,746,,,0,0,0,,,,,,
383,541,771,383,540,771,,,0,1,0,,,,,,
380,559,152,380,558,152,,,0,1,0,,,,,,
380,559,153,380,558,152,,,0,1,1,,,,,,
380,559,157,380,558,157,,,0,1,0,,,,,,
380,559,164,380,558,165,,,0,1,-1,,,,,,
380,559,174,380,559,173,,,0,0,1,,,,,,
380,559,186,381,559,187,,,-1,0,-1,,,,,,
380,559,201,381,559,200,,,-1,0,1,,,,,,
381,559,217,381,559,218,,,0,0,-1,,,,,,
381,559,235,381,559,235,,,0,0,0,,,,,,
381,559,254,381,559,255,,,0,0,-1,,,,,,
381,560,274,382,559,274,,,-1,1,0,,,,,,
382,560,295,382,559,295,,,0,1,0,,,,,,
382,560,317,382,560,316,,,0,0,1,,,,,,
382,560,339,383,560,338,,,-1,0,1,,,,,,
383,560,361,383,560,361,,,0,0,0,,,,,,
383,561,384,384,560,383,,,-1,1,1,,,,,,
384,561,407,384,561,406,,,0,0,1,,,,,,
384,561,430,384,561,430,,,0,0,0,,,,,,
385,562,454,385,562,453,,,0,0,1,,,,,,
385,562,477,385,562,477,,,0,0,0,,,,,,
386,563,501,386,562,501,,,0,1,0,,,,,,
386,563,525,387,563,525,,,-1,0,0,,,,,,
387,564,550,388,563,549,,,-1,1,1,,,,,,
388,564,574,388,564,574,,,0,0,0,,,,,,
389,565,599,389,564,598,,,0,1,1,,,,,,
389,565,623,390,565,623,,,-1,0,0,,,,,,
390,566,648,391,565,648,,,-1,1,0,,,,,,
391,566,673,392,566,672,,,-1,0,1,,,,,,
392,567,698,393,567,697,,,-1,0,1,,,,,,
393,568,722,393,567,722,,,0,1,0,,,,,,
394,568,747,394,568,747,,,0,0,0,,,,,,
395,569,773,395,569,772,,,0,0,1,,,,,,
393,588,159,393,587,159,,,0,1,0,,,,,,
393,588,160,393,587,159,,,0,1,1,,,,,,
393,588,164,393,587,164,,,0,1,0,,,,,,
393,588,171,393,587,172,,,0,1,-1,,,,,,
393,588,180,393,587,180,,,0,1,0,,,,,,
393,588,192,394,587,193,,,-1,1,-1,,,,,,
393,588,206,394,587,206,,,-1,1,0,,,,,,
394,588,222,394,588,223,,,0,0,-1,,,,,,
394,588,240,394,588,240,,,0,0,0,,,,,,
394,588,259,394,588,259,,,0,0,0,,,,,,
394,588,278,395,588,278,,,-1,0,0,,,,,,
394,589,299,395,588,299,,,-1,1,0,,,,,,
395,589,320,395,588,320,,,0,1,0,,,,,,
395,589,342,396,589,342,,,-1,0,0,,,,,,
396,589,364,396,589,364,,,0,0,0,,,,,,
396,590,386,396,589,386,,,0,1,0,,,,,,
396,590,409,397,589,409,,,-1,1,0,,,,,,
397,590,432,397,590,432,,,0,0,0,,,,,,
397,590,456,398,590,456,,,-1,0,0,,,,,,
398,591,480,398,591,479,,,0,0,1,,,,,,
399,591,503,399,591,503,,,0,0,0,,,,,,
399,592,527,400,591,527,,,-1,1,0,,,,,,
400,592,552,400,592,551,,,0,0,1,,,,,,
400,593,576,401,592,575,,,-1,1,1,,,,,,
401,593,600,402,593,600,,,-1,0,0,,,,,,
402,594,625,402,593,624,,,0,1,1,,,,,,
403,594,649,403,594,649,,,0,0,0,,,,,,
404,595,674,404,594,674,,,0,1,0,,,,,,
404,595,699,405,595,699,,,-1,0,0,,,,,,
405,596,724,406,596,723,,,-1,0,1,,,,,,
406,597,749,407,596,748,,,-1,1,1,,,,,,
407,597,774,408,597,773,,,-1,0,1,,,,,,
406,616,167,407,616,167,,,-1,0,0,,,,,,
406,616,168,407,616,167,,,-1,0,1,,,,,,
406,616,171,407,616,171,,,-1,0,0,,,,,,
406,616,178,407,616,179,,,-1,0,-1,,,,,,
406,617,187,407,616,187,,,-1,1,0,,,,,,
407,617,198,407,616,199,,,0,1,-1,,,,,,
407,617,212,407,616,212,,,0,1,0,,,,,,
407,617,228,407,616,228,,,0,1,0,,,,,,
407,617,245,407,617,244,,,0,0,1,,,,,,
407,617,263,407,617,263,,,0,0,0,,,,,,
407,617,282,408,617,282,,,-1,0,0,,,,,,
408,617,303,408,617,303,,,0,0,0,,,,,,
408,618,324,408,617,323,,,0,1,1,,,,,,
408,618,345,409,617,345,,,-1,1,0,,,,,,
409,618,367,409,618,367,,,0,0,0,,,,,,
409,618,389,409,618,389,,,0,0,0,,,,,,
410,619,412,410,618,412,,,0,1,0,,,,,,
410,619,435,410,619,435,,,0,0,0,,,,,,
410,619,458,411,619,458,,,-1,0,0,,,,,,
411,620,482,411,619,482,,,0,1,0,,,,,,
412,620,506,412,620,505,,,0,0,1,,,,,,
412,620,529,412,620,529,,,0,0,0,,,,,,
413,621,553,413,620,553,,,0,1,0,,,,,,
413,621,578,414,621,577,,,-1,0,1,,,,,,
414,622,602,415,621,602,,,-1,1,0,,,,,,
415,622,626,415,622,626,,,0,0,0,,,,,,
416,623,651,416,622,651,,,0,1,0,,,,,,
416,623,676,417,623,675,,,-1,0,1,,,,,,
417,624,700,418,623,700,,,-1,1,0,,,,,,
418,624,725,419,624,725,,,-1,0,0,,,,,,
419,625,750,420,625,750,,,-1,0,0,,,,,,
420,626,775,420,625,775,,,0,1,0,,,,,,
420,645,175,420,645,174,,,0,0,1,,,,,,
420,645,176,420,645,174,,,0,0,2,,,,,,
420,645,179,420,645,179,,,0,0,0,,,,,,
420,645,185,420,645,186,,,0,0,-1,,,,,,
420,646,194,420,645,193,,,0,1,1,,,,,,
420,646,205,420,645,206,,,0,1,-1,,,,,,
420,646,218,421,645,218,,,-1,1,0,,,,,,
420,646,233,421,645,234,,,-1,1,-1,,,,,,
420,646,250,421,645,250,,,-1,1,0,,,,,,
421,646,268,421,646,268,,,0,0,0,,,,,,
421,646,287,421,646,287,,,0,0,0,,,,,,
421,646,307,421,646,307,,,0,0,0,,,,,,
421,647,327,422,646,327,,,-1,1,0,,,,,,
422,647,348,422,646,348,,,0,1,0,,,,,,
422,647,370,423,647,370,,,-1,0,0,,,,,,
422,647,392,423,647,392,,,-1,0,0,,,,,,
423,647,415,423,647,415,,,0,0,0,,,,,,
423,648,438,424,648,438,,,-1,0,0,,,,,,
424,648,461,424,648,461,,,0,0,0,,,,,,
424,648,484,425,648,484,,,-1,0,0,,,,,,
425,649,508,425,648,507,,,0,1,1,,,,,,
425,649,532,426,649,531,,,-1,0,1,,,,,,
426,650,556,426,649,555,,,0,1,1,,,,,,
427,650,580,427,650,579,,,0,0,1,,,,,,
427,650,604,428,650,604,,,-1,0,0,,,,,,
428,651,628,428,651,628,,,0,0,0,,,,,,
429,651,653,429,651,652,,,0,0,1,,,,,,
430,652,677,430,652,677,,,0,0,0,,,,,,
430,652,702,431,652,702,,,-1,0,0,,,,,,
431,653,727,432,653,726,,,-1,0,1,,,,,,
432,654,752,433,653,751,,,-1,1,1,,,,,,
433,654,777,433,654,776,,,0,0,1,,,,,,
433,674,182,434,674,182,,,-1,0,0,,,,,,
433,674,183,434,674,182,,,-1,0,1,,,,,,
433,674,186,434,674,186,,,-1,0,0,,,,,,
434,675,192,434,674,193,,,0,1,-1,,,,,,
434,675,201,434,674,200,,,0,1,1,,,,,,
434,675,211,434,674,212,,,0,1,-1,,,,,,
434,675,224,434,674,224,,,0,1,0,,,,,,
434,675,239,434,674,240,,,0,1,-1,,,,,,
434,675,255,434,674,255,,,0,1,0,,,,,,
434,675,273,435,675,273,,,-1,0,0,,,,,,
435,675,291,435,675,291,,,0,0,0,,,,,,
435,675,311,435,675,311,,,0,0,0,,,,,,
435,676,331,435,675,331,,,0,1,0,,,,,,
435,676,352,436,675,352,,,-1,1,0,,,,,,
436,676,374,436,676,373,,,0,0,1,,,,,,
436,676,395,436,676,395,,,0,0,0,,,,,,
436,676,418,437,676,418,,,-1,0,0,,,,,,
437,677,441,437,677,440,,,0,0,1,,,,,,
437,677,463,438,677,463,,,-1,0,0,,,,,,
438,677,487,438,677,486,,,0,0,1,,,,,,
438,678,510,439,677,510,,,-1,1,0,,,,,,
439,678,534,439,678,533,,,0,0,1,,,,,,
440,678,558,440,678,557,,,0,0,1,,,,,,
440,679,582,440,679,581,,,0,0,1,,,,,,
441,679,606,441,679,606,,,0,0,0,,,,,,
441,680,630,442,680,630,,,-1,0,0,,,,,,
442,680,655,443,680,654,,,-1,0,1,,,,,,
443,681,679,443,681,679,,,0,0,0,,,,,,
444,681,704,444,681,704,,,0,0,0,,,,,,
445,682,728,445,682,728,,,0,0,0,,,,,,
445,682,753,446,682,753,,,-1,0,0,,,,,,
446,683,778,447,683,778,,,-1,0,0,,,,,,
447,704,190,448,703,190,,,-1,1,0,,,,,,
447,704,191,448,703,190,,,-1,1,1,,,,,,
447,704,194,448,703,194,,,-1,1,0,,,,,,
447,704,199,448,703,200,,,-1,1,-1,,,,,,
448,704,207,448,703,207,,,0,1,0,,,,,,
448,704,218,448,703,219,,,0,1,-1,,,,,,
448,704,230,448,703,230,,,0,1,0,,,,,,
448,704,245,448,703,245,,,0,1,0,,,,,,
448,704,260,448,704,260,,,0,0,0,,,,,,
448,704,278,449,704,278,,,-1,0,0,,,,,,
448,704,296,449,704,296,,,-1,0,0,,,,,,
449,704,315,449,704,315,,,0,0,0,,,,,,
449,705,335,449,704,335,,,0,1,0,,,,,,
449,705,356,450,704,356,,,-1,1,0,,,,,,
450,705,377,450,705,377,,,0,0,0,,,,,,
450,705,399,450,705,399,,,0,0,0,,,,,,
450,705,421,451,705,421,,,-1,0,0,,,,,,
451,706,443,451,706,443,,,0,0,0,,,,,,
451,706,466,451,706,466,,,0,0,0,,,,,,
452,706,489,452,706,489,,,0,0,0,,,,,,
452,707,513,452,706,512,,,0,1,1,,,,,,
453,707,536,453,707,536,,,0,0,0,,,,,,
453,707,560,453,707,559,,,0,0,1,,,,,,
454,708,584,454,708,583,,,0,0,1,,,,,,
454,708,608,455,708,608,,,-1,0,0,,,,,,
455,709,632,455,708,632,,,0,1,0,,,,,,
456,709,656,456,709,656,,,0,0,0,,,,,,
457,709,681,457,709,681,,,0,0,0,,,,,,
457,710,705,458,710,705,,,-1,0,0,,,,,,
458,710,730,458,710,730,,,0,0,0,,,,,,
459,711,755,459,711,754,,,0,0,1,,,,,,
460,712,780,460,711,779,,,0,1,1,,,,,,
461,733,198,462,732,197,,,-1,1,1,,,,,,
461,733,198,462,732,197,,,-1,1,1,,,,,,
461,733,201,462,732,201,,,-1,1,0,,,,,,
462,733,207,462,732,208,,,0,1,-1,,,,,,
462,733,214,462,732,214,,,0,1,0,,,,,,
462,733,224,462,732,225,,,0,1,-1,,,,,,
462,733,237,462,732,236,,,0,1,1,,,,,,
462,733,250,462,733,251,,,0,0,-1,,,,,,
462,733,266,462,733,266,,,0,0,0,,,,,,
462,733,283,463,733,283,,,-1,0,0,,,,,,
462,733,301,463,733,300,,,-1,0,1,,,,,,
463,734,320,463,733,320,,,0,1,0,,,,,,
463,734,339,463,733,339,,,0,1,0,,,,,,
463,734,360,464,734,360,,,-1,0,0,,,,,,
464,734,381,464,734,380,,,0,0,1,,,,,,
464,734,402,464,734,402,,,0,0,0,,,,,,
464,735,424,465,734,424,,,-1,1,0,,,,,,
465,735,446,465,735,446,,,0,0,0,,,,,,
465,735,469,465,735,469,,,0,0,0,,,,,,
466,735,492,466,735,492,,,0,0,0,,,,,,
466,736,515,466,735,515,,,0,1,0,,,,,,
467,736,539,467,736,538,,,0,0,1,,,,,,
467,736,562,467,736,562,,,0,0,0,,,,,,
468,737,586,468,737,586,,,0,0,0,,,,,,
468,737,610,469,737,610,,,-1,0,0,,,,,,
469,737,634,469,737,634,,,0,0,0,,,,,,
470,738,658,470,737,658,,,0,1,0,,,,,,
470,738,683,471,738,682,,,-1,0,1,,,,,,
471,739,707,472,738,707,,,-1,1,0,,,,,,
472,739,732,472,739,731,,,0,0,1,,,,,,
473,740,756,473,739,756,,,0,1,0,,,,,,
473,740,781,474,740,781,,,-1,0,0,,,,,,
476,762,205,476,762,205,,,0,0,0,,,,,,
476,762,206,476,762,205,,,0,0,1,,,,,,
476,762,209,476,762,209,,,0,0,0,,,,,,
476,762,214,476,762,215,,,0,0,-1,,,,,,
476,762,222,476,762,221,,,0,0,1,,,,,,
476,762,231,476,762,232,,,0,0,-1,,,,,,
476,762,243,476,762,243,,,0,0,0,,,,,,
476,762,256,476,762,257,,,0,0,-1,,,,,,
476,762,272,477,762,271,,,-1,0,1,,,,,,
477,762,288,477,762,288,,,0,0,0,,,,,,
477,763,306,477,762,305,,,0,1,1,,,,,,
477,763,324,477,762,324,,,0,1,0,,,,,,
477,763,344,478,763,343,,,-1,0,1,,,,,,
477,763,364,478,763,364,,,-1,0,0,,,,,,
478,763,385,478,763,384,,,0,0,1,,,,,,
478,763,406,478,763,406,,,0,0,0,,,,,,
478,764,428,479,763,427,,,-1,1,1,,,,,,
479,764,450,479,764,449,,,0,0,1,,,,,,
479,764,472,480,764,472,,,-1,0,0,,,,,,
480,764,495,480,764,495,,,0,0,0,,,,,,
480,765,518,481,764,518,,,-1,1,0,,,,,,
481,765,541,481,765,541,,,0,0,0,,,,,,
481,765,565,482,765,564,,,-1,0,1,,,,,,
482,766,588,482,766,588,,,0,0,0,,,,,,
482,766,612,483,766,612,,,-1,0,0,,,,,,
483,767,636,483,766,636,,,0,1,0,,,,,,
484,767,660,484,766,660,,,0,1,0,,,,,,
484,767,685,485,767,684,,,-1,0,1,,,,,,
485,768,709,485,767,709,,,0,1,0,,,,,,
486,768,734,486,768,733,,,0,0,1,,,,,,
487,769,758,487,768,758,,,0,1,0,,,,,,
487,769,783,488,769,783,,,-1,0,0,,,,,,
490,791,213,490,791,213,,,0,0,0,,,,,,
490,791,214,490,791,213,,,0,0,1,,,,,,
490,791,217,490,791,216,,,0,0,1,,,,,,
490,791,221,490,791,222,,,0,0,-1,,,,,,
490,791,229,491,791,228,,,-1,0,1,,,,,,
490,791,238,491,791,239,,,-1,0,-1,,,,,,
490,791,249,491,791,249,,,-1,0,0,,,,,,
491,791,263,491,791,263,,,0,0,0,,,,,,
491,792,277,491,791,277,,,0,1,0,,,,,,
491,792,293,491,791,294,,,0,1,-1,,,,,,
491,792,311,491,791,310,,,0,1,1,,,,,,
491,792,329,492,792,329,,,-1,0,0,,,,,,
492,792,348,492,792,348,,,0,0,0,,,,,,
492,792,368,492,792,368,,,0,0,0,,,,,,
492,792,388,492,792,388,,,0,0,0,,,,,,
492,793,409,493,792,409,,,-1,1,0,,,,,,
493,793,431,493,792,431,,,0,1,0,,,,,,
493,793,453,494,793,453,,,-1,0,0,,,,,,
494,793,475,494,793,475,,,0,0,0,,,,,,
494,794,498,495,793,498,,,-1,1,0,,,,,,
494,794,521,495,793,521,,,-1,1,0,,,,,,
495,794,544,496,794,544,,,-1,0,0,,,,,,
495,795,567,496,794,567,,,-1,1,0,,,,,,
496,795,591,497,795,590,,,-1,0,1,,,,,,
497,795,615,497,795,614,,,0,0,1,,,,,,
497,796,639,498,795,638,,,-1,1,1,,,,,,
498,796,663,498,796,662,,,0,0,1,,,,,,
498,796,687,499,796,686,,,-1,0,1,,,,,,
499,797,711,499,796,711,,,0,1,0,,,,,,
500,797,736,500,797,735,,,0,0,1,,,,,,
501,798,760,501,797,760,,,0,1,0,,,,,,
501,798,785,502,798,784,,,-1,0,1,,,,,,
505,821,221,505,820,221,,,0,1,0,,,,,,
505,821,222,505,820,221,,,0,1,1,,,,,,
505,821,224,505,820,224,,,0,1,0,,,,,,
505,821,229,505,820,230,,,0,1,-1,,,,,,
505,821,236,505,820,236,,,0,1,0,,,,,,
505,821,245,505,820,246,,,0,1,-1,,,,,,
505,821,256,505,821,256,,,0,0,0,,,,,,
505,821,269,505,821,269,,,0,0,0,,,,,,
505,821,283,506,821,283,,,-1,0,0,,,,,,
505,821,299,506,821,299,,,-1,0,0,,,,,,
506,821,316,506,821,315,,,0,0,1,,,,,,
506,821,334,506,821,334,,,0,0,0,,,,,,
506,821,353,506,821,352,,,0,0,1,,,,,,
506,822,372,507,821,372,,,-1,1,0,,,,,,
507,822,392,507,821,392,,,0,1,0,,,,,,
507,822,413,507,821,413,,,0,1,0,,,,,,
507,822,435,508,822,434,,,-1,0,1,,,,,,
508,822,456,508,822,456,,,0,0,0,,,,,,
508,823,478,508,822,478,,,0,1,0,,,,,,
508,823,501,509,822,501,,,-1,1,0,,,,,,
509,823,524,509,823,524,,,0,0,0,,,,,,
509,823,547,510,823,547,,,-1,0,0,,,,,,
510,824,570,510,823,570,,,0,1,0,,,,,,
510,824,593,511,824,593,,,-1,0,0,,,,,,
511,824,617,511,824,617,,,0,0,0,,,,,,
512,825,641,512,824,640,,,0,1,1,,,,,,
512,825,665,512,825,664,,,0,0,1,,,,,,
513,825,689,513,825,688,,,0,0,1,,,,,,
513,826,713,514,825,713,,,-1,1,0,,,,,,
514,826,738,514,826,737,,,0,0,1,,,,,,
515,827,762,515,826,762,,,0,1,0,,,,,,
516,827,787,516,827,786,,,0,0,1,,,,,,
519,850,229,520,849,228,,,-1,1,1,,,,,,
519,850,229,520,849,228,,,-1,1,1,,,,,,
519,850,232,520,850,231,,,-1,0,1,,,,,,
519,850,236,520,850,237,,,-1,0,-1,,,,,,
520,850,243,520,850,243,,,0,0,0,,,,,,
520,850,252,520,850,253,,,0,0,-1,,,,,,
520,850,263,520,850,262,,,0,0,1,,,,,,
520,850,275,520,850,275,,,0,0,0,,,,,,
520,850,289,520,850,289,,,0,0,0,,,,,,
520,850,304,520,850,305,,,0,0,-1,,,,,,
520,850,321,521,850,321,,,-1,0,0,,,,,,
521,851,339,521,850,339,,,0,1,0,,,,,,
521,851,357,521,850,357,,,0,1,0,,,,,,
521,851,377,521,850,377,,,0,1,0,,,,,,
521,851,397,522,851,396,,,-1,0,1,,,,,,
522,851,417,522,851,417,,,0,0,0,,,,,,
522,851,438,522,851,438,,,0,0,0,,,,,,
522,852,460,522,851,460,,,0,1,0,,,,,,
523,852,482,523,851,482,,,0,1,0,,,,,,
523,852,504,523,852,504,,,0,0,0,,,,,,
523,852,527,524,852,527,,,-1,0,0,,,,,,
524,853,550,524,852,550,,,0,1,0,,,,,,
524,853,573,525,853,573,,,-1,0,0,,,,,,
525,853,596,525,853,596,,,0,0,0,,,,,,
525,854,620,526,853,619,,,-1,1,1,,,,,,
526,854,643,526,854,643,,,0,0,0,,,,,,
527,854,667,527,854,667,,,0,0,0,,,,,,
527,855,691,527,854,691,,,0,1,0,,,,,,
528,855,715,528,855,715,,,0,0,0,,,,,,
529,855,740,529,855,739,,,0,0,1,,,,,,
529,856,764,530,856,764,,,-1,0,0,,,,,,
530,856,789,530,856,788,,,0,0,1,,,,,,
534,879,236,534,879,236,,,0,0,0,,,,,,
534,879,237,534,879,236,,,0,0,1,,,,,,
534,879,240,535,879,239,,,-1,0,1,,,,,,
534,879,244,535,879,245,,,-1,0,-1,,,,,,
534,879,250,535,879,250,,,-1,0,0,,,,,,
534,879,259,535,879,260,,,-1,0,-1,,,,,,
535,879,269,535,879,269,,,0,0,0,,,,,,
535,880,281,535,879,282,,,0,1,-1,,,,,,
535,880,295,535,879,295,,,0,1,0,,,,,,
535,880,310,535,879,310,,,0,1,0,,,,,,
535,880,326,535,880,326,,,0,0,0,,,,,,
535,880,344,535,880,344,,,0,0,0,,,,,,
536,880,362,536,880,362,,,0,0,0,,,,,,
536,880,381,536,880,381,,,0,0,0,,,,,,
536,880,401,536,880,401,,,0,0,0,,,,,,
536,881,421,537,880,421,,,-1,1,0,,,,,,
537,881,442,537,881,442,,,0,0,0,,,,,,
537,881,463,537,881,463,,,0,0,0,,,,,,
537,881,485,538,881,485,,,-1,0,0,,,,,,
538,881,507,538,881,507,,,0,0,0,,,,,,
538,882,530,538,881,530,,,0,1,0,,,,,,
539,882,553,539,882,552,,,0,0,1,,,,,,
539,882,576,539,882,575,,,0,0,1,,,,,,
540,883,599,540,882,599,,,0,1,0,,,,,,
540,883,622,540,883,622,,,0,0,0,,,,,,
541,883,646,541,883,645,,,0,0,1,,,,,,
541,884,670,541,883,669,,,0,1,1,,,,,,
542,884,693,542,883,693,,,0,1,0,,,,,,
542,884,718,543,884,717,,,-1,0,1,,,,,,
543,885,742,543,884,741,,,0,1,1,,,,,,
544,885,766,544,885,766,,,0,0,0,,,,,,
544,886,791,545,885,790,,,-1,1,1,,,,,,
259,72,39,259,72,39,,,0,0,0,,,,,,
259,72,44,259,72,39,,,0,0,5,,,,,,
259,72,57,259,72,57,,,0,0,0,,,,,,
259,72,76,259,72,77,,,0,0,-1,,,,,,
259,73,97,259,73,97,,,0,0,0,,,,,,
259,73,119,259,73,119,,,0,0,0,,,,,,
259,74,142,259,74,142,,,0,0,0,,,,,,
259,75,165,259,75,165,,,0,0,0,,,,,,
260,76,189,260,76,189,,,0,0,0,,,,,,
260,78,212,260,77,212,,,0,1,0,,,,,,
261,79,236,261,79,236,,,0,0,0,,,,,,
261,81,261,261,81,260,,,0,0,1,,,,,,
261,83,285,261,83,285,,,0,0,0,,,,,,
262,85,309,262,85,309,,,0,0,0,,,,,,
263,87,334,263,87,334,,,0,0,0,,,,,,
263,90,359,263,89,358,,,0,1,1,,,,,,
264,92,383,264,92,383,,,0,0,0,,,,,,
265,95,408,265,94,408,,,0,1,0,,,,,,
266,97,433,266,97,433,,,0,0,0,,,,,,
266,100,458,266,100,458,,,0,0,0,,,,,,
267,103,483,267,103,483,,,0,0,0,,,,,,
268,106,508,268,106,508,,,0,0,0,,,,,,
269,109,533,269,109,533,,,0,0,0,,,,,,
270,112,558,270,112,558,,,0,0,0,,,,,,
271,115,584,271,115,584,,,0,0,0,,,,,,
273,118,609,272,118,609,,,1,0,0,,,,,,
274,121,634,274,121,634,,,0,0,0,,,,,,
275,125,660,275,124,659,,,0,1,1,,,,,,
276,128,685,276,128,685,,,0,0,0,,,,,,
278,131,710,277,131,710,,,1,0,0,,,,,,
279,135,736,279,135,736,,,0,0,0,,,,,,
281,138,761,280,138,761,,,1,0,0,,,,,,
259,75,40,259,72,39,,,0,3,1,,,,,,
259,75,44,259,72,39,,,0,3,5,,,,,,
259,75,58,259,72,57,,,0,3,1,,,,,,
259,75,76,259,72,77,,,0,3,-1,,,,,,
259,76,97,259,73,97,,,0,3,0,,,,,,
259,76,119,259,73,119,,,0,3,0,,,,,,
259,77,142,259,74,142,,,0,3,0,,,,,,
260,78,165,259,75,165,,,1,3,0,,,,,,
260,80,189,260,76,189,,,0,4,0,,,,,,
260,81,212,260,77,212,,,0,4,0,,,,,,
261,82,236,261,79,236,,,0,3,0,,,,,,
261,84,261,261,81,260,,,0,3,1,,,,,,
262,86,285,261,83,285,,,1,3,0,,,,,,
262,88,309,262,85,309,,,0,3,0,,,,,,
263,90,334,263,87,334,,,0,3,0,,,,,,
263,92,359,263,89,358,,,0,3,1,,,,,,
264,95,383,264,92,383,,,0,3,0,,,,,,
265,97,408,265,94,408,,,0,3,0,,,,,,
266,100,433,266,97,433,,,0,3,0,,,,,,
267,102,458,266,100,458,,,1,2,0,,,,,,
268,105,483,267,103,483,,,1,2,0,,,,,,
268,108,508,268,106,508,,,0,2,0,,,,,,
269,111,533,269,109,533,,,0,2,0,,,,,,
271,114,558,270,112,558,,,1,2,0,,,,,,
272,117,584,271,115,584,,,1,2,0,,,,,,
273,120,609,272,118,609,,,1,2,0,,,,,,
274,123,634,274,121,634,,,0,2,0,,,,,,
275,126,660,275,124,659,,,0,2,1,,,,,,
277,130,685,276,128,685,,,1,2,0,,,,,,
278,133,710,277,131,710,,,1,2,0,,,,,,
279,136,736,279,135,736,,,0,1,0,,,,,,
281,140,761,280,138,761,,,1,2,0,,,,,,
260,86,41,260,86,41,,,0,0,0,,,,,,
260,86,45,260,86,41,,,0,0,4,,,,,,
260,86,59,260,86,59,,,0,0,0,,,,,,
260,86,77,260,86,78,,,0,0,-1,,,,,,
260,87,97,260,87,97,,,0,0,0,,,,,,
260,87,119,260,87,119,,,0,0,0,,,,,,
260,88,142,260,88,142,,,0,0,0,,,,,,
261,89,165,260,89,165,,,1,0,0,,,,,,
261,90,189,261,90,189,,,0,0,0,,,,,,
261,91,213,261,91,213,,,0,0,0,,,,,,
262,92,237,262,92,237,,,0,0,0,,,,,,
262,94,261,262,93,261,,,0,1,0,,,,,,
263,95,285,263,95,285,,,0,0,0,,,,,,
263,97,310,263,97,309,,,0,0,1,,,,,,
264,99,334,264,99,334,,,0,0,0,,,,,,
264,101,359,264,101,359,,,0,0,0,,,,,,
265,103,384,265,103,384,,,0,0,0,,,,,,
266,105,408,266,105,408,,,0,0,0,,,,,,
267,108,433,267,108,433,,,0,0,0,,,,,,
267,110,458,267,110,458,,,0,0,0,,,,,,
268,113,483,268,113,483,,,0,0,0,,,,,,
269,115,508,269,115,508,,,0,0,0,,,,,,
270,118,533,270,118,533,,,0,0,0,,,,,,
271,121,559,271,121,558,,,0,0,1,,,,,,
272,124,584,272,124,584,,,0,0,0,,,,,,
274,127,609,273,127,609,,,1,0,0,,,,,,
275,130,634,275,130,634,,,0,0,0,,,,,,
276,133,660,276,133,659,,,0,0,1,,,,,,
277,136,685,277,136,685,,,0,0,0,,,,,,
279,139,711,278,139,710,,,1,0,1,,,,,,
280,142,736,280,142,736,,,0,0,0,,,,,,
282,146,762,281,145,761,,,1,1,1,,,,,,
261,103,44,262,105,44,,,-1,-2,0,,,,,,
261,103,48,262,105,44,,,-1,-2,4,,,,,,
261,103,60,262,105,61,,,-1,-2,-1,,,,,,
261,103,78,262,105,79,,,-1,-2,-1,,,,,,
262,104,98,262,105,98,,,0,-1,0,,,,,,
262,104,120,262,106,120,,,0,-2,0,,,,,,
262,105,143,262,106,143,,,0,-1,0,,,,,,
262,105,166,262,107,166,,,0,-2,0,,,,,,
262,106,189,263,108,189,,,-1,-2,0,,,,,,
263,107,213,263,109,213,,,0,-2,0,,,,,,
263,108,237,264,110,237,,,-1,-2,0,,,,,,
264,110,261,264,111,261,,,0,-1,0,,,,,,
264,111,285,264,112,285,,,0,-1,0,,,,,,
265,112,310,265,114,310,,,0,-2,0,,,,,,
265,114,334,266,116,334,,,-1,-2,0,,,,,,
266,116,359,266,117,359,,,0,-1,0,,,,,,
267,118,384,267,119,384,,,0,-1,0,,,,,,
267,119,409,267,121,408,,,0,-2,1,,,,,,
268,122,433,268,123,433,,,0,-1,0,,,,,,
269,124,458,269,125,458,,,0,-1,0,,,,,,
270,126,483,270,128,483,,,0,-2,0,,,,,,
271,128,508,271,130,508,,,0,-2,0,,,,,,
272,131,533,272,132,533,,,0,-1,0,,,,,,
273,133,559,273,135,558,,,0,-2,1,,,,,,
274,136,584,274,138,584,,,0,-2,0,,,,,,
275,138,609,275,140,609,,,0,-2,0,,,,,,
276,141,634,277,143,634,,,-1,-2,0,,,,,,
278,144,660,278,146,659,,,0,-2,1,,,,,,
279,147,685,279,149,685,,,0,-2,0,,,,,,
280,150,711,280,151,710,,,0,-1,1,,,,,,
282,153,736,282,154,736,,,0,-1,0,,,,,,
283,156,762,283,157,761,,,0,-1,1,,,,,,
264,124,47,264,124,47,,,0,0,0,,,,,,
264,124,51,264,124,47,,,0,0,4,,,,,,
264,124,63,264,124,63,,,0,0,0,,,,,,
264,124,80,264,124,81,,,0,0,-1,,,,,,
264,124,100,264,124,100,,,0,0,0,,,,,,
264,125,121,264,124,122,,,0,1,-1,,,,,,
264,125,144,264,125,144,,,0,0,0,,,,,,
265,126,167,264,125,167,,,1,1,0,,,,,,
265,126,190,265,126,190,,,0,0,0,,,,,,
265,127,214,265,127,214,,,0,0,0,,,,,,
266,128,238,266,128,238,,,0,0,0,,,,,,
266,129,262,266,129,262,,,0,0,0,,,,,,
266,130,286,266,130,286,,,0,0,0,,,,,,
267,132,310,267,131,310,,,0,1,0,,,,,,
268,133,335,268,133,335,,,0,0,0,,,,,,
268,134,359,268,134,359,,,0,0,0,,,,,,
269,136,384,269,136,384,,,0,0,0,,,,,,
270,138,409,269,137,409,,,1,1,0,,,,,,
270,139,434,270,139,434,,,0,0,0,,,,,,
271,141,459,271,141,459,,,0,0,0,,,,,,
272,143,484,272,143,484,,,0,0,0,,,,,,
273,145,509,273,145,509,,,0,0,0,,,,,,
274,147,534,274,147,534,,,0,0,0,,,,,,
275,149,559,275,149,559,,,0,0,0,,,,,,
276,152,584,276,152,584,,,0,0,0,,,,,,
277,154,609,277,154,609,,,0,0,0,,,,,,
279,157,635,279,157,635,,,0,0,0,,,,,,
280,159,660,280,159,660,,,0,0,0,,,,,,
281,162,685,281,162,685,,,0,0,0,,,,,,
283,164,711,282,164,710,,,1,0,1,,,,,,
284,167,736,284,167,736,,,0,0,0,,,,,,
285,170,762,285,169,761,,,0,1,1,,,,,,
267,147,52,267,148,52,,,0,-1,0,,,,,,
267,147,55,267,148,52,,,0,-1,3,,,,,,
267,147,66,267,148,66,,,0,-1,0,,,,,,
267,147,83,267,148,84,,,0,-1,-1,,,,,,
267,147,102,267,148,102,,,0,-1,0,,,,,,
267,148,123,267,148,123,,,0,0,0,,,,,,
267,148,145,267,149,145,,,0,-1,0,,,,,,
268,149,168,268,149,168,,,0,0,0,,,,,,
268,149,191,268,150,191,,,0,-1,0,,,,,,
268,150,215,269,150,214,,,-1,0,1,,,,,,
269,151,238,269,151,238,,,0,0,0,,,,,,
269,152,262,269,152,262,,,0,0,0,,,,,,
270,152,287,270,153,286,,,0,-1,1,,,,,,
270,154,311,270,154,311,,,0,0,0,,,,,,
271,155,335,271,155,335,,,0,0,0,,,,,,
271,156,360,272,156,360,,,-1,0,0,,,,,,
272,157,385,272,158,384,,,0,-1,1,,,,,,
273,159,409,273,159,409,,,0,0,0,,,,,,
274,160,434,273,161,434,,,1,-1,0,,,,,,
274,162,459,274,162,459,,,0,0,0,,,,,,
275,163,484,275,164,484,,,0,-1,0,,,,,,
276,165,509,276,166,509,,,0,-1,0,,,,,,
277,167,534,277,168,534,,,0,-1,0,,,,,,
278,169,559,278,170,559,,,0,-1,0,,,,,,
279,171,584,279,172,584,,,0,-1,0,,,,,,
280,173,610,280,174,609,,,0,-1,1,,,,,,
282,175,635,282,176,635,,,0,-1,0,,,,,,
283,177,660,283,178,660,,,0,-1,0,,,,,,
284,180,686,284,181,685,,,0,-1,1,,,,,,
285,182,711,286,183,711,,,-1,-1,0,,,,,,
287,184,736,287,185,736,,,0,-1,0,,,,,,
288,187,762,288,188,762,,,0,-1,0,,,,,,
271,172,57,271,172,57,,,0,0,0,,,,,,
271,172,60,271,172,57,,,0,0,3,,,,,,
271,172,70,271,172,70,,,0,0,0,,,,,,
271,172,86,271,172,87,,,0,0,-1,,,,,,
271,172,104,271,172,104,,,0,0,0,,,,,,
271,172,125,271,172,125,,,0,0,0,,,,,,
271,173,147,271,173,147,,,0,0,0,,,,,,
272,173,169,271,173,169,,,1,0,0,,,,,,
272,174,192,272,174,192,,,0,0,0,,,,,,
272,174,216,272,174,215,,,0,0,1,,,,,,
273,175,239,273,175,239,,,0,0,0,,,,,,
273,175,263,273,175,263,,,0,0,0,,,,,,
274,176,287,274,176,287,,,0,0,0,,,,,,
274,177,312,274,177,311,,,0,0,1,,,,,,
275,178,336,275,178,336,,,0,0,0,,,,,,
275,179,360,275,179,360,,,0,0,0,,,,,,
276,180,385,276,180,385,,,0,0,0,,,,,,
277,182,410,276,181,410,,,1,1,0,,,,,,
277,183,435,277,183,435,,,0,0,0,,,,,,
278,184,459,278,184,459,,,0,0,0,,,,,,
279,186,484,279,186,484,,,0,0,0,,,,,,
280,187,509,280,187,509,,,0,0,0,,,,,,
281,189,534,281,189,534,,,0,0,0,,,,,,
282,190,560,282,190,559,,,0,0,1,,,,,,
283,192,585,283,192,585,,,0,0,0,,,,,,
284,194,610,284,194,610,,,0,0,0,,,,,,
285,196,635,285,196,635,,,0,0,0,,,,,,
287,198,661,286,198,660,,,1,0,1,,,,,,
288,200,686,288,200,686,,,0,0,0,,,,,,
289,202,711,289,202,711,,,0,0,0,,,,,,
291,204,737,291,204,737,,,0,0,0,,,,,,
292,206,762,292,206,762,,,0,0,0,,,,,,
276,197,62,276,198,62,,,0,-1,0,,,,,,
276,197,65,276,198,62,,,0,-1,3,,,,,,
276,197,74,276,198,74,,,0,-1,0,,,,,,
276,197,89,276,198,91,,,0,-1,-2,,,,,,
276,198,107,276,198,107,,,0,0,0,,,,,,
276,198,127,276,198,128,,,0,0,-1,,,,,,
276,198,149,276,198,149,,,0,0,0,,,,,,
276,198,171,276,199,171,,,0,-1,0,,,,,,
277,199,194,277,199,194,,,0,0,0,,,,,,
277,199,217,277,200,217,,,0,-1,0,,,,,,
277,200,241,278,200,240,,,-1,0,1,,,,,,
278,201,264,278,201,264,,,0,0,0,,,,,,
278,201,288,279,201,288,,,-1,0,0,,,,,,
279,202,312,279,202,312,,,0,0,0,,,,,,
279,203,337,280,203,337,,,-1,0,0,,,,,,
280,204,361,280,204,361,,,0,0,0,,,,,,
281,205,386,281,205,386,,,0,0,0,,,,,,
281,206,410,281,206,410,,,0,0,0,,,,,,
282,207,435,282,207,435,,,0,0,0,,,,,,
283,208,460,283,208,460,,,0,0,0,,,,,,
284,209,485,284,210,485,,,0,-1,0,,,,,,
285,211,510,285,211,509,,,0,0,1,,,,,,
286,212,535,286,213,534,,,0,-1,1,,,,,,
287,214,560,287,214,560,,,0,0,0,,,,,,
288,215,585,288,215,585,,,0,0,0,,,,,,
289,217,610,289,217,610,,,0,0,0,,,,,,
290,218,636,290,219,635,,,0,-1,1,,,,,,
291,220,661,291,220,661,,,0,0,0,,,,,,
292,222,686,293,222,686,,,-1,0,0,,,,,,
294,224,712,294,224,711,,,0,0,1,,,,,,
295,226,737,295,226,737,,,0,0,0,,,,,,
296,228,763,296,228,762,,,0,0,1,,,,,,
281,224,68,281,224,68,,,0,0,0,,,,,,
281,224,71,281,224,68,,,0,0,3,,,,,,
281,224,79,281,224,79,,,0,0,0,,,,,,
281,224,93,281,224,95,,,0,0,-2,,,,,,
281,224,111,281,224,111,,,0,0,0,,,,,,
282,224,130,281,224,131,,,1,0,-1,,,,,,
282,224,151,282,224,151,,,0,0,0,,,,,,
282,225,173,282,224,173,,,0,1,0,,,,,,
282,225,196,282,225,196,,,0,0,0,,,,,,
283,225,219,282,225,219,,,1,0,0,,,,,,
283,226,242,283,226,242,,,0,0,0,,,,,,
283,226,266,283,226,265,,,0,0,1,,,,,,
284,227,289,284,227,289,,,0,0,0,,,,,,
284,228,314,284,227,313,,,0,1,1,,,,,,
285,228,338,285,228,338,,,0,0,0,,,,,,
285,229,362,285,229,362,,,0,0,0,,,,,,
286,230,387,286,230,387,,,0,0,0,,,,,,
287,231,411,287,231,411,,,0,0,0,,,,,,
288,232,436,288,232,436,,,0,0,0,,,,,,
288,233,461,288,233,461,,,0,0,0,,,,,,
289,234,486,289,234,486,,,0,0,0,,,,,,
290,235,510,290,235,510,,,0,0,0,,,,,,
291,237,535,291,237,535,,,0,0,0,,,,,,
292,238,561,292,238,560,,,0,0,1,,,,,,
293,239,586,293,239,586,,,0,0,0,,,,,,
294,241,611,294,240,611,,,0,1,0,,,,,,
295,242,636,295,242,636,,,0,0,0,,,,,,
296,244,661,296,243,661,,,0,1,0,,,,,,
298,245,687,298,245,687,,,0,0,0,,,,,,
299,247,712,299,247,712,,,0,0,0,,,,,,
300,249,737,300,249,737,,,0,0,0,,,,,,
302,250,763,301,250,762,,,1,0,1,,,,,,
288,250,74,288,250,74,,,0,0,0,,,,,,
288,250,77,288,250,74,,,0,0,3,,,,,,
288,250,85,288,250,84,,,0,0,1,,,,,,
288,250,98,288,250,99,,,0,0,-1,,,,,,
288,251,114,288,251,115,,,0,0,-1,,,,,,
288,251,133,288,251,134,,,0,0,-1,,,,,,
288,251,154,288,251,154,,,0,0,0,,,,,,
288,251,175,288,251,176,,,0,0,-1,,,,,,
289,252,198,289,252,198,,,0,0,0,,,,,,
289,252,220,289,252,220,,,0,0,0,,,,,,
289,252,244,289,252,243,,,0,0,1,,,,,,
290,253,267,290,253,267,,,0,0,0,,,,,,
290,253,291,290,253,290,,,0,0,1,,,,,,
291,254,315,291,254,314,,,0,0,1,,,,,,
291,255,339,291,254,339,,,0,1,0,,,,,,
292,255,363,292,255,363,,,0,0,0,,,,,,
292,256,388,292,256,388,,,0,0,0,,,,,,
293,257,412,293,257,412,,,0,0,0,,,,,,
294,258,437,294,258,437,,,0,0,0,,,,,,
294,259,461,295,259,461,,,-1,0,0,,,,,,
295,260,486,295,260,486,,,0,0,0,,,,,,
296,261,511,296,261,511,,,0,0,0,,,,,,
297,262,536,297,262,536,,,0,0,0,,,,,,
298,263,561,298,263,561,,,0,0,0,,,,,,
299,264,586,299,264,586,,,0,0,0,,,,,,
300,266,611,300,265,611,,,0,1,0,,,,,,
301,267,637,301,267,636,,,0,0,1,,,,,,
302,268,662,302,268,662,,,0,0,0,,,,,,
304,270,687,304,270,687,,,0,0,0,,,,,,
305,271,713,305,271,712,,,0,0,1,,,,,,
306,273,738,306,273,737,,,0,0,1,,,,,,
307,274,763,307,275,763,,,0,-1,0,,,,,,
295,277,81,295,277,81,,,0,0,0,,,,,,
295,277,83,295,277,81,,,0,0,2,,,,,,
295,277,90,295,277,90,,,0,0,0,,,,,,
295,278,103,295,277,104,,,0,1,-1,,,,,,
295,278,119,295,278,119,,,0,0,0,,,,,,
295,278,137,295,278,138,,,0,0,-1,,,,,,
295,278,157,295,278,157,,,0,0,0,,,,,,
295,278,178,295,278,178,,,0,0,0,,,,,,
296,279,200,296,279,200,,,0,0,0,,,,,,
296,279,222,296,279,222,,,0,0,0,,,,,,
296,279,245,296,279,245,,,0,0,0,,,,,,
297,280,269,296,279,268,,,1,1,1,,,,,,
297,280,292,297,280,292,,,0,0,0,,,,,,
298,281,316,297,280,316,,,1,1,0,,,,,,
298,281,340,298,281,340,,,0,0,0,,,,,,
299,282,364,298,282,364,,,1,0,0,,,,,,
299,283,389,299,283,389,,,0,0,0,,,,,,
300,283,413,300,283,413,,,0,0,0,,,,,,
301,284,438,301,284,438,,,0,0,0,,,,,,
301,285,462,301,285,462,,,0,0,0,,,,,,
302,286,487,302,286,487,,,0,0,0,,,,,,
303,287,512,303,287,512,,,0,0,0,,,,,,
304,288,537,304,288,537,,,0,0,0,,,,,,
305,289,562,305,289,562,,,0,0,0,,,,,,
306,290,587,306,290,587,,,0,0,0,,,,,,
307,291,612,307,291,612,,,0,0,0,,,,,,
308,292,637,308,292,637,,,0,0,0,,,,,,
309,294,662,309,293,662,,,0,1,0,,,,,,
310,295,688,310,295,688,,,0,0,0,,,,,,
311,296,713,311,296,713,,,0,0,0,,,,,,
313,298,738,313,298,738,,,0,0,0,,,,,,
314,299,764,314,299,763,,,0,0,1,,,,,,
302,305,88,303,305,87,,,-1,0,1,,,,,,
302,305,90,303,305,87,,,-1,0,3,,,,,,
302,305,96,303,305,96,,,-1,0,0,,,,,,
303,305,108,303,305,110,,,0,0,-2,,,,,,
303,305,123,303,305,123,,,0,0,0,,,,,,
303,305,141,303,305,142,,,0,0,-1,,,,,,
303,305,160,303,305,160,,,0,0,0,,,,,,
303,306,181,303,305,181,,,0,1,0,,,,,,
303,306,202,304,306,202,,,-1,0,0,,,,,,
304,306,225,304,306,225,,,0,0,0,,,,,,
304,307,247,304,306,247,,,0,1,0,,,,,,
304,307,270,304,307,270,,,0,0,0,,,,,,
305,307,294,305,307,294,,,0,0,0,,,,,,
305,308,318,305,308,317,,,0,0,1,,,,,,
306,308,342,306,308,341,,,0,0,1,,,,,,
306,309,366,306,309,365,,,0,0,1,,,,,,
307,310,390,307,310,390,,,0,0,0,,,,,,
308,310,414,307,310,414,,,1,0,0,,,,,,
308,311,439,308,311,439,,,0,0,0,,,,,,
309,312,463,309,312,463,,,0,0,0,,,,,,
310,313,488,310,313,488,,,0,0,0,,,,,,
311,313,513,311,313,513,,,0,0,0,,,,,,
311,314,538,312,314,538,,,-1,0,0,,,,,,
312,315,563,312,315,563,,,0,0,0,,,,,,
313,316,588,313,316,588,,,0,0,0,,,,,,
314,317,613,314,317,613,,,0,0,0,,,,,,
315,318,638,315,318,638,,,0,0,0,,,,,,
316,319,663,316,319,663,,,0,0,0,,,,,,
318,321,688,317,321,688,,,1,0,0,,,,,,
319,322,714,319,322,713,,,0,0,1,,,,,,
320,323,739,320,323,739,,,0,0,0,,,,,,
321,325,764,321,325,764,,,0,0,0,,,,,,
311,333,94,311,333,94,,,0,0,0,,,,,,
311,333,96,311,333,94,,,0,0,2,,,,,,
311,333,103,311,333,103,,,0,0,0,,,,,,
311,333,113,311,333,115,,,0,0,-2,,,,,,
311,333,128,311,333,128,,,0,0,0,,,,,,
311,333,145,311,333,146,,,0,0,-1,,,,,,
311,333,164,311,333,164,,,0,0,0,,,,,,
311,333,184,311,333,184,,,0,0,0,,,,,,
312,333,205,312,333,205,,,0,0,0,,,,,,
312,334,227,312,333,227,,,0,1,0,,,,,,
312,334,250,312,334,250,,,0,0,0,,,,,,
313,334,273,312,334,273,,,1,0,0,,,,,,
313,335,296,313,335,296,,,0,0,0,,,,,,
314,335,319,313,335,319,,,1,0,0,,,,,,
314,336,343,314,336,343,,,0,0,0,,,,,,
315,336,367,314,336,367,,,1,0,0,,,,,,
315,337,391,315,337,391,,,0,0,0,,,,,,
316,337,415,315,337,415,,,1,0,0,,,,,,
316,338,440,316,338,440,,,0,0,0,,,,,,
317,339,464,317,339,464,,,0,0,0,,,,,,
318,340,489,318,340,489,,,0,0,0,,,,,,
319,340,514,319,340,514,,,0,0,0,,,,,,
320,341,539,320,341,539,,,0,0,0,,,,,,
320,342,564,320,342,564,,,0,0,0,,,,,,
321,343,589,321,343,589,,,0,0,0,,,,,,
322,344,614,322,344,614,,,0,0,0,,,,,,
323,345,639,323,345,639,,,0,0,0,,,,,,
324,346,664,324,346,664,,,0,0,0,,,,,,
325,347,689,325,347,689,,,0,0,0,,,,,,
327,348,714,326,348,714,,,1,0,0,,,,,,
328,349,740,328,349,740,,,0,0,0,,,,,,
329,350,765,329,350,765,,,0,0,0,,,,,,
320,360,101,320,361,101,,,0,-1,0,,,,,,
320,360,103,320,361,101,,,0,-1,2,,,,,,
320,360,109,320,361,109,,,0,-1,0,,,,,,
320,361,119,320,361,121,,,0,0,-2,,,,,,
320,361,133,320,361,133,,,0,0,0,,,,,,
320,361,149,320,361,150,,,0,0,-1,,,,,,
320,361,168,320,361,168,,,0,0,0,,,,,,
320,361,187,320,361,188,,,0,0,-1,,,,,,
321,361,208,321,361,208,,,0,0,0,,,,,,
321,362,230,321,361,230,,,0,1,0,,,,,,
321,362,252,321,362,252,,,0,0,0,,,,,,
322,362,275,322,362,275,,,0,0,0,,,,,,
322,363,298,322,362,298,,,0,1,0,,,,,,
322,363,321,322,363,321,,,0,0,0,,,,,,
323,363,345,323,363,345,,,0,0,0,,,,,,
323,364,369,323,364,368,,,0,0,1,,,,,,
324,364,393,324,364,392,,,0,0,1,,,,,,
325,365,417,324,365,417,,,1,0,0,,,,,,
325,366,441,325,365,441,,,0,1,0,,,,,,
326,366,466,326,366,466,,,0,0,0,,,,,,
327,367,490,327,367,490,,,0,0,0,,,,,,
327,368,515,328,367,515,,,-1,1,0,,,,,,
328,368,540,329,368,540,,,-1,0,0,,,,,,
329,369,565,329,369,565,,,0,0,0,,,,,,
330,370,590,330,370,590,,,0,0,0,,,,,,
331,371,615,331,371,615,,,0,0,0,,,,,,
332,372,640,332,372,640,,,0,0,0,,,,,,
333,373,665,333,373,665,,,0,0,0,,,,,,
334,374,690,334,374,690,,,0,0,0,,,,,,
335,375,715,335,375,715,,,0,0,0,,,,,,
336,376,740,336,376,740,,,0,0,0,,,,,,
338,377,766,337,377,766,,,1,0,0,,,,,,
329,389,109,329,389,109,,,0,0,0,,,,,,
329,389,110,329,389,109,,,0,0,1,,,,,,
329,389,116,329,389,116,,,0,0,0,,,,,,
329,389,125,329,389,127,,,0,0,-2,,,,,,
330,389,138,330,389,138,,,0,0,0,,,,,,
330,389,154,330,389,155,,,0,0,-1,,,,,,
330,389,172,330,389,172,,,0,0,0,,,,,,
330,389,191,330,389,192,,,0,0,-1,,,,,,
330,389,212,330,389,212,,,0,0,0,,,,,,
330,390,233,330,389,233,,,0,1,0,,,,,,
331,390,255,331,390,255,,,0,0,0,,,,,,
331,390,277,331,390,277,,,0,0,0,,,,,,
332,390,300,332,390,300,,,0,0,0,,,,,,
332,391,323,332,390,323,,,0,1,0,,,,,,
332,391,347,332,391,347,,,0,0,0,,,,,,
333,392,370,332,391,370,,,1,1,0,,,,,,
333,392,394,333,392,394,,,0,0,0,,,,,,
334,393,418,334,392,418,,,0,1,0,,,,,,
335,393,443,335,393,443,,,0,0,0,,,,,,
335,394,467,335,393,467,,,0,1,0,,,,,,
336,394,492,336,394,492,,,0,0,0,,,,,,
337,395,516,337,395,516,,,0,0,0,,,,,,
338,396,541,338,396,541,,,0,0,0,,,,,,
338,396,566,338,396,566,,,0,0,0,,,,,,
339,397,591,339,397,591,,,0,0,0,,,,,,
340,398,616,340,398,616,,,0,0,0,,,,,,
341,399,641,341,399,641,,,0,0,0,,,,,,
342,400,666,342,400,666,,,0,0,0,,,,,,
343,401,691,343,401,691,,,0,0,0,,,,,,
344,402,716,344,402,716,,,0,0,0,,,,,,
345,403,741,345,403,741,,,0,0,0,,,,,,
347,404,767,346,404,766,,,1,0,1,,,,,,
339,417,116,339,417,116,,,0,0,0,,,,,,
339,417,117,339,417,116,,,0,0,1,,,,,,
339,417,122,339,417,122,,,0,0,0,,,,,,
339,417,131,339,417,133,,,0,0,-2,,,,,,
340,417,144,340,417,144,,,0,0,0,,,,,,
340,417,159,340,417,160,,,0,0,-1,,,,,,
340,417,176,340,417,176,,,0,0,0,,,,,,
340,417,195,340,417,196,,,0,0,-1,,,,,,
340,417,215,340,417,215,,,0,0,0,,,,,,
341,418,236,340,417,236,,,1,1,0,,,,,,
341,418,258,341,418,258,,,0,0,0,,,,,,
341,418,280,341,418,280,,,0,0,0,,,,,,
341,418,302,342,418,302,,,-1,0,0,,,,,,
342,419,325,342,418,325,,,0,1,0,,,,,,
342,419,349,342,419,349,,,0,0,0,,,,,,
343,420,372,343,419,372,,,0,1,0,,,,,,
343,420,396,343,420,396,,,0,0,0,,,,,,
344,421,420,344,420,420,,,0,1,0,,,,,,
345,421,444,345,421,444,,,0,0,0,,,,,,
345,422,469,345,421,468,,,0,1,1,,,,,,
346,422,493,346,422,493,,,0,0,0,,,,,,
347,423,517,347,422,517,,,0,1,0,,,,,,
347,423,542,348,423,542,,,-1,0,0,,,,,,
348,424,567,348,424,567,,,0,0,0,,,,,,
349,425,592,349,425,592,,,0,0,0,,,,,,
350,426,617,350,425,617,,,0,1,0,,,,,,
351,426,642,351,426,642,,,0,0,0,,,,,,
352,427,667,352,427,667,,,0,0,0,,,,,,
353,428,692,353,428,692,,,0,0,0,,,,,,
354,429,717,354,429,717,,,0,0,0,,,,,,
355,430,742,355,430,742,,,0,0,0,,,,,,
356,431,767,356,431,767,,,0,0,0,,,,,,
350,445,123,350,445,123,,,0,0,0,,,,,,
350,445,124,350,445,123,,,0,0,1,,,,,,
350,445,129,350,445,129,,,0,0,0,,,,,,
350,445,138,350,445,139,,,0,0,-1,,,,,,
350,445,150,350,445,150,,,0,0,0,,,,,,
350,445,164,350,445,165,,,0,0,-1,,,,,,
350,445,181,350,445,181,,,0,0,0,,,,,,
351,446,199,350,445,200,,,1,1,-1,,,,,,
351,446,219,351,446,219,,,0,0,0,,,,,,
351,446,239,351,446,240,,,0,0,-1,,,,,,
351,446,261,351,446,261,,,0,0,0,,,,,,
352,446,283,351,446,283,,,1,0,0,,,,,,
352,447,305,352,447,305,,,0,0,0,,,,,,
352,447,328,352,447,328,,,0,0,0,,,,,,
353,447,351,353,447,351,,,0,0,0,,,,,,
353,448,374,353,447,374,,,0,1,0,,,,,,
354,448,398,354,448,398,,,0,0,0,,,,,,
354,449,422,354,448,422,,,0,1,0,,,,,,
355,449,446,355,449,446,,,0,0,0,,,,,,
356,450,470,355,449,470,,,1,1,0,,,,,,
356,450,494,356,450,494,,,0,0,0,,,,,,
357,451,519,357,450,518,,,0,1,1,,,,,,
358,451,543,358,451,543,,,0,0,0,,,,,,
358,452,568,358,452,568,,,0,0,0,,,,,,
359,453,593,359,453,593,,,0,0,0,,,,,,
360,453,618,360,453,618,,,0,0,0,,,,,,
361,454,643,361,454,643,,,0,0,0,,,,,,
362,455,668,362,455,668,,,0,0,0,,,,,,
363,456,693,363,456,693,,,0,0,0,,,,,,
364,456,718,364,456,718,,,0,0,0,,,,,,
365,457,743,365,457,743,,,0,0,0,,,,,,
366,458,768,366,458,768,,,0,0,0,,,,,,
361,473,130,361,473,130,,,0,0,0,,,,,,
361,473,132,361,473,130,,,0,0,2,,,,,,
361,474,136,361,473,136,,,0,1,0,,,,,,
361,474,144,361,473,146,,,0,1,-2,,,,,,
361,474,156,361,473,156,,,0,1,0,,,,,,
361,474,170,361,473,171,,,0,1,-1,,,,,,
361,474,186,361,473,186,,,0,1,0,,,,,,
362,474,204,361,474,204,,,1,0,0,,,,,,
362,474,223,362,474,223,,,0,0,0,,,,,,
362,474,243,362,474,243,,,0,0,0,,,,,,
362,474,264,362,474,264,,,0,0,0,,,,,,
363,475,286,362,474,286,,,1,1,0,,,,,,
363,475,308,363,475,308,,,0,0,0,,,,,,
363,475,330,363,475,330,,,0,0,0,,,,,,
364,476,353,364,475,353,,,0,1,0,,,,,,
364,476,377,364,476,376,,,0,0,1,,,,,,
365,476,400,365,476,400,,,0,0,0,,,,,,
365,477,424,365,477,424,,,0,0,0,,,,,,
366,477,448,366,477,448,,,0,0,0,,,,,,
366,478,472,366,477,472,,,0,1,0,,,,,,
367,478,496,367,478,496,,,0,0,0,,,,,,
368,479,520,367,478,520,,,1,1,0,,,,,,
368,479,545,368,479,544,,,0,0,1,,,,,,
369,480,570,369,480,569,,,0,0,1,,,,,,
370,481,594,370,481,594,,,0,0,0,,,,,,
371,481,619,371,481,619,,,0,0,0,,,,,,
372,482,644,372,482,644,,,0,0,0,,,,,,
373,483,669,372,482,669,,,1,1,0,,,,,,
373,483,694,373,483,694,,,0,0,0,,,,,,
374,484,719,374,484,719,,,0,0,0,,,,,,
375,485,744,375,485,744,,,0,0,0,,,,,,
377,486,769,376,485,769,,,1,1,0,,,,,,
372,502,138,372,502,138,,,0,0,0,,,,,,
372,502,139,372,502,138,,,0,0,1,,,,,,
372,502,143,372,502,143,,,0,0,0,,,,,,
372,502,151,372,502,152,,,0,0,-1,,,,,,
372,502,162,372,502,162,,,0,0,0,,,,,,
373,502,175,372,502,176,,,1,0,-1,,,,,,
373,502,191,373,502,191,,,0,0,0,,,,,,
373,502,208,373,502,209,,,0,0,-1,,,,,,
373,503,227,373,503,227,,,0,0,0,,,,,,
373,503,247,373,503,247,,,0,0,0,,,,,,
374,503,267,374,503,267,,,0,0,0,,,,,,
374,503,289,374,503,289,,,0,0,0,,,,,,
374,503,311,374,503,311,,,0,0,0,,,,,,
375,504,333,374,503,333,,,1,1,0,,,,,,
375,504,356,375,504,356,,,0,0,0,,,,,,
375,504,379,375,504,379,,,0,0,0,,,,,,
376,505,402,376,505,402,,,0,0,0,,,,,,
376,505,426,376,505,426,,,0,0,0,,,,,,
377,506,450,377,506,450,,,0,0,0,,,,,,
378,506,474,377,506,474,,,1,0,0,,,,,,
378,506,498,378,506,498,,,0,0,0,,,,,,
379,507,522,378,506,522,,,1,1,0,,,,,,
379,507,546,379,507,546,,,0,0,0,,,,,,
380,508,571,380,508,571,,,0,0,0,,,,,,
381,509,596,381,509,596,,,0,0,0,,,,,,
382,509,620,382,509,620,,,0,0,0,,,,,,
383,510,645,383,510,645,,,0,0,0,,,,,,
384,511,670,383,510,670,,,1,1,0,,,,,,
384,511,695,384,511,695,,,0,0,0,,,,,,
385,512,720,385,512,720,,,0,0,0,,,,,,
386,513,745,386,513,745,,,0,0,0,,,,,,
387,514,770,387,513,770,,,0,1,0,,,,,,
384,531,145,384,530,145,,,0,1,0,,,,,,
384,531,146,384,530,145,,,0,1,1,,,,,,
384,531,150,384,530,150,,,0,1,0,,,,,,
384,531,158,384,530,159,,,0,1,-1,,,,,,
384,531,168,384,531,168,,,0,0,0,,,,,,
384,531,181,384,531,182,,,0,0,-1,,,,,,
384,531,196,385,531,196,,,-1,0,0,,,,,,
385,531,213,385,531,213,,,0,0,0,,,,,,
385,531,231,385,531,231,,,0,0,0,,,,,,
385,531,251,385,531,251,,,0,0,0,,,,,,
385,532,271,385,531,271,,,0,1,0,,,,,,
386,532,292,385,531,292,,,1,1,0,,,,,,
386,532,314,386,532,314,,,0,0,0,,,,,,
386,532,336,386,532,336,,,0,0,0,,,,,,
387,533,358,387,532,358,,,0,1,0,,,,,,
387,533,381,387,533,381,,,0,0,0,,,,,,
388,533,405,388,533,404,,,0,0,1,,,,,,
388,534,428,388,534,428,,,0,0,0,,,,,,
389,534,452,388,534,452,,,1,0,0,,,,,,
389,534,476,389,534,476,,,0,0,0,,,,,,
390,535,500,390,534,500,,,0,1,0,,,,,,
390,535,524,390,535,524,,,0,0,0,,,,,,
391,536,548,391,535,548,,,0,1,0,,,,,,
392,536,573,391,536,572,,,1,0,1,,,,,,
392,537,597,392,537,597,,,0,0,0,,,,,,
393,537,622,393,537,622,,,0,0,0,,,,,,
394,538,647,394,538,646,,,0,0,1,,,,,,
395,539,671,395,538,671,,,0,1,0,,,,,,
396,539,696,396,539,696,,,0,0,0,,,,,,
397,540,721,396,540,721,,,1,0,0,,,,,,
398,541,746,397,541,746,,,1,0,0,,,,,,
399,542,772,398,541,771,,,1,1,1,,,,,,
396,559,153,396,559,153,,,0,0,0,,,,,,
396,559,154,396,559,153,,,0,0,1,,,,,,
396,559,158,396,559,158,,,0,0,0,,,,,,
396,559,165,396,559,166,,,0,0,-1,,,,,,
396,560,174,396,560,174,,,0,0,0,,,,,,
396,560,187,396,560,187,,,0,0,0,,,,,,
397,560,201,397,560,201,,,0,0,0,,,,,,
397,560,218,397,560,218,,,0,0,0,,,,,,
397,560,236,397,560,236,,,0,0,0,,,,,,
397,560,255,397,560,255,,,0,0,0,,,,,,
397,560,275,397,560,275,,,0,0,0,,,,,,
398,560,296,397,560,296,,,1,0,0,,,,,,
398,561,317,398,561,317,,,0,0,0,,,,,,
398,561,339,398,561,339,,,0,0,0,,,,,,
399,561,361,399,561,361,,,0,0,0,,,,,,
399,561,384,399,561,384,,,0,0,0,,,,,,
400,562,407,400,562,407,,,0,0,0,,,,,,
400,562,430,400,562,430,,,0,0,0,,,,,,
400,563,454,400,563,454,,,0,0,0,,,,,,
401,563,478,401,563,478,,,0,0,0,,,,,,
402,563,502,402,563,502,,,0,0,0,,,,,,
402,564,526,402,563,526,,,0,1,0,,,,,,
403,564,550,403,564,550,,,0,0,0,,,,,,
404,565,574,403,564,574,,,1,1,0,,,,,,
404,565,599,404,565,599,,,0,0,0,,,,,,
405,566,623,405,565,623,,,0,1,0,,,,,,
406,566,648,406,566,648,,,0,0,0,,,,,,
407,567,673,407,567,673,,,0,0,0,,,,,,
408,568,698,408,568,698,,,0,0,0,,,,,,
408,568,723,408,568,723,,,0,0,0,,,,,,
409,569,748,409,569,748,,,0,0,0,,,,,,
410,570,773,410,569,773,,,0,1,0,,,,,,
409,588,160,408,588,160,,,1,0,0,,,,,,
409,588,161,408,588,160,,,1,0,1,,,,,,
409,588,165,408,588,165,,,1,0,0,,,,,,
409,588,171,408,588,173,,,1,0,-2,,,,,,
409,588,181,408,588,181,,,1,0,0,,,,,,
409,588,193,409,588,194,,,0,0,-1,,,,,,
409,588,207,409,588,207,,,0,0,0,,,,,,
409,589,223,409,588,223,,,0,1,0,,,,,,
409,589,240,409,589,240,,,0,0,0,,,,,,
410,589,259,409,589,259,,,1,0,0,,,,,,
410,589,279,409,589,279,,,1,0,0,,,,,,
410,589,299,410,589,299,,,0,0,0,,,,,,
410,589,320,410,589,320,,,0,0,0,,,,,,
411,590,342,411,589,342,,,0,1,0,,,,,,
411,590,364,411,590,364,,,0,0,0,,,,,,
411,590,387,411,590,386,,,0,0,1,,,,,,
412,590,410,412,590,409,,,0,0,1,,,,,,
412,591,433,412,591,433,,,0,0,0,,,,,,
413,591,456,412,591,456,,,1,0,0,,,,,,
413,592,480,413,591,480,,,0,1,0,,,,,,
414,592,504,414,592,504,,,0,0,0,,,,,,
414,592,528,414,592,528,,,0,0,0,,,,,,
415,593,552,415,592,552,,,0,1,0,,,,,,
416,593,576,416,593,576,,,0,0,0,,,,,,
416,594,600,416,593,600,,,0,1,0,,,,,,
417,594,625,417,594,625,,,0,0,0,,,,,,
418,595,650,418,594,649,,,0,1,1,,,,,,
419,595,674,419,595,674,,,0,0,0,,,,,,
420,596,699,420,596,699,,,0,0,0,,,,,,
420,597,724,420,596,724,,,0,1,0,,,,,,
421,597,749,421,597,749,,,0,0,0,,,,,,
422,598,774,422,598,774,,,0,0,0,,,,,,
421,617,168,421,617,168,,,0,0,0,,,,,,
421,617,169,421,617,168,,,0,0,1,,,,,,
421,617,172,421,617,172,,,0,0,0,,,,,,
421,617,179,421,617,180,,,0,0,-1,,,,,,
421,617,188,421,617,188,,,0,0,0,,,,,,
422,617,199,421,617,200,,,1,0,-1,,,,,,
422,617,213,422,617,213,,,0,0,0,,,,,,
422,617,228,422,617,229,,,0,0,-1,,,,,,
422,618,245,422,618,245,,,0,0,0,,,,,,
422,618,264,422,618,264,,,0,0,0,,,,,,
422,618,283,422,618,283,,,0,0,0,,,,,,
423,618,303,422,618,303,,,1,0,0,,,,,,
423,618,324,423,618,324,,,0,0,0,,,,,,
423,618,345,423,618,345,,,0,0,0,,,,,,
424,619,367,424,619,367,,,0,0,0,,,,,,
424,619,390,424,619,389,,,0,0,1,,,,,,
424,619,412,424,619,412,,,0,0,0,,,,,,
425,620,435,424,619,435,,,1,1,0,,,,,,
425,620,459,425,620,459,,,0,0,0,,,,,,
426,620,482,425,620,482,,,1,0,0,,,,,,
426,621,506,426,621,506,,,0,0,0,,,,,,
427,621,530,427,621,530,,,0,0,0,,,,,,
428,621,554,428,621,554,,,0,0,0,,,,,,
428,622,578,428,621,578,,,0,1,0,,,,,,
429,622,602,429,622,602,,,0,0,0,,,,,,
430,623,627,429,622,626,,,1,1,1,,,,,,
430,623,651,430,623,651,,,0,0,0,,,,,,
431,624,676,431,623,676,,,0,1,0,,,,,,
432,624,701,432,624,701,,,0,0,0,,,,,,
433,625,725,433,625,725,,,0,0,0,,,,,,
434,626,750,434,626,750,,,0,0,0,,,,,,
435,626,775,434,626,775,,,1,0,0,,,,,,
434,646,175,434,646,175,,,0,0,0,,,,,,
434,646,176,434,646,175,,,0,0,1,,,,,,
434,646,180,434,646,179,,,0,0,1,,,,,,
434,646,186,434,646,187,,,0,0,-1,,,,,,
434,646,194,434,646,194,,,0,0,0,,,,,,
434,646,205,434,646,206,,,0,0,-1,,,,,,
435,646,219,435,646,219,,,0,0,0,,,,,,
435,646,234,435,646,234,,,0,0,0,,,,,,
435,646,250,435,646,250,,,0,0,0,,,,,,
435,647,268,435,646,269,,,0,1,-1,,,,,,
435,647,287,435,647,287,,,0,0,0,,,,,,
436,647,307,435,647,307,,,1,0,0,,,,,,
436,647,328,436,647,327,,,0,0,1,,,,,,
436,647,349,436,647,349,,,0,0,0,,,,,,
437,648,370,437,648,370,,,0,0,0,,,,,,
437,648,393,437,648,392,,,0,0,1,,,,,,
437,648,415,437,648,415,,,0,0,0,,,,,,
438,648,438,437,648,438,,,1,0,0,,,,,,
438,649,461,438,649,461,,,0,0,0,,,,,,
439,649,484,438,649,484,,,1,0,0,,,,,,
439,649,508,439,649,508,,,0,0,0,,,,,,
440,650,532,439,649,532,,,1,1,0,,,,,,
440,650,556,440,650,556,,,0,0,0,,,,,,
441,651,580,441,650,580,,,0,1,0,,,,,,
442,651,604,442,651,604,,,0,0,0,,,,,,
442,651,628,442,651,628,,,0,0,0,,,,,,
443,652,653,443,652,653,,,0,0,0,,,,,,
444,652,677,443,652,677,,,1,0,0,,,,,,
445,653,702,444,653,702,,,1,0,0,,,,,,
445,654,727,445,653,727,,,0,1,0,,,,,,
446,654,752,446,654,751,,,0,0,1,,,,,,
447,655,777,447,655,776,,,0,0,1,,,,,,
447,675,183,447,675,183,,,0,0,0,,,,,,
447,675,184,447,675,183,,,0,0,1,,,,,,
448,675,187,448,675,187,,,0,0,0,,,,,,
448,675,193,448,675,194,,,0,0,-1,,,,,,
448,675,201,448,675,201,,,0,0,0,,,,,,
448,675,212,448,675,213,,,0,0,-1,,,,,,
448,675,225,448,675,225,,,0,0,0,,,,,,
448,675,239,448,675,240,,,0,0,-1,,,,,,
448,675,256,448,675,256,,,0,0,0,,,,,,
448,676,273,448,675,274,,,0,1,-1,,,,,,
449,676,292,449,676,292,,,0,0,0,,,,,,
449,676,311,449,676,311,,,0,0,0,,,,,,
449,676,331,449,676,331,,,0,0,0,,,,,,
449,676,352,449,676,352,,,0,0,0,,,,,,
450,677,374,450,677,374,,,0,0,0,,,,,,
450,677,396,450,677,396,,,0,0,0,,,,,,
450,677,418,450,677,418,,,0,0,0,,,,,,
451,677,441,450,677,441,,,1,0,0,,,,,,
451,678,464,451,678,464,,,0,0,0,,,,,,
452,678,487,451,678,487,,,1,0,0,,,,,,
452,678,510,452,678,510,,,0,0,0,,,,,,
453,679,534,452,678,534,,,1,1,0,,,,,,
453,679,558,453,679,558,,,0,0,0,,,,,,
454,679,582,454,679,582,,,0,0,0,,,,,,
455,680,606,455,680,606,,,0,0,0,,,,,,
455,680,630,455,680,630,,,0,0,0,,,,,,
456,681,655,456,681,655,,,0,0,0,,,,,,
457,681,679,456,681,679,,,1,0,0,,,,,,
457,682,704,457,682,704,,,0,0,0,,,,,,
458,682,729,458,682,728,,,0,0,1,,,,,,
459,683,753,459,683,753,,,0,0,0,,,,,,
460,683,778,460,683,778,,,0,0,0,,,,,,
461,704,191,461,704,190,,,0,0,1,,,,,,
461,704,191,461,704,190,,,0,0,1,,,,,,
461,704,194,461,704,194,,,0,0,0,,,,,,
461,704,200,461,704,201,,,0,0,-1,,,,,,
461,704,208,461,704,208,,,0,0,0,,,,,,
461,704,218,461,704,219,,,0,0,-1,,,,,,
461,704,231,461,704,231,,,0,0,0,,,,,,
461,704,245,461,704,246,,,0,0,-1,,,,,,
462,705,261,461,704,261,,,1,1,0,,,,,,
462,705,278,462,704,278,,,0,1,0,,,,,,
462,705,296,462,705,296,,,0,0,0,,,,,,
462,705,316,462,705,316,,,0,0,0,,,,,,
462,705,336,462,705,335,,,0,0,1,,,,,,
463,705,356,463,705,356,,,0,0,0,,,,,,
463,706,377,463,706,377,,,0,0,0,,,,,,
463,706,399,463,706,399,,,0,0,0,,,,,,
464,706,421,463,706,421,,,1,0,0,,,,,,
464,706,444,464,706,443,,,0,0,1,,,,,,
465,707,466,464,707,466,,,1,0,0,,,,,,
465,707,490,465,707,489,,,0,0,1,,,,,,
466,707,513,465,707,512,,,1,0,1,,,,,,
466,708,536,466,707,536,,,0,1,0,,,,,,
467,708,560,466,708,560,,,1,0,0,,,,,,
467,708,584,467,708,584,,,0,0,0,,,,,,
468,709,608,468,709,608,,,0,0,0,,,,,,
468,709,632,468,709,632,,,0,0,0,,,,,,
469,710,657,469,709,657,,,0,1,0,,,,,,
470,710,681,469,710,681,,,1,0,0,,,,,,
471,710,706,470,710,705,,,1,0,1,,,,,,
471,711,730,471,711,730,,,0,0,0,,,,,,
472,712,755,472,711,755,,,0,1,0,,,,,,
473,712,780,473,712,779,,,0,0,1,,,,,,
475,733,198,475,733,198,,,0,0,0,,,,,,
475,733,199,475,733,198,,,0,0,1,,,,,,
475,733,202,475,733,202,,,0,0,0,,,,,,
475,733,207,475,733,208,,,0,0,-1,,,,,,
475,733,215,475,733,215,,,0,0,0,,,,,,
475,733,225,475,733,226,,,0,0,-1,,,,,,
475,733,237,475,733,237,,,0,0,0,,,,,,
475,734,251,475,733,251,,,0,1,0,,,,,,
475,734,266,475,734,266,,,0,0,0,,,,,,
475,734,283,475,734,283,,,0,0,0,,,,,,
476,734,301,476,734,301,,,0,0,0,,,,,,
476,734,320,476,734,320,,,0,0,0,,,,,,
476,734,340,476,734,340,,,0,0,0,,,,,,
476,734,360,476,734,360,,,0,0,0,,,,,,
477,735,381,477,735,381,,,0,0,0,,,,,,
477,735,403,477,735,402,,,0,0,1,,,,,,
477,735,424,477,735,424,,,0,0,0,,,,,,
478,735,447,477,735,446,,,1,0,1,,,,,,
478,736,469,478,736,469,,,0,0,0,,,,,,
479,736,492,478,736,492,,,1,0,0,,,,,,
479,736,515,479,736,515,,,0,0,0,,,,,,
480,736,539,479,736,538,,,1,0,1,,,,,,
480,737,562,480,737,562,,,0,0,0,,,,,,
481,737,586,480,737,586,,,1,0,0,,,,,,
481,738,610,481,738,610,,,0,0,0,,,,,,
482,738,634,481,738,634,,,1,0,0,,,,,,
482,738,659,482,738,659,,,0,0,0,,,,,,
483,739,683,483,738,683,,,0,1,0,,,,,,
484,739,707,484,739,707,,,0,0,0,,,,,,
485,740,732,484,739,732,,,1,1,0,,,,,,
485,740,757,485,740,757,,,0,0,0,,,,,,
486,741,781,486,740,781,,,0,1,0,,,,,,
488,762,206,488,762,206,,,0,0,0,,,,,,
488,762,207,488,762,206,,,0,0,1,,,,,,
488,762,210,488,762,209,,,0,0,1,,,,,,
488,762,215,488,762,215,,,0,0,0,,,,,,
489,763,222,489,762,222,,,0,1,0,,,,,,
489,763,232,489,762,232,,,0,1,0,,,,,,
489,763,243,489,762,243,,,0,1,0,,,,,,
489,763,257,489,762,257,,,0,1,0,,,,,,
489,763,272,489,763,272,,,0,0,0,,,,,,
489,763,288,489,763,289,,,0,0,-1,,,,,,
489,763,306,489,763,306,,,0,0,0,,,,,,
490,763,325,489,763,325,,,1,0,0,,,,,,
490,763,344,490,763,344,,,0,0,0,,,,,,
490,764,364,490,763,364,,,0,1,0,,,,,,
490,764,385,490,764,385,,,0,0,0,,,,,,
491,764,406,490,764,406,,,1,0,0,,,,,,
491,764,428,491,764,427,,,0,0,1,,,,,,
491,764,450,491,764,449,,,0,0,1,,,,,,
492,765,472,492,765,472,,,0,0,0,,,,,,
492,765,495,492,765,495,,,0,0,0,,,,,,
493,765,518,493,765,518,,,0,0,0,,,,,,
493,766,541,493,765,541,,,0,1,0,,,,,,
494,766,565,494,766,564,,,0,0,1,,,,,,
494,766,589,494,766,588,,,0,0,1,,,,,,
495,767,612,495,767,612,,,0,0,0,,,,,,
495,767,636,495,767,636,,,0,0,0,,,,,,
496,767,661,496,767,661,,,0,0,0,,,,,,
497,768,685,496,767,685,,,1,1,0,,,,,,
497,768,709,497,768,709,,,0,0,0,,,,,,
498,769,734,498,768,733,,,0,1,1,,,,,,
499,769,758,499,769,758,,,0,0,0,,,,,,
500,770,783,499,769,783,,,1,1,0,,,,,,
502,792,214,502,792,214,,,0,0,0,,,,,,
502,792,214,502,792,214,,,0,0,0,,,,,,
502,792,217,502,792,217,,,0,0,0,,,,,,
502,792,222,502,792,223,,,0,0,-1,,,,,,
503,792,229,503,792,229,,,0,0,0,,,,,,
503,792,239,503,792,239,,,0,0,0,,,,,,
503,792,250,503,792,250,,,0,0,0,,,,,,
503,792,263,503,792,264,,,0,0,-1,,,,,,
503,792,278,503,792,278,,,0,0,0,,,,,,
503,792,294,503,792,294,,,0,0,0,,,,,,
503,792,311,503,792,311,,,0,0,0,,,,,,
504,792,329,503,792,329,,,1,0,0,,,,,,
504,793,348,504,793,348,,,0,0,0,,,,,,
504,793,368,504,793,368,,,0,0,0,,,,,,
504,793,389,504,793,389,,,0,0,0,,,,,,
505,793,410,504,793,410,,,1,0,0,,,,,,
505,793,431,505,793,431,,,0,0,0,,,,,,
505,794,453,505,793,453,,,0,1,0,,,,,,
506,794,475,506,794,475,,,0,0,0,,,,,,
506,794,498,506,794,498,,,0,0,0,,,,,,
507,794,521,507,794,521,,,0,0,0,,,,,,
507,795,544,507,794,544,,,0,1,0,,,,,,
508,795,567,508,795,567,,,0,0,0,,,,,,
508,795,591,508,795,591,,,0,0,0,,,,,,
509,796,615,509,796,615,,,0,0,0,,,,,,
509,796,639,509,796,639,,,0,0,0,,,,,,
510,796,663,510,796,663,,,0,0,0,,,,,,
511,797,687,510,796,687,,,1,1,0,,,,,,
511,797,711,511,797,711,,,0,0,0,,,,,,
512,798,736,512,797,735,,,0,1,1,,,,,,
513,798,760,513,798,760,,,0,0,0,,,,,,
513,799,785,513,798,785,,,0,1,0,,,,,,
517,821,221,516,821,221,,,1,0,0,,,,,,
517,821,222,516,821,221,,,1,0,1,,,,,,
517,821,225,516,821,224,,,1,0,1,,,,,,
517,821,229,516,821,230,,,1,0,-1,,,,,,
517,821,236,517,821,236,,,0,0,0,,,,,,
517,821,245,517,821,246,,,0,0,-1,,,,,,
517,821,256,517,821,256,,,0,0,0,,,,,,
517,821,269,517,821,270,,,0,0,-1,,,,,,
517,821,284,517,821,283,,,0,0,1,,,,,,
517,821,299,517,821,299,,,0,0,0,,,,,,
517,822,316,517,821,316,,,0,1,0,,,,,,
518,822,334,517,821,334,,,1,1,0,,,,,,
518,822,353,518,822,353,,,0,0,0,,,,,,
518,822,372,518,822,373,,,0,0,-1,,,,,,
518,822,393,518,822,393,,,0,0,0,,,,,,
519,822,414,518,822,414,,,1,0,0,,,,,,
519,823,435,519,822,435,,,0,1,0,,,,,,
519,823,457,519,822,456,,,0,1,1,,,,,,
520,823,479,520,823,478,,,0,0,1,,,,,,
520,823,501,520,823,501,,,0,0,0,,,,,,
521,824,524,521,823,524,,,0,1,0,,,,,,
521,824,547,521,823,547,,,0,1,0,,,,,,
522,824,570,522,824,570,,,0,0,0,,,,,,
522,824,594,522,824,593,,,0,0,1,,,,,,
523,825,617,523,825,617,,,0,0,0,,,,,,
523,825,641,523,825,641,,,0,0,0,,,,,,
524,826,665,524,825,665,,,0,1,0,,,,,,
524,826,689,524,825,689,,,0,1,0,,,,,,
525,826,713,525,826,713,,,0,0,0,,,,,,
526,827,738,526,826,737,,,0,1,1,,,,,,
526,827,762,527,827,762,,,-1,0,0,,,,,,
527,828,787,527,827,786,,,0,1,1,,,,,,
531,850,229,531,850,229,,,0,0,0,,,,,,
531,850,230,531,850,229,,,0,0,1,,,,,,
531,850,232,531,850,232,,,0,0,0,,,,,,
531,850,237,531,850,238,,,0,0,-1,,,,,,
531,850,244,531,850,244,,,0,0,0,,,,,,
531,850,252,531,850,253,,,0,0,-1,,,,,,
531,851,263,531,851,263,,,0,0,0,,,,,,
531,851,275,531,851,276,,,0,0,-1,,,,,,
531,851,289,531,851,289,,,0,0,0,,,,,,
532,851,305,531,851,305,,,1,0,0,,,,,,
532,851,321,532,851,321,,,0,0,0,,,,,,
532,851,339,532,851,339,,,0,0,0,,,,,,
532,851,358,532,851,358,,,0,0,0,,,,,,
532,851,377,532,851,377,,,0,0,0,,,,,,
533,851,397,533,851,397,,,0,0,0,,,,,,
533,852,417,533,851,418,,,0,1,-1,,,,,,
533,852,439,533,852,439,,,0,0,0,,,,,,
534,852,460,533,852,460,,,1,0,0,,,,,,
534,852,482,534,852,482,,,0,0,0,,,,,,
534,853,504,534,852,504,,,0,1,0,,,,,,
535,853,527,535,853,527,,,0,0,0,,,,,,
535,853,550,535,853,550,,,0,0,0,,,,,,
536,853,573,536,853,573,,,0,0,0,,,,,,
536,854,596,536,853,596,,,0,1,0,,,,,,
537,854,620,537,854,620,,,0,0,0,,,,,,
537,854,643,537,854,643,,,0,0,0,,,,,,
538,855,667,538,855,667,,,0,0,0,,,,,,
539,855,691,538,855,691,,,1,0,0,,,,,,
539,855,715,539,855,715,,,0,0,0,,,,,,
540,856,740,540,855,739,,,0,1,1,,,,,,
541,856,764,541,856,764,,,0,0,0,,,,,,
541,857,789,541,856,788,,,0,1,1,,,,,,
545,880,237,545,879,237,,,0,1,0,,,,,,
545,880,238,545,879,237,,,0,1,1,,,,,,
545,880,240,545,879,240,,,0,1,0,,,,,,
545,880,244,545,879,245,,,0,1,-1,,,,,,
546,880,251,545,879,251,,,1,1,0,,,,,,
546,880,259,545,879,260,,,1,1,-1,,,,,,
546,880,270,545,880,270,,,1,0,0,,,,,,
546,880,282,545,880,282,,,1,0,0,,,,,,
546,880,295,546,880,295,,,0,0,0,,,,,,
546,880,311,546,880,311,,,0,0,0,,,,,,
546,880,327,546,880,326,,,0,0,1,,,,,,
546,880,344,546,880,344,,,0,0,0,,,,,,
547,880,362,546,880,362,,,1,0,0,,,,,,
547,881,381,547,880,382,,,0,1,-1,,,,,,
547,881,401,547,880,401,,,0,1,0,,,,,,
547,881,422,547,881,422,,,0,0,0,,,,,,
548,881,442,547,881,442,,,1,0,0,,,,,,
548,881,464,548,881,464,,,0,0,0,,,,,,
548,882,485,548,881,485,,,0,1,0,,,,,,
549,882,508,549,881,507,,,0,1,1,,,,,,
549,882,530,549,882,530,,,0,0,0,,,,,,
550,882,553,550,882,553,,,0,0,0,,,,,,
550,883,576,550,882,576,,,0,1,0,,,,,,
551,883,599,551,883,599,,,0,0,0,,,,,,
551,883,622,551,883,622,,,0,0,0,,,,,,
552,884,646,552,883,646,,,0,1,0,,,,,,
552,884,670,552,884,669,,,0,0,1,,,,,,
553,884,694,553,884,693,,,0,0,1,,,,,,
553,885,718,553,884,717,,,0,1,1,,,,,,
554,885,742,554,885,741,,,0,0,1,,,,,,
555,886,766,555,885,766,,,0,1,0,,,,,,
555,886,791,555,886,790,,,0,0,1,,,,,,
286,79,43,286,79,43,,,0,0,0,,,,,,
286,79,47,286,79,43,,,0,0,4,,,,,,
286,79,60,286,79,60,,,0,0,0,,,,,,
286,80,78,286,79,79,,,0,1,-1,,,,,,
286,80,98,286,80,98,,,0,0,0,,,,,,
286,81,120,286,80,120,,,0,1,0,,,,,,
286,81,143,286,81,143,,,0,0,0,,,,,,
286,82,166,286,82,166,,,0,0,0,,,,,,
287,83,189,287,83,189,,,0,0,0,,,,,,
287,85,213,287,84,213,,,0,1,0,,,,,,
287,86,237,287,86,237,,,0,0,0,,,,,,
288,88,261,287,87,261,,,1,1,0,,,,,,
288,90,285,288,89,285,,,0,1,0,,,,,,
289,91,310,288,91,310,,,1,0,0,,,,,,
289,93,334,289,93,334,,,0,0,0,,,,,,
290,96,359,290,95,359,,,0,1,0,,,,,,
290,98,384,290,98,383,,,0,0,1,,,,,,
291,100,409,291,100,408,,,0,0,1,,,,,,
292,103,433,292,102,433,,,0,1,0,,,,,,
293,105,458,292,105,458,,,1,0,0,,,,,,
293,108,483,293,108,483,,,0,0,0,,,,,,
294,111,508,294,111,508,,,0,0,0,,,,,,
295,114,533,295,114,533,,,0,0,0,,,,,,
296,116,559,296,116,558,,,0,0,1,,,,,,
297,119,584,297,119,584,,,0,0,0,,,,,,
298,122,609,298,122,609,,,0,0,0,,,,,,
299,126,634,299,125,634,,,0,1,0,,,,,,
301,129,660,300,128,659,,,1,1,1,,,,,,
302,132,685,301,132,685,,,1,0,0,,,,,,
303,135,711,303,135,710,,,0,0,1,,,,,,
304,139,736,304,139,736,,,0,0,0,,,,,,
306,142,762,305,142,761,,,1,0,1,,,,,,
286,82,44,286,79,43,,,0,3,1,,,,,,
286,82,48,286,79,43,,,0,3,5,,,,,,
286,82,60,286,79,60,,,0,3,0,,,,,,
286,82,78,286,79,79,,,0,3,-1,,,,,,
286,83,98,286,80,98,,,0,3,0,,,,,,
286,83,120,286,80,120,,,0,3,0,,,,,,
286,84,143,286,81,143,,,0,3,0,,,,,,
287,85,166,286,82,166,,,1,3,0,,,,,,
287,86,189,287,83,189,,,0,3,0,,,,,,
287,87,213,287,84,213,,,0,3,0,,,,,,
288,89,237,287,86,237,,,1,3,0,,,,,,
288,90,261,287,87,261,,,1,3,0,,,,,,
288,92,285,288,89,285,,,0,3,0,,,,,,
289,94,310,288,91,310,,,1,3,0,,,,,,
289,96,334,289,93,334,,,0,3,0,,,,,,
290,98,359,290,95,359,,,0,3,0,,,,,,
291,100,384,290,98,383,,,1,2,1,,,,,,
291,102,409,291,100,408,,,0,2,1,,,,,,
292,105,433,292,102,433,,,0,3,0,,,,,,
293,107,458,292,105,458,,,1,2,0,,,,,,
294,110,483,293,108,483,,,1,2,0,,,,,,
295,113,508,294,111,508,,,1,2,0,,,,,,
295,115,533,295,114,533,,,0,1,0,,,,,,
296,118,559,296,116,558,,,0,2,1,,,,,,
297,121,584,297,119,584,,,0,2,0,,,,,,
298,124,609,298,122,609,,,0,2,0,,,,,,
300,127,634,299,125,634,,,1,2,0,,,,,,
301,130,660,300,128,659,,,1,2,1,,,,,,
302,134,685,301,132,685,,,1,2,0,,,,,,
303,137,711,303,135,710,,,0,2,1,,,,,,
304,140,736,304,139,736,,,0,1,0,,,,,,
306,143,762,305,142,761,,,1,1,1,,,,,,
287,92,45,287,92,45,,,0,0,0,,,,,,
287,92,49,287,92,45,,,0,0,4,,,,,,
287,92,61,287,92,61,,,0,0,0,,,,,,
287,92,79,287,92,80,,,0,0,-1,,,,,,
287,93,99,287,93,99,,,0,0,0,,,,,,
287,93,121,287,93,121,,,0,0,0,,,,,,
287,94,143,287,94,143,,,0,0,0,,,,,,
287,95,166,287,95,166,,,0,0,0,,,,,,
288,96,190,288,96,189,,,0,0,1,,,,,,
288,97,213,288,97,213,,,0,0,0,,,,,,
288,98,237,288,98,237,,,0,0,0,,,,,,
289,100,261,289,99,261,,,0,1,0,,,,,,
289,101,286,289,101,285,,,0,0,1,,,,,,
290,103,310,290,102,310,,,0,1,0,,,,,,
290,104,335,290,104,334,,,0,0,1,,,,,,
291,106,359,291,106,359,,,0,0,0,,,,,,
291,108,384,291,108,384,,,0,0,0,,,,,,
292,110,409,292,110,408,,,0,0,1,,,,,,
293,113,434,293,113,433,,,0,0,1,,,,,,
294,115,458,293,115,458,,,1,0,0,,,,,,
294,117,483,294,117,483,,,0,0,0,,,,,,
295,120,508,295,120,508,,,0,0,0,,,,,,
296,123,534,296,122,533,,,0,1,1,,,,,,
297,125,559,297,125,558,,,0,0,1,,,,,,
298,128,584,298,128,584,,,0,0,0,,,,,,
299,131,609,299,131,609,,,0,0,0,,,,,,
300,134,635,300,134,634,,,0,0,1,,,,,,
301,137,660,301,137,659,,,0,0,1,,,,,,
303,140,685,302,140,685,,,1,0,0,,,,,,
304,143,711,304,143,710,,,0,0,1,,,,,,
305,146,736,305,146,736,,,0,0,0,,,,,,
307,149,762,306,149,761,,,1,0,1,,,,,,
288,108,47,288,110,47,,,0,-2,0,,,,,,
288,108,51,288,110,47,,,0,-2,4,,,,,,
288,108,63,288,110,63,,,0,-2,0,,,,,,
288,108,80,288,110,81,,,0,-2,-1,,,,,,
288,109,100,288,110,100,,,0,-1,0,,,,,,
288,109,121,288,111,122,,,0,-2,-1,,,,,,
289,110,144,288,111,144,,,1,-1,0,,,,,,
289,110,167,289,112,167,,,0,-2,0,,,,,,
289,111,190,289,113,190,,,0,-2,0,,,,,,
289,112,214,290,114,214,,,-1,-2,0,,,,,,
290,113,238,290,115,238,,,0,-2,0,,,,,,
290,114,262,290,116,262,,,0,-2,0,,,,,,
291,116,286,291,117,286,,,0,-1,0,,,,,,
291,117,310,291,119,310,,,0,-2,0,,,,,,
292,119,335,292,120,335,,,0,-1,0,,,,,,
292,120,359,292,122,359,,,0,-2,0,,,,,,
293,122,384,293,124,384,,,0,-2,0,,,,,,
293,124,409,293,126,409,,,0,-2,0,,,,,,
294,126,434,294,128,433,,,0,-2,1,,,,,,
295,128,459,295,130,458,,,0,-2,1,,,,,,
296,130,484,296,132,483,,,0,-2,1,,,,,,
297,132,509,297,134,508,,,0,-2,1,,,,,,
298,135,534,297,136,533,,,1,-1,1,,,,,,
299,137,559,298,139,559,,,1,-2,0,,,,,,
300,140,584,299,142,584,,,1,-2,0,,,,,,
301,142,609,301,144,609,,,0,-2,0,,,,,,
302,145,635,302,147,634,,,0,-2,1,,,,,,
303,148,660,303,149,660,,,0,-1,0,,,,,,
304,150,685,304,152,685,,,0,-2,0,,,,,,
305,153,711,305,155,710,,,0,-2,1,,,,,,
307,156,736,307,158,736,,,0,-2,0,,,,,,
308,159,762,308,161,761,,,0,-2,1,,,,,,
290,128,51,290,128,50,,,0,0,1,,,,,,
290,128,54,290,128,50,,,0,0,4,,,,,,
290,128,65,290,128,65,,,0,0,0,,,,,,
290,128,82,290,128,83,,,0,0,-1,,,,,,
290,129,101,290,128,101,,,0,1,0,,,,,,
291,129,123,290,129,123,,,1,0,0,,,,,,
291,129,145,290,129,145,,,1,0,0,,,,,,
291,130,168,291,130,168,,,0,0,0,,,,,,
291,131,191,291,130,191,,,0,1,0,,,,,,
292,131,214,291,131,214,,,1,0,0,,,,,,
292,132,238,292,132,238,,,0,0,0,,,,,,
292,133,262,292,133,262,,,0,0,0,,,,,,
293,134,286,292,134,286,,,1,0,0,,,,,,
293,136,311,293,135,311,,,0,1,0,,,,,,
294,137,335,294,137,335,,,0,0,0,,,,,,
294,138,360,294,138,360,,,0,0,0,,,,,,
295,140,384,295,140,384,,,0,0,0,,,,,,
296,141,409,295,141,409,,,1,0,0,,,,,,
296,143,434,296,143,434,,,0,0,0,,,,,,
297,145,459,297,145,459,,,0,0,0,,,,,,
298,147,484,298,147,484,,,0,0,0,,,,,,
299,149,509,298,149,509,,,1,0,0,,,,,,
300,151,534,299,151,534,,,1,0,0,,,,,,
301,153,559,300,153,559,,,1,0,0,,,,,,
302,155,584,301,155,584,,,1,0,0,,,,,,
303,157,610,302,157,609,,,1,0,1,,,,,,
304,160,635,304,160,635,,,0,0,0,,,,,,
305,162,660,305,162,660,,,0,0,0,,,,,,
306,165,686,306,165,685,,,0,0,1,,,,,,
307,167,711,307,167,711,,,0,0,0,,,,,,
309,170,736,309,170,736,,,0,0,0,,,,,,
310,173,762,310,172,762,,,0,1,0,,,,,,
293,150,55,293,151,55,,,0,-1,0,,,,,,
293,150,58,293,151,55,,,0,-1,3,,,,,,
293,151,68,293,151,69,,,0,0,-1,,,,,,
293,151,84,293,151,86,,,0,0,-2,,,,,,
293,151,103,293,151,103,,,0,0,0,,,,,,
293,151,124,293,152,125,,,0,-1,-1,,,,,,
294,152,146,293,152,146,,,1,0,0,,,,,,
294,152,169,294,153,169,,,0,-1,0,,,,,,
294,153,192,294,153,192,,,0,0,0,,,,,,
294,153,215,295,154,215,,,-1,-1,0,,,,,,
295,154,239,295,155,239,,,0,-1,0,,,,,,
295,155,263,295,156,263,,,0,-1,0,,,,,,
296,156,287,296,156,287,,,0,0,0,,,,,,
296,157,311,296,157,311,,,0,0,0,,,,,,
297,158,336,297,159,336,,,0,-1,0,,,,,,
297,159,360,297,160,360,,,0,-1,0,,,,,,
298,160,385,298,161,385,,,0,-1,0,,,,,,
298,162,410,298,163,409,,,0,-1,1,,,,,,
299,163,434,299,164,434,,,0,-1,0,,,,,,
300,165,459,300,166,459,,,0,-1,0,,,,,,
301,166,484,301,167,484,,,0,-1,0,,,,,,
301,168,509,302,169,509,,,-1,-1,0,,,,,,
302,170,534,302,171,534,,,0,-1,0,,,,,,
303,172,559,303,173,559,,,0,-1,0,,,,,,
304,174,585,304,175,584,,,0,-1,1,,,,,,
305,176,610,305,177,610,,,0,-1,0,,,,,,
306,178,635,307,179,635,,,-1,-1,0,,,,,,
308,180,660,308,181,660,,,0,-1,0,,,,,,
309,182,686,309,183,685,,,0,-1,1,,,,,,
310,185,711,310,186,711,,,0,-1,0,,,,,,
311,187,737,312,188,736,,,-1,-1,1,,,,,,
313,189,762,313,190,762,,,0,-1,0,,,,,,
297,175,59,297,175,59,,,0,0,0,,,,,,
297,175,62,297,175,59,,,0,0,3,,,,,,
297,175,72,297,175,72,,,0,0,0,,,,,,
297,175,87,297,175,89,,,0,0,-2,,,,,,
297,175,106,297,175,105,,,0,0,1,,,,,,
297,175,126,297,175,126,,,0,0,0,,,,,,
297,176,148,297,176,148,,,0,0,0,,,,,,
297,176,170,297,176,170,,,0,0,0,,,,,,
298,176,193,298,177,193,,,0,-1,0,,,,,,
298,177,216,298,177,216,,,0,0,0,,,,,,
298,178,240,298,178,240,,,0,0,0,,,,,,
299,178,264,299,178,263,,,0,0,1,,,,,,
299,179,288,299,179,287,,,0,0,1,,,,,,
300,180,312,300,180,312,,,0,0,0,,,,,,
300,181,336,300,181,336,,,0,0,0,,,,,,
301,182,361,301,182,361,,,0,0,0,,,,,,
301,183,385,301,183,385,,,0,0,0,,,,,,
302,184,410,302,184,410,,,0,0,0,,,,,,
303,186,435,302,186,435,,,1,0,0,,,,,,
303,187,460,303,187,459,,,0,0,1,,,,,,
304,188,485,304,188,484,,,0,0,1,,,,,,
305,190,510,305,190,509,,,0,0,1,,,,,,
306,191,535,306,191,534,,,0,0,1,,,,,,
307,193,560,307,193,559,,,0,0,1,,,,,,
308,195,585,308,195,585,,,0,0,0,,,,,,
309,197,610,309,196,610,,,0,1,0,,,,,,
310,198,635,310,198,635,,,0,0,0,,,,,,
311,200,661,311,200,660,,,0,0,1,,,,,,
312,202,686,312,202,686,,,0,0,0,,,,,,
313,204,711,313,204,711,,,0,0,0,,,,,,
315,207,737,315,206,737,,,0,1,0,,,,,,
316,209,762,316,209,762,,,0,0,0,,,,,,
301,200,65,301,200,65,,,0,0,0,,,,,,
301,200,67,301,200,65,,,0,0,2,,,,,,
301,200,77,301,200,76,,,0,0,1,,,,,,
301,200,91,301,200,92,,,0,0,-1,,,,,,
301,200,109,301,200,109,,,0,0,0,,,,,,
301,200,129,301,200,129,,,0,0,0,,,,,,
302,201,150,302,201,150,,,0,0,0,,,,,,
302,201,172,302,201,172,,,0,0,0,,,,,,
302,201,195,302,202,194,,,0,-1,1,,,,,,
302,202,218,302,202,218,,,0,0,0,,,,,,
303,202,241,303,203,241,,,0,-1,0,,,,,,
303,203,265,303,203,264,,,0,0,1,,,,,,
303,204,289,304,204,288,,,-1,0,1,,,,,,
304,204,313,304,205,313,,,0,-1,0,,,,,,
304,205,337,305,205,337,,,-1,0,0,,,,,,
305,206,362,305,206,361,,,0,0,1,,,,,,
306,207,386,306,207,386,,,0,0,0,,,,,,
306,208,411,306,208,411,,,0,0,0,,,,,,
307,209,435,307,210,435,,,0,-1,0,,,,,,
308,211,460,308,211,460,,,0,0,0,,,,,,
308,212,485,309,212,485,,,-1,0,0,,,,,,
309,213,510,309,213,510,,,0,0,0,,,,,,
310,214,535,310,215,535,,,0,-1,0,,,,,,
311,216,560,311,216,560,,,0,0,0,,,,,,
312,217,585,312,218,585,,,0,-1,0,,,,,,
313,219,611,313,219,610,,,0,0,1,,,,,,
314,221,636,314,221,635,,,0,0,1,,,,,,
315,222,661,315,223,661,,,0,-1,0,,,,,,
316,224,686,317,225,686,,,-1,-1,0,,,,,,
317,226,712,318,226,711,,,-1,0,1,,,,,,
319,228,737,319,228,737,,,0,0,0,,,,,,
320,230,763,320,230,762,,,0,0,1,,,,,,
306,226,70,306,226,70,,,0,0,0,,,,,,
306,226,73,306,226,70,,,0,0,3,,,,,,
306,226,81,306,226,81,,,0,0,0,,,,,,
306,226,95,306,226,96,,,0,0,-1,,,,,,
306,226,112,306,226,112,,,0,0,0,,,,,,
306,226,131,306,226,132,,,0,0,-1,,,,,,
307,226,152,307,226,152,,,0,0,0,,,,,,
307,227,174,307,227,174,,,0,0,0,,,,,,
307,227,196,307,227,196,,,0,0,0,,,,,,
307,228,219,307,227,219,,,0,1,0,,,,,,
308,228,242,308,228,242,,,0,0,0,,,,,,
308,229,266,308,228,266,,,0,1,0,,,,,,
308,229,290,309,229,289,,,-1,0,1,,,,,,
309,230,314,309,230,314,,,0,0,0,,,,,,
309,231,338,309,230,338,,,0,1,0,,,,,,
310,231,362,310,231,362,,,0,0,0,,,,,,
311,232,387,310,232,387,,,1,0,0,,,,,,
311,233,412,311,233,411,,,0,0,1,,,,,,
312,234,436,312,234,436,,,0,0,0,,,,,,
313,235,461,313,235,461,,,0,0,0,,,,,,
313,236,486,313,236,486,,,0,0,0,,,,,,
314,237,511,314,237,510,,,0,0,1,,,,,,
315,239,536,315,239,535,,,0,0,1,,,,,,
316,240,561,316,240,560,,,0,0,1,,,,,,
317,241,586,317,241,586,,,0,0,0,,,,,,
318,243,611,318,242,611,,,0,1,0,,,,,,
319,244,636,319,244,636,,,0,0,0,,,,,,
320,246,662,320,245,661,,,0,1,1,,,,,,
321,247,687,321,247,687,,,0,0,0,,,,,,
322,249,712,322,249,712,,,0,0,0,,,,,,
323,251,738,323,251,737,,,0,0,1,,,,,,
325,252,763,325,252,763,,,0,0,0,,,,,,
312,252,76,312,252,76,,,0,0,0,,,,,,
312,252,79,312,252,76,,,0,0,3,,,,,,
312,252,87,312,252,86,,,0,0,1,,,,,,
312,252,99,312,252,101,,,0,0,-2,,,,,,
312,253,116,312,252,116,,,0,1,0,,,,,,
312,253,134,312,253,135,,,0,0,-1,,,,,,
312,253,155,313,253,155,,,-1,0,0,,,,,,
313,253,176,313,253,176,,,0,0,0,,,,,,
313,254,198,313,254,198,,,0,0,0,,,,,,
313,254,221,313,254,221,,,0,0,0,,,,,,
313,254,244,314,254,244,,,-1,0,0,,,,,,
314,255,268,314,255,267,,,0,0,1,,,,,,
314,255,291,315,255,291,,,-1,0,0,,,,,,
315,256,315,315,256,315,,,0,0,0,,,,,,
315,257,339,315,256,339,,,0,1,0,,,,,,
316,257,363,316,257,363,,,0,0,0,,,,,,
316,258,388,316,258,388,,,0,0,0,,,,,,
317,259,412,317,259,412,,,0,0,0,,,,,,
317,260,437,318,260,437,,,-1,0,0,,,,,,
318,261,462,319,261,462,,,-1,0,0,,,,,,
319,262,487,319,262,486,,,0,0,1,,,,,,
320,263,511,320,263,511,,,0,0,0,,,,,,
321,264,536,321,264,536,,,0,0,0,,,,,,
321,265,561,322,265,561,,,-1,0,0,,,,,,
322,266,586,323,266,586,,,-1,0,0,,,,,,
323,267,612,324,267,611,,,-1,0,1,,,,,,
324,269,637,325,269,636,,,-1,0,1,,,,,,
325,270,662,326,270,662,,,-1,0,0,,,,,,
327,272,687,327,272,687,,,0,0,0,,,,,,
328,273,713,328,273,712,,,0,0,1,,,,,,
329,275,738,329,275,738,,,0,0,0,,,,,,
330,276,764,330,276,763,,,0,0,1,,,,,,
318,279,83,319,279,83,,,-1,0,0,,,,,,
318,279,85,319,279,83,,,-1,0,2,,,,,,
318,279,92,319,279,92,,,-1,0,0,,,,,,
318,279,104,319,279,106,,,-1,0,-2,,,,,,
319,279,120,319,279,120,,,0,0,0,,,,,,
319,280,138,319,279,139,,,0,1,-1,,,,,,
319,280,158,319,280,158,,,0,0,0,,,,,,
319,280,179,319,280,179,,,0,0,0,,,,,,
319,280,201,319,280,200,,,0,0,1,,,,,,
320,281,223,319,280,223,,,1,1,0,,,,,,
320,281,246,320,281,246,,,0,0,0,,,,,,
320,281,269,320,281,269,,,0,0,0,,,,,,
321,282,293,321,282,292,,,0,0,1,,,,,,
321,282,316,321,282,316,,,0,0,0,,,,,,
322,283,340,322,283,340,,,0,0,0,,,,,,
322,284,365,322,283,364,,,0,1,1,,,,,,
323,284,389,323,284,389,,,0,0,0,,,,,,
323,285,413,323,285,413,,,0,0,0,,,,,,
324,286,438,324,286,438,,,0,0,0,,,,,,
325,287,463,325,286,462,,,0,1,1,,,,,,
325,288,487,325,287,487,,,0,1,0,,,,,,
326,289,512,326,288,512,,,0,1,0,,,,,,
327,290,537,327,289,537,,,0,1,0,,,,,,
328,291,562,328,290,562,,,0,1,0,,,,,,
329,292,587,329,291,587,,,0,1,0,,,,,,
330,293,612,330,292,612,,,0,1,0,,,,,,
331,294,637,331,294,637,,,0,0,0,,,,,,
332,295,663,332,295,662,,,0,0,1,,,,,,
333,297,688,333,296,688,,,0,1,0,,,,,,
334,298,713,334,298,713,,,0,0,0,,,,,,
335,299,739,335,299,738,,,0,0,1,,,,,,
336,301,764,336,301,764,,,0,0,0,,,,,,
325,306,89,326,306,89,,,-1,0,0,,,,,,
325,306,91,326,306,89,,,-1,0,2,,,,,,
326,306,98,326,306,98,,,0,0,0,,,,,,
326,307,109,326,306,111,,,0,1,-2,,,,,,
326,307,124,326,307,124,,,0,0,0,,,,,,
326,307,142,326,307,143,,,0,0,-1,,,,,,
326,307,161,326,307,161,,,0,0,0,,,,,,
326,307,182,326,307,182,,,0,0,0,,,,,,
326,307,203,327,307,203,,,-1,0,0,,,,,,
327,308,225,327,307,225,,,0,1,0,,,,,,
327,308,248,327,308,248,,,0,0,0,,,,,,
327,309,271,327,308,271,,,0,1,0,,,,,,
328,309,294,328,309,294,,,0,0,0,,,,,,
328,309,318,328,309,318,,,0,0,0,,,,,,
329,310,342,329,310,342,,,0,0,0,,,,,,
329,311,366,329,310,366,,,0,1,0,,,,,,
330,311,390,330,311,390,,,0,0,0,,,,,,
330,312,415,330,312,414,,,0,0,1,,,,,,
331,312,439,331,312,439,,,0,0,0,,,,,,
332,313,464,332,313,463,,,0,0,1,,,,,,
332,314,488,333,314,488,,,-1,0,0,,,,,,
333,315,513,333,315,513,,,0,0,0,,,,,,
334,316,538,334,316,538,,,0,0,0,,,,,,
335,317,563,335,317,563,,,0,0,0,,,,,,
336,318,588,336,318,588,,,0,0,0,,,,,,
336,319,613,337,319,613,,,-1,0,0,,,,,,
337,320,638,338,320,638,,,-1,0,0,,,,,,
338,321,663,339,321,663,,,-1,0,0,,,,,,
339,322,689,340,322,688,,,-1,0,1,,,,,,
341,323,714,341,323,714,,,0,0,0,,,,,,
342,325,739,342,325,739,,,0,0,0,,,,,,
343,326,765,343,326,764,,,0,0,1,,,,,,
333,334,96,333,334,96,,,0,0,0,,,,,,
333,334,98,333,334,96,,,0,0,2,,,,,,
333,334,104,333,334,104,,,0,0,0,,,,,,
333,334,115,333,334,116,,,0,0,-1,,,,,,
333,334,129,334,334,129,,,-1,0,0,,,,,,
334,334,146,334,334,147,,,0,0,-1,,,,,,
334,334,165,334,334,165,,,0,0,0,,,,,,
334,335,185,334,334,185,,,0,1,0,,,,,,
334,335,206,334,334,206,,,0,1,0,,,,,,
334,335,228,334,335,228,,,0,0,0,,,,,,
335,336,250,335,335,250,,,0,1,0,,,,,,
335,336,273,335,336,273,,,0,0,0,,,,,,
335,336,296,335,336,296,,,0,0,0,,,,,,
336,337,320,336,337,320,,,0,0,0,,,,,,
336,337,343,336,337,343,,,0,0,0,,,,,,
337,338,367,337,338,367,,,0,0,0,,,,,,
337,338,392,337,338,391,,,0,0,1,,,,,,
338,339,416,338,339,416,,,0,0,0,,,,,,
338,339,440,338,339,440,,,0,0,0,,,,,,
339,340,465,339,340,465,,,0,0,0,,,,,,
340,341,489,340,341,489,,,0,0,0,,,,,,
341,342,514,341,341,514,,,0,1,0,,,,,,
341,343,539,342,342,539,,,-1,1,0,,,,,,
342,343,564,342,343,564,,,0,0,0,,,,,,
343,344,589,343,344,589,,,0,0,0,,,,,,
344,345,614,344,345,614,,,0,0,0,,,,,,
345,346,639,345,346,639,,,0,0,0,,,,,,
346,347,664,346,347,664,,,0,0,0,,,,,,
347,348,689,347,348,689,,,0,0,0,,,,,,
348,349,715,348,349,714,,,0,0,1,,,,,,
349,351,740,349,350,740,,,0,1,0,,,,,,
350,352,765,350,352,765,,,0,0,0,,,,,,
342,362,103,342,362,103,,,0,0,0,,,,,,
342,362,105,342,362,103,,,0,0,2,,,,,,
342,362,110,342,362,110,,,0,0,0,,,,,,
342,362,120,342,362,122,,,0,0,-2,,,,,,
342,362,134,342,362,134,,,0,0,0,,,,,,
342,362,150,342,362,151,,,0,0,-1,,,,,,
342,362,169,342,362,169,,,0,0,0,,,,,,
342,362,188,342,362,189,,,0,0,-1,,,,,,
342,363,209,343,362,209,,,-1,1,0,,,,,,
343,363,230,343,362,231,,,0,1,-1,,,,,,
343,363,253,343,363,253,,,0,0,0,,,,,,
343,363,275,344,363,275,,,-1,0,0,,,,,,
344,364,298,344,364,298,,,0,0,0,,,,,,
344,364,322,344,364,321,,,0,0,1,,,,,,
344,365,345,345,365,345,,,-1,0,0,,,,,,
345,365,369,345,365,369,,,0,0,0,,,,,,
345,366,393,346,366,393,,,-1,0,0,,,,,,
346,366,417,346,366,417,,,0,0,0,,,,,,
347,367,442,347,367,441,,,0,0,1,,,,,,
347,367,466,348,367,466,,,-1,0,0,,,,,,
348,368,491,348,368,490,,,0,0,1,,,,,,
349,369,515,349,369,515,,,0,0,0,,,,,,
349,370,540,350,369,540,,,-1,1,0,,,,,,
350,370,565,351,370,565,,,-1,0,0,,,,,,
351,371,590,351,371,590,,,0,0,0,,,,,,
352,372,615,352,372,615,,,0,0,0,,,,,,
353,373,640,353,373,640,,,0,0,0,,,,,,
354,374,665,354,374,665,,,0,0,0,,,,,,
355,375,690,355,375,690,,,0,0,0,,,,,,
356,376,715,356,376,715,,,0,0,0,,,,,,
357,377,741,357,377,740,,,0,0,1,,,,,,
358,378,766,358,378,766,,,0,0,0,,,,,,
350,390,110,350,390,110,,,0,0,0,,,,,,
350,390,111,350,390,110,,,0,0,1,,,,,,
350,390,117,350,390,117,,,0,0,0,,,,,,
351,390,126,351,390,128,,,0,0,-2,,,,,,
351,390,139,351,390,139,,,0,0,0,,,,,,
351,390,155,351,390,156,,,0,0,-1,,,,,,
351,390,173,351,390,173,,,0,0,0,,,,,,
351,390,192,351,390,192,,,0,0,0,,,,,,
351,390,212,351,390,212,,,0,0,0,,,,,,
352,391,233,352,390,234,,,0,1,-1,,,,,,
352,391,255,352,391,255,,,0,0,0,,,,,,
352,391,278,352,391,278,,,0,0,0,,,,,,
352,392,300,353,391,300,,,-1,1,0,,,,,,
353,392,324,353,392,323,,,0,0,1,,,,,,
353,392,347,353,392,347,,,0,0,0,,,,,,
354,393,371,354,393,370,,,0,0,1,,,,,,
354,393,395,354,393,394,,,0,0,1,,,,,,
355,394,419,355,394,418,,,0,0,1,,,,,,
355,394,443,356,394,443,,,-1,0,0,,,,,,
356,395,467,356,395,467,,,0,0,0,,,,,,
357,396,492,357,395,492,,,0,1,0,,,,,,
357,396,516,358,396,516,,,-1,0,0,,,,,,
358,397,541,359,397,541,,,-1,0,0,,,,,,
359,398,566,359,397,566,,,0,1,0,,,,,,
360,398,591,360,398,591,,,0,0,0,,,,,,
361,399,616,361,399,616,,,0,0,0,,,,,,
361,400,641,362,400,641,,,-1,0,0,,,,,,
362,401,666,363,401,666,,,-1,0,0,,,,,,
363,402,691,364,402,691,,,-1,0,0,,,,,,
364,403,716,365,403,716,,,-1,0,0,,,,,,
365,404,741,366,404,741,,,-1,0,0,,,,,,
367,405,767,367,405,766,,,0,0,1,,,,,,
360,418,117,360,418,117,,,0,0,0,,,,,,
360,418,118,360,418,117,,,0,0,1,,,,,,
360,418,124,360,418,123,,,0,0,1,,,,,,
360,418,133,360,418,134,,,0,0,-1,,,,,,
360,418,145,361,418,145,,,-1,0,0,,,,,,
360,418,160,361,418,161,,,-1,0,-1,,,,,,
360,418,177,361,418,177,,,-1,0,0,,,,,,
360,418,196,361,418,196,,,-1,0,0,,,,,,
361,419,216,361,418,216,,,0,1,0,,,,,,
361,419,237,361,418,237,,,0,1,0,,,,,,
361,419,258,362,419,258,,,-1,0,0,,,,,,
361,419,280,362,419,280,,,-1,0,0,,,,,,
362,420,303,362,419,303,,,0,1,0,,,,,,
362,420,326,362,420,326,,,0,0,0,,,,,,
363,420,349,363,420,349,,,0,0,0,,,,,,
363,421,373,363,420,372,,,0,1,1,,,,,,
364,421,396,364,421,396,,,0,0,0,,,,,,
364,422,420,364,421,420,,,0,1,0,,,,,,
365,422,445,365,422,444,,,0,0,1,,,,,,
365,423,469,366,422,469,,,-1,1,0,,,,,,
366,423,493,366,423,493,,,0,0,0,,,,,,
367,424,518,367,423,517,,,0,1,1,,,,,,
367,424,542,368,424,542,,,-1,0,0,,,,,,
368,425,567,368,425,567,,,0,0,0,,,,,,
369,426,592,369,426,592,,,0,0,0,,,,,,
370,427,617,370,426,617,,,0,1,0,,,,,,
371,427,642,371,427,642,,,0,0,0,,,,,,
371,428,667,372,428,667,,,-1,0,0,,,,,,
372,429,692,373,429,692,,,-1,0,0,,,,,,
373,430,717,374,430,717,,,-1,0,0,,,,,,
374,431,742,375,431,742,,,-1,0,0,,,,,,
376,432,768,376,432,767,,,0,0,1,,,,,,
370,446,124,370,446,124,,,0,0,0,,,,,,
370,446,126,370,446,124,,,0,0,2,,,,,,
370,446,130,370,446,130,,,0,0,0,,,,,,
370,446,139,370,446,140,,,0,0,-1,,,,,,
370,446,151,370,446,151,,,0,0,0,,,,,,
370,446,165,370,446,166,,,0,0,-1,,,,,,
370,446,182,370,446,182,,,0,0,0,,,,,,
370,447,200,370,446,200,,,0,1,0,,,,,,
371,447,219,371,447,219,,,0,0,0,,,,,,
371,447,240,371,447,240,,,0,0,0,,,,,,
371,447,261,371,447,261,,,0,0,0,,,,,,
371,447,283,371,447,283,,,0,0,0,,,,,,
372,448,305,372,448,305,,,0,0,0,,,,,,
372,448,328,372,448,328,,,0,0,0,,,,,,
372,448,351,373,448,351,,,-1,0,0,,,,,,
373,449,375,373,448,375,,,0,1,0,,,,,,
373,449,398,374,449,398,,,-1,0,0,,,,,,
374,450,422,374,449,422,,,0,1,0,,,,,,
374,450,446,375,450,446,,,-1,0,0,,,,,,
375,451,470,375,450,470,,,0,1,0,,,,,,
376,451,495,376,451,494,,,0,0,1,,,,,,
376,452,519,376,451,519,,,0,1,0,,,,,,
377,452,544,377,452,543,,,0,0,1,,,,,,
378,453,568,378,453,568,,,0,0,0,,,,,,
378,454,593,379,454,593,,,-1,0,0,,,,,,
379,454,618,379,454,618,,,0,0,0,,,,,,
380,455,643,380,455,643,,,0,0,0,,,,,,
381,456,668,381,456,668,,,0,0,0,,,,,,
382,457,693,382,457,693,,,0,0,0,,,,,,
383,457,718,383,457,718,,,0,0,0,,,,,,
384,458,743,384,458,743,,,0,0,0,,,,,,
385,459,769,385,459,768,,,0,0,1,,,,,,
380,474,131,380,474,131,,,0,0,0,,,,,,
380,474,133,380,474,131,,,0,0,2,,,,,,
380,474,137,381,474,137,,,-1,0,0,,,,,,
380,475,145,381,474,147,,,-1,1,-2,,,,,,
380,475,157,381,474,157,,,-1,1,0,,,,,,
380,475,170,381,474,171,,,-1,1,-1,,,,,,
380,475,186,381,474,186,,,-1,1,0,,,,,,
381,475,204,381,475,205,,,0,0,-1,,,,,,
381,475,223,381,475,223,,,0,0,0,,,,,,
381,475,243,381,475,244,,,0,0,-1,,,,,,
381,475,264,382,475,264,,,-1,0,0,,,,,,
382,476,286,382,475,286,,,0,1,0,,,,,,
382,476,308,382,476,308,,,0,0,0,,,,,,
382,476,331,383,476,331,,,-1,0,0,,,,,,
383,477,354,383,476,354,,,0,1,0,,,,,,
383,477,377,384,477,377,,,-1,0,0,,,,,,
384,477,400,384,477,400,,,0,0,0,,,,,,
384,478,424,385,477,424,,,-1,1,0,,,,,,
385,478,448,385,478,448,,,0,0,0,,,,,,
385,479,472,386,478,472,,,-1,1,0,,,,,,
386,479,496,386,479,496,,,0,0,0,,,,,,
386,480,521,387,479,520,,,-1,1,1,,,,,,
387,480,545,387,480,545,,,0,0,0,,,,,,
388,481,570,388,480,569,,,0,1,1,,,,,,
389,481,594,389,481,594,,,0,0,0,,,,,,
389,482,619,390,482,619,,,-1,0,0,,,,,,
390,483,644,391,483,644,,,-1,0,0,,,,,,
391,484,669,391,483,669,,,0,1,0,,,,,,
392,484,694,392,484,694,,,0,0,0,,,,,,
393,485,719,393,485,719,,,0,0,0,,,,,,
394,486,744,394,486,744,,,0,0,0,,,,,,
395,487,769,395,486,769,,,0,1,0,,,,,,
391,503,139,391,503,139,,,0,0,0,,,,,,
391,503,140,391,503,139,,,0,0,1,,,,,,
391,503,144,391,503,144,,,0,0,0,,,,,,
391,503,152,391,503,153,,,0,0,-1,,,,,,
391,503,163,391,503,163,,,0,0,0,,,,,,
391,503,176,391,503,177,,,0,0,-1,,,,,,
391,503,192,392,503,191,,,-1,0,1,,,,,,
391,503,209,392,503,209,,,-1,0,0,,,,,,
392,504,227,392,504,227,,,0,0,0,,,,,,
392,504,247,392,504,247,,,0,0,0,,,,,,
392,504,268,393,504,267,,,-1,0,1,,,,,,
392,504,289,393,504,289,,,-1,0,0,,,,,,
393,504,311,393,504,311,,,0,0,0,,,,,,
393,505,333,393,504,334,,,0,1,-1,,,,,,
393,505,356,394,505,356,,,-1,0,0,,,,,,
394,505,379,394,505,379,,,0,0,0,,,,,,
394,506,403,395,506,402,,,-1,0,1,,,,,,
395,506,426,395,506,426,,,0,0,0,,,,,,
395,506,450,396,506,450,,,-1,0,0,,,,,,
396,507,474,396,506,474,,,0,1,0,,,,,,
396,507,498,397,507,498,,,-1,0,0,,,,,,
397,508,522,397,507,522,,,0,1,0,,,,,,
398,508,547,398,508,546,,,0,0,1,,,,,,
398,509,571,398,508,571,,,0,1,0,,,,,,
399,510,596,399,509,596,,,0,1,0,,,,,,
400,510,621,400,510,620,,,0,0,1,,,,,,
401,511,645,401,511,645,,,0,0,0,,,,,,
401,511,670,402,511,670,,,-1,0,0,,,,,,
402,512,695,402,512,695,,,0,0,0,,,,,,
403,513,720,403,513,720,,,0,0,0,,,,,,
404,514,745,404,514,745,,,0,0,0,,,,,,
405,514,771,405,514,770,,,0,0,1,,,,,,
402,532,146,402,531,146,,,0,1,0,,,,,,
402,532,147,402,531,146,,,0,1,1,,,,,,
402,532,151,402,531,151,,,0,1,0,,,,,,
402,532,159,402,531,160,,,0,1,-1,,,,,,
402,532,169,402,531,169,,,0,1,0,,,,,,
402,532,182,403,531,182,,,-1,1,0,,,,,,
402,532,197,403,531,196,,,-1,1,1,,,,,,
403,532,214,403,532,214,,,0,0,0,,,,,,
403,532,232,403,532,232,,,0,0,0,,,,,,
403,532,251,403,532,251,,,0,0,0,,,,,,
403,532,271,404,532,271,,,-1,0,0,,,,,,
403,533,293,404,532,293,,,-1,1,0,,,,,,
404,533,314,404,532,314,,,0,1,0,,,,,,
404,533,336,404,533,336,,,0,0,0,,,,,,
404,533,359,405,533,359,,,-1,0,0,,,,,,
405,534,382,405,533,382,,,0,1,0,,,,,,
405,534,405,406,534,405,,,-1,0,0,,,,,,
406,534,428,406,534,428,,,0,0,0,,,,,,
406,535,452,407,535,452,,,-1,0,0,,,,,,
407,535,476,407,535,476,,,0,0,0,,,,,,
407,536,500,408,535,500,,,-1,1,0,,,,,,
408,536,524,408,536,524,,,0,0,0,,,,,,
409,537,548,409,536,548,,,0,1,0,,,,,,
409,537,573,409,537,572,,,0,0,1,,,,,,
410,538,597,410,537,597,,,0,1,0,,,,,,
411,538,622,411,538,622,,,0,0,0,,,,,,
412,539,647,412,539,646,,,0,0,1,,,,,,
412,540,672,413,539,671,,,-1,1,1,,,,,,
413,540,696,413,540,696,,,0,0,0,,,,,,
414,541,721,414,541,721,,,0,0,0,,,,,,
415,542,747,415,542,746,,,0,0,1,,,,,,
416,542,772,416,542,771,,,0,0,1,,,,,,
414,560,154,414,560,154,,,0,0,0,,,,,,
414,560,155,414,560,154,,,0,0,1,,,,,,
414,560,159,414,560,159,,,0,0,0,,,,,,
414,560,165,414,560,167,,,0,0,-2,,,,,,
414,560,175,414,560,175,,,0,0,0,,,,,,
414,560,188,414,560,188,,,0,0,0,,,,,,
414,560,202,414,560,202,,,0,0,0,,,,,,
414,561,219,414,560,219,,,0,1,0,,,,,,
414,561,236,415,561,236,,,-1,0,0,,,,,,
414,561,255,415,561,256,,,-1,0,-1,,,,,,
415,561,275,415,561,275,,,0,0,0,,,,,,
415,561,296,415,561,296,,,0,0,0,,,,,,
415,561,317,416,561,317,,,-1,0,0,,,,,,
416,562,339,416,561,339,,,0,1,0,,,,,,
416,562,362,416,562,361,,,0,0,1,,,,,,
416,562,384,417,562,384,,,-1,0,0,,,,,,
417,563,407,417,562,407,,,0,1,0,,,,,,
417,563,431,417,563,430,,,0,0,1,,,,,,
418,563,454,418,563,454,,,0,0,0,,,,,,
418,564,478,418,563,478,,,0,1,0,,,,,,
419,564,502,419,564,502,,,0,0,0,,,,,,
419,565,526,420,564,526,,,-1,1,0,,,,,,
420,565,550,420,565,550,,,0,0,0,,,,,,
421,566,574,421,565,574,,,0,1,0,,,,,,
421,566,599,421,566,599,,,0,0,0,,,,,,
422,567,624,422,566,623,,,0,1,1,,,,,,
423,567,648,423,567,648,,,0,0,0,,,,,,
424,568,673,424,567,673,,,0,1,0,,,,,,
424,568,698,425,568,698,,,-1,0,0,,,,,,
425,569,723,425,569,723,,,0,0,0,,,,,,
426,570,748,426,570,748,,,0,0,0,,,,,,
427,570,773,427,570,773,,,0,0,0,,,,,,
425,589,161,426,589,161,,,-1,0,0,,,,,,
425,589,162,426,589,161,,,-1,0,1,,,,,,
425,589,166,426,589,166,,,-1,0,0,,,,,,
425,589,172,426,589,173,,,-1,0,-1,,,,,,
426,589,182,426,589,181,,,0,0,1,,,,,,
426,589,194,426,589,194,,,0,0,0,,,,,,
426,589,208,426,589,207,,,0,0,1,,,,,,
426,589,224,426,589,224,,,0,0,0,,,,,,
426,589,241,427,589,241,,,-1,0,0,,,,,,
426,590,260,427,589,260,,,-1,1,0,,,,,,
426,590,279,427,589,279,,,-1,1,0,,,,,,
427,590,300,427,590,300,,,0,0,0,,,,,,
427,590,321,427,590,321,,,0,0,0,,,,,,
427,590,342,428,590,342,,,-1,0,0,,,,,,
428,591,365,428,590,364,,,0,1,1,,,,,,
428,591,387,428,591,387,,,0,0,0,,,,,,
428,591,410,429,591,410,,,-1,0,0,,,,,,
429,592,433,429,591,433,,,0,1,0,,,,,,
429,592,456,430,592,456,,,-1,0,0,,,,,,
430,592,480,430,592,480,,,0,0,0,,,,,,
430,593,504,431,592,504,,,-1,1,0,,,,,,
431,593,528,431,593,528,,,0,0,0,,,,,,
432,594,552,432,593,552,,,0,1,0,,,,,,
432,594,576,433,594,576,,,-1,0,0,,,,,,
433,594,601,433,594,600,,,0,0,1,,,,,,
434,595,625,434,595,625,,,0,0,0,,,,,,
434,596,650,435,595,649,,,-1,1,1,,,,,,
435,596,674,435,596,674,,,0,0,0,,,,,,
436,597,699,436,596,699,,,0,1,0,,,,,,
437,597,724,437,597,724,,,0,0,0,,,,,,
438,598,749,438,598,749,,,0,0,0,,,,,,
438,599,774,439,598,774,,,-1,1,0,,,,,,
438,618,169,438,618,169,,,0,0,0,,,,,,
438,618,170,438,618,169,,,0,0,1,,,,,,
438,618,173,438,618,173,,,0,0,0,,,,,,
438,618,179,438,618,180,,,0,0,-1,,,,,,
438,618,188,438,618,188,,,0,0,0,,,,,,
438,618,200,438,618,201,,,0,0,-1,,,,,,
438,618,213,438,618,213,,,0,0,0,,,,,,
438,618,229,438,618,229,,,0,0,0,,,,,,
438,618,246,439,618,246,,,-1,0,0,,,,,,
438,618,264,439,618,264,,,-1,0,0,,,,,,
439,619,283,439,618,283,,,0,1,0,,,,,,
439,619,304,439,618,304,,,0,1,0,,,,,,
439,619,324,439,619,324,,,0,0,0,,,,,,
439,619,346,440,619,346,,,-1,0,0,,,,,,
440,619,368,440,619,367,,,0,0,1,,,,,,
440,620,390,440,619,390,,,0,1,0,,,,,,
441,620,413,441,620,412,,,0,0,1,,,,,,
441,620,436,441,620,435,,,0,0,1,,,,,,
441,621,459,442,620,459,,,-1,1,0,,,,,,
442,621,482,442,621,482,,,0,0,0,,,,,,
442,621,506,443,621,506,,,-1,0,0,,,,,,
443,622,530,443,621,530,,,0,1,0,,,,,,
444,622,554,444,622,554,,,0,0,0,,,,,,
444,623,578,445,622,578,,,-1,1,0,,,,,,
445,623,602,445,623,602,,,0,0,0,,,,,,
446,624,627,446,623,627,,,0,1,0,,,,,,
446,624,651,446,624,651,,,0,0,0,,,,,,
447,625,676,447,624,676,,,0,1,0,,,,,,
448,625,701,448,625,701,,,0,0,0,,,,,,
449,626,726,449,625,725,,,0,1,1,,,,,,
449,626,750,450,626,750,,,-1,0,0,,,,,,
450,627,775,450,627,775,,,0,0,0,,,,,,
450,647,176,450,646,176,,,0,1,0,,,,,,
450,647,177,450,646,176,,,0,1,1,,,,,,
450,647,180,450,646,180,,,0,1,0,,,,,,
450,647,186,450,646,187,,,0,1,-1,,,,,,
450,647,195,450,647,195,,,0,0,0,,,,,,
450,647,206,450,647,207,,,0,0,-1,,,,,,
450,647,219,451,647,219,,,-1,0,0,,,,,,
450,647,234,451,647,235,,,-1,0,-1,,,,,,
451,647,251,451,647,251,,,0,0,0,,,,,,
451,647,269,451,647,269,,,0,0,0,,,,,,
451,647,288,451,647,288,,,0,0,0,,,,,,
451,648,308,452,647,308,,,-1,1,0,,,,,,
452,648,328,452,647,328,,,0,1,0,,,,,,
452,648,349,452,648,349,,,0,0,0,,,,,,
452,648,371,453,648,371,,,-1,0,0,,,,,,
453,648,393,453,648,393,,,0,0,0,,,,,,
453,649,415,453,648,415,,,0,1,0,,,,,,
453,649,438,454,649,438,,,-1,0,0,,,,,,
454,649,461,454,649,461,,,0,0,0,,,,,,
454,650,485,455,649,484,,,-1,1,1,,,,,,
455,650,508,455,650,508,,,0,0,0,,,,,,
455,650,532,456,650,532,,,-1,0,0,,,,,,
456,651,556,456,650,556,,,0,1,0,,,,,,
456,651,580,457,651,580,,,-1,0,0,,,,,,
457,652,604,458,651,604,,,-1,1,0,,,,,,
458,652,629,458,652,628,,,0,0,1,,,,,,
458,653,653,459,652,653,,,-1,1,0,,,,,,
459,653,678,459,653,677,,,0,0,1,,,,,,
460,654,702,460,653,702,,,0,1,0,,,,,,
461,654,727,461,654,727,,,0,0,0,,,,,,
461,655,752,462,655,752,,,-1,0,0,,,,,,
462,655,777,463,655,776,,,-1,0,1,,,,,,
463,676,184,463,675,184,,,0,1,0,,,,,,
463,676,185,463,675,184,,,0,1,1,,,,,,
463,676,188,463,675,188,,,0,1,0,,,,,,
463,676,194,463,675,195,,,0,1,-1,,,,,,
463,676,202,463,676,202,,,0,0,0,,,,,,
463,676,213,463,676,213,,,0,0,0,,,,,,
463,676,225,463,676,225,,,0,0,0,,,,,,
463,676,240,463,676,241,,,0,0,-1,,,,,,
463,676,256,464,676,256,,,-1,0,0,,,,,,
464,676,274,464,676,274,,,0,0,0,,,,,,
464,676,292,464,676,292,,,0,0,0,,,,,,
464,677,312,464,676,312,,,0,1,0,,,,,,
464,677,332,465,676,331,,,-1,1,1,,,,,,
465,677,353,465,677,353,,,0,0,0,,,,,,
465,677,374,465,677,374,,,0,0,0,,,,,,
465,677,396,465,677,396,,,0,0,0,,,,,,
466,678,418,466,677,418,,,0,1,0,,,,,,
466,678,441,466,678,441,,,0,0,0,,,,,,
466,678,464,467,678,464,,,-1,0,0,,,,,,
467,679,487,467,678,487,,,0,1,0,,,,,,
467,679,511,468,679,510,,,-1,0,1,,,,,,
468,679,534,468,679,534,,,0,0,0,,,,,,
468,680,558,469,679,558,,,-1,1,0,,,,,,
469,680,582,469,680,582,,,0,0,0,,,,,,
470,680,606,470,680,606,,,0,0,0,,,,,,
470,681,630,471,681,630,,,-1,0,0,,,,,,
471,681,655,471,681,655,,,0,0,0,,,,,,
472,682,679,472,682,679,,,0,0,0,,,,,,
472,682,704,472,682,704,,,0,0,0,,,,,,
473,683,729,473,683,728,,,0,0,1,,,,,,
474,683,753,474,683,753,,,0,0,0,,,,,,
475,684,778,475,684,778,,,0,0,0,,,,,,
476,705,191,476,704,191,,,0,1,0,,,,,,
476,705,192,476,704,191,,,0,1,1,,,,,,
476,705,195,476,704,195,,,0,1,0,,,,,,
476,705,201,476,704,202,,,0,1,-1,,,,,,
476,705,209,476,705,208,,,0,0,1,,,,,,
476,705,219,476,705,220,,,0,0,-1,,,,,,
476,705,231,476,705,231,,,0,0,0,,,,,,
476,705,246,476,705,246,,,0,0,0,,,,,,
476,705,261,477,705,261,,,-1,0,0,,,,,,
476,705,279,477,705,279,,,-1,0,0,,,,,,
477,705,297,477,705,297,,,0,0,0,,,,,,
477,706,316,477,705,316,,,0,1,0,,,,,,
477,706,336,478,705,335,,,-1,1,1,,,,,,
477,706,357,478,706,356,,,-1,0,1,,,,,,
478,706,378,478,706,378,,,0,0,0,,,,,,
478,706,399,478,706,399,,,0,0,0,,,,,,
478,707,422,479,706,421,,,-1,1,1,,,,,,
479,707,444,479,707,444,,,0,0,0,,,,,,
479,707,467,480,707,466,,,-1,0,1,,,,,,
480,707,490,480,707,489,,,0,0,1,,,,,,
480,708,513,480,707,513,,,0,1,0,,,,,,
481,708,537,481,708,536,,,0,0,1,,,,,,
481,708,560,481,708,560,,,0,0,0,,,,,,
482,709,584,482,709,584,,,0,0,0,,,,,,
482,709,608,483,709,608,,,-1,0,0,,,,,,
483,710,632,483,709,632,,,0,1,0,,,,,,
484,710,657,484,710,657,,,0,0,0,,,,,,
484,711,681,484,710,681,,,0,1,0,,,,,,
485,711,706,485,711,705,,,0,0,1,,,,,,
486,712,730,486,711,730,,,0,1,0,,,,,,
486,712,755,487,712,755,,,-1,0,0,,,,,,
487,713,780,487,712,780,,,0,1,0,,,,,,
489,734,199,489,734,199,,,0,0,0,,,,,,
489,734,200,489,734,199,,,0,0,1,,,,,,
489,734,203,489,734,202,,,0,0,1,,,,,,
489,734,208,489,734,209,,,0,0,-1,,,,,,
489,734,216,489,734,215,,,0,0,1,,,,,,
489,734,226,489,734,226,,,0,0,0,,,,,,
489,734,238,490,734,237,,,-1,0,1,,,,,,
489,734,251,490,734,252,,,-1,0,-1,,,,,,
489,734,267,490,734,266,,,-1,0,1,,,,,,
490,734,284,490,734,284,,,0,0,0,,,,,,
490,734,302,490,734,301,,,0,0,1,,,,,,
490,735,320,490,734,320,,,0,1,0,,,,,,
490,735,340,491,734,340,,,-1,1,0,,,,,,
491,735,360,491,735,360,,,0,0,0,,,,,,
491,735,381,491,735,381,,,0,0,0,,,,,,
491,735,403,491,735,403,,,0,0,0,,,,,,
492,736,425,492,735,424,,,0,1,1,,,,,,
492,736,447,492,736,447,,,0,0,0,,,,,,
492,736,470,493,736,469,,,-1,0,1,,,,,,
493,736,493,493,736,492,,,0,0,1,,,,,,
493,737,516,493,736,515,,,0,1,1,,,,,,
494,737,539,494,737,539,,,0,0,0,,,,,,
494,737,563,494,737,562,,,0,0,1,,,,,,
495,738,586,495,738,586,,,0,0,0,,,,,,
495,738,610,496,738,610,,,-1,0,0,,,,,,
496,739,635,496,738,634,,,0,1,1,,,,,,
497,739,659,497,739,659,,,0,0,0,,,,,,
497,739,683,497,739,683,,,0,0,0,,,,,,
498,740,708,498,740,707,,,0,0,1,,,,,,
499,740,732,499,740,732,,,0,0,0,,,,,,
499,741,757,499,741,757,,,0,0,0,,,,,,
500,741,782,500,741,781,,,0,0,1,,,,,,
502,763,207,502,763,206,,,0,0,1,,,,,,
502,763,207,502,763,206,,,0,0,1,,,,,,
502,763,210,502,763,210,,,0,0,0,,,,,,
502,763,215,503,763,216,,,-1,0,-1,,,,,,
502,763,223,503,763,222,,,-1,0,1,,,,,,
502,763,232,503,763,233,,,-1,0,-1,,,,,,
503,763,244,503,763,244,,,0,0,0,,,,,,
503,763,257,503,763,258,,,0,0,-1,,,,,,
503,763,272,503,763,272,,,0,0,0,,,,,,
503,763,289,503,763,289,,,0,0,0,,,,,,
503,764,306,503,763,306,,,0,1,0,,,,,,
503,764,325,504,763,325,,,-1,1,0,,,,,,
504,764,344,504,764,344,,,0,0,0,,,,,,
504,764,364,504,764,364,,,0,0,0,,,,,,
504,764,385,504,764,385,,,0,0,0,,,,,,
505,764,406,505,764,406,,,0,0,0,,,,,,
505,765,428,505,764,428,,,0,1,0,,,,,,
505,765,450,506,765,450,,,-1,0,0,,,,,,
506,765,473,506,765,472,,,0,0,1,,,,,,
506,766,495,506,765,495,,,0,1,0,,,,,,
506,766,518,507,765,518,,,-1,1,0,,,,,,
507,766,542,507,766,541,,,0,0,1,,,,,,
507,766,565,508,766,565,,,-1,0,0,,,,,,
508,767,589,508,767,588,,,0,0,1,,,,,,
509,767,613,509,767,612,,,0,0,1,,,,,,
509,768,637,509,767,636,,,0,1,1,,,,,,
510,768,661,510,768,661,,,0,0,0,,,,,,
510,768,685,511,768,685,,,-1,0,0,,,,,,
511,769,709,511,768,709,,,0,1,0,,,,,,
512,769,734,512,769,734,,,0,0,0,,,,,,
512,770,759,513,769,758,,,-1,1,1,,,,,,
513,770,783,513,770,783,,,0,0,0,,,,,,
516,792,214,516,792,214,,,0,0,0,,,,,,
516,792,215,516,792,214,,,0,0,1,,,,,,
516,792,218,516,792,217,,,0,0,1,,,,,,
516,792,223,516,792,223,,,0,0,0,,,,,,
516,792,230,517,792,229,,,-1,0,1,,,,,,
516,792,239,517,792,240,,,-1,0,-1,,,,,,
516,792,250,517,792,250,,,-1,0,0,,,,,,
516,793,264,517,792,264,,,-1,1,0,,,,,,
516,793,278,517,792,278,,,-1,1,0,,,,,,
517,793,294,517,792,295,,,0,1,-1,,,,,,
517,793,311,517,792,311,,,0,1,0,,,,,,
517,793,330,517,793,330,,,0,0,0,,,,,,
517,793,349,518,793,348,,,-1,0,1,,,,,,
517,793,369,518,793,368,,,-1,0,1,,,,,,
518,793,389,518,793,389,,,0,0,0,,,,,,
518,794,410,518,793,410,,,0,1,0,,,,,,
518,794,432,519,793,431,,,-1,1,1,,,,,,
519,794,453,519,794,453,,,0,0,0,,,,,,
519,794,476,520,794,475,,,-1,0,1,,,,,,
520,795,498,520,794,498,,,0,1,0,,,,,,
520,795,521,520,795,521,,,0,0,0,,,,,,
520,795,544,521,795,544,,,-1,0,0,,,,,,
521,796,568,521,795,567,,,0,1,1,,,,,,
521,796,591,522,796,591,,,-1,0,0,,,,,,
522,796,615,522,796,615,,,0,0,0,,,,,,
523,797,639,523,796,639,,,0,1,0,,,,,,
523,797,663,523,797,663,,,0,0,0,,,,,,
524,797,687,524,797,687,,,0,0,0,,,,,,
524,798,711,525,797,711,,,-1,1,0,,,,,,
525,798,736,525,798,736,,,0,0,0,,,,,,
526,799,760,526,798,760,,,0,1,0,,,,,,
527,799,785,527,799,785,,,0,0,0,,,,,,
530,822,222,530,821,222,,,0,1,0,,,,,,
530,822,223,530,821,222,,,0,1,1,,,,,,
530,822,225,530,821,225,,,0,1,0,,,,,,
530,822,230,530,821,231,,,0,1,-1,,,,,,
530,822,237,530,821,237,,,0,1,0,,,,,,
530,822,246,530,821,247,,,0,1,-1,,,,,,
530,822,257,530,822,257,,,0,0,0,,,,,,
530,822,270,530,822,270,,,0,0,0,,,,,,
530,822,284,530,822,284,,,0,0,0,,,,,,
530,822,300,530,822,300,,,0,0,0,,,,,,
531,822,317,531,822,316,,,0,0,1,,,,,,
531,822,334,531,822,334,,,0,0,0,,,,,,
531,822,353,531,822,353,,,0,0,0,,,,,,
531,823,373,531,822,373,,,0,1,0,,,,,,
531,823,393,532,822,393,,,-1,1,0,,,,,,
532,823,414,532,822,414,,,0,1,0,,,,,,
532,823,435,532,823,435,,,0,0,0,,,,,,
532,823,457,533,823,457,,,-1,0,0,,,,,,
533,824,479,533,823,479,,,0,1,0,,,,,,
533,824,501,533,823,501,,,0,1,0,,,,,,
534,824,524,534,824,524,,,0,0,0,,,,,,
534,824,547,534,824,547,,,0,0,0,,,,,,
535,825,570,535,824,570,,,0,1,0,,,,,,
535,825,594,535,825,593,,,0,0,1,,,,,,
536,825,617,536,825,617,,,0,0,0,,,,,,
536,826,641,536,825,641,,,0,1,0,,,,,,
537,826,665,537,826,665,,,0,0,0,,,,,,
537,826,689,537,826,689,,,0,0,0,,,,,,
538,827,714,538,826,713,,,0,1,1,,,,,,
539,827,738,539,827,737,,,0,0,1,,,,,,
539,828,762,540,827,762,,,-1,1,0,,,,,,
540,828,787,540,828,787,,,0,0,0,,,,,,
544,851,230,544,850,229,,,0,1,1,,,,,,
544,851,230,544,850,229,,,0,1,1,,,,,,
544,851,233,544,850,233,,,0,1,0,,,,,,
544,851,238,544,850,238,,,0,1,0,,,,,,
544,851,244,544,850,244,,,0,1,0,,,,,,
544,851,253,544,851,254,,,0,0,-1,,,,,,
544,851,264,544,851,263,,,0,0,1,,,,,,
544,851,276,544,851,276,,,0,0,0,,,,,,
544,851,290,544,851,289,,,0,0,1,,,,,,
544,851,305,544,851,305,,,0,0,0,,,,,,
544,851,322,545,851,321,,,-1,0,1,,,,,,
545,851,339,545,851,339,,,0,0,0,,,,,,
545,852,358,545,851,358,,,0,1,0,,,,,,
545,852,377,545,851,377,,,0,1,0,,,,,,
545,852,397,546,852,397,,,-1,0,0,,,,,,
546,852,418,546,852,418,,,0,0,0,,,,,,
546,852,439,546,852,439,,,0,0,0,,,,,,
546,853,460,546,852,460,,,0,1,0,,,,,,
547,853,482,547,852,482,,,0,1,0,,,,,,
547,853,505,547,853,504,,,0,0,1,,,,,,
547,853,527,548,853,527,,,-1,0,0,,,,,,
548,854,550,548,853,550,,,0,1,0,,,,,,
548,854,573,549,853,573,,,-1,1,0,,,,,,
549,854,596,549,854,596,,,0,0,0,,,,,,
549,855,620,550,854,620,,,-1,1,0,,,,,,
550,855,644,550,855,643,,,0,0,1,,,,,,
550,855,667,551,855,667,,,-1,0,0,,,,,,
551,856,692,551,855,691,,,0,1,1,,,,,,
552,856,716,552,856,715,,,0,0,1,,,,,,
552,856,740,552,856,739,,,0,0,1,,,,,,
553,857,764,553,856,764,,,0,1,0,,,,,,
554,857,789,554,857,788,,,0,0,1,,,,,,
558,880,238,558,880,237,,,0,0,1,,,,,,
558,880,238,558,880,237,,,0,0,1,,,,,,
558,880,241,558,880,240,,,0,0,1,,,,,,
558,880,245,558,880,246,,,0,0,-1,,,,,,
558,880,251,558,880,251,,,0,0,0,,,,,,
558,880,260,558,880,261,,,0,0,-1,,,,,,
558,880,270,558,880,270,,,0,0,0,,,,,,
558,880,282,558,880,283,,,0,0,-1,,,,,,
558,881,296,558,880,296,,,0,1,0,,,,,,
558,881,311,559,880,311,,,-1,1,0,,,,,,
559,881,327,559,881,327,,,0,0,0,,,,,,
559,881,345,559,881,344,,,0,0,1,,,,,,
559,881,363,559,881,362,,,0,0,1,,,,,,
559,881,382,559,881,382,,,0,0,0,,,,,,
559,881,401,560,881,401,,,-1,0,0,,,,,,
560,881,422,560,881,422,,,0,0,0,,,,,,
560,882,443,560,882,442,,,0,0,1,,,,,,
560,882,464,560,882,464,,,0,0,0,,,,,,
561,882,486,561,882,486,,,0,0,0,,,,,,
561,882,508,561,882,508,,,0,0,0,,,,,,
561,883,530,562,882,530,,,-1,1,0,,,,,,
562,883,553,562,882,553,,,0,1,0,,,,,,
562,883,576,563,883,576,,,-1,0,0,,,,,,
563,883,599,563,883,599,,,0,0,0,,,,,,
563,884,623,564,884,622,,,-1,0,1,,,,,,
564,884,646,564,884,646,,,0,0,0,,,,,,
564,884,670,565,884,670,,,-1,0,0,,,,,,
565,885,694,565,884,693,,,0,1,1,,,,,,
566,885,718,566,885,717,,,0,0,1,,,,,,
566,886,742,566,885,742,,,0,1,0,,,,,,
567,886,766,567,886,766,,,0,0,0,,,,,,
567,886,791,568,886,790,,,-1,0,1,,,,,,
313,87,47,313,87,47,,,0,0,0,,,,,,
313,87,51,313,87,47,,,0,0,4,,,,,,
313,87,63,313,87,63,,,0,0,0,,,,,,
313,87,80,313,87,81,,,0,0,-1,,,,,,
313,87,100,313,87,100,,,0,0,0,,,,,,
313,88,122,313,88,122,,,0,0,0,,,,,,
313,89,144,313,89,144,,,0,0,0,,,,,,
314,90,167,313,90,167,,,1,0,0,,,,,,
314,91,190,314,91,190,,,0,0,0,,,,,,
314,92,214,314,92,214,,,0,0,0,,,,,,
314,93,238,314,93,238,,,0,0,0,,,,,,
315,95,262,314,94,262,,,1,1,0,,,,,,
315,96,286,315,96,286,,,0,0,0,,,,,,
316,98,310,315,98,310,,,1,0,0,,,,,,
316,100,335,316,100,335,,,0,0,0,,,,,,
317,102,359,316,102,359,,,1,0,0,,,,,,
317,104,384,317,104,384,,,0,0,0,,,,,,
318,106,409,317,106,409,,,1,0,0,,,,,,
318,108,434,318,108,434,,,0,0,0,,,,,,
319,111,459,319,110,459,,,0,1,0,,,,,,
320,113,484,320,113,484,,,0,0,0,,,,,,
321,116,509,320,116,509,,,1,0,0,,,,,,
321,119,534,321,119,534,,,0,0,0,,,,,,
322,121,559,322,121,559,,,0,0,0,,,,,,
323,124,584,323,124,584,,,0,0,0,,,,,,
324,127,609,324,127,609,,,0,0,0,,,,,,
325,130,635,325,130,635,,,0,0,0,,,,,,
326,133,660,326,133,660,,,0,0,0,,,,,,
327,136,685,327,136,685,,,0,0,0,,,,,,
329,140,711,328,139,710,,,1,1,1,,,,,,
330,143,736,330,143,736,,,0,0,0,,,,,,
331,146,762,331,146,761,,,0,0,1,,,,,,
313,89,48,313,87,47,,,0,2,1,,,,,,
313,89,51,313,87,47,,,0,2,4,,,,,,
313,89,63,313,87,63,,,0,2,0,,,,,,
313,90,80,313,87,81,,,0,3,-1,,,,,,
313,90,100,313,87,100,,,0,3,0,,,,,,
313,91,122,313,88,122,,,0,3,0,,,,,,
313,91,144,313,89,144,,,0,2,0,,,,,,
314,92,167,313,90,167,,,1,2,0,,,,,,
314,93,190,314,91,190,,,0,2,0,,,,,,
314,94,214,314,92,214,,,0,2,0,,,,,,
315,96,238,314,93,238,,,1,3,0,,,,,,
315,97,262,314,94,262,,,1,3,0,,,,,,
315,98,286,315,96,286,,,0,2,0,,,,,,
316,100,310,315,98,310,,,1,2,0,,,,,,
316,102,335,316,100,335,,,0,2,0,,,,,,
317,104,359,316,102,359,,,1,2,0,,,,,,
317,106,384,317,104,384,,,0,2,0,,,,,,
318,108,409,317,106,409,,,1,2,0,,,,,,
319,110,434,318,108,434,,,1,2,0,,,,,,
319,113,459,319,110,459,,,0,3,0,,,,,,
320,115,484,320,113,484,,,0,2,0,,,,,,
321,118,509,320,116,509,,,1,2,0,,,,,,
322,121,534,321,119,534,,,1,2,0,,,,,,
323,123,559,322,121,559,,,1,2,0,,,,,,
323,126,584,323,124,584,,,0,2,0,,,,,,
324,129,609,324,127,609,,,0,2,0,,,,,,
325,132,635,325,130,635,,,0,2,0,,,,,,
326,135,660,326,133,660,,,0,2,0,,,,,,
328,138,685,327,136,685,,,1,2,0,,,,,,
329,141,711,328,139,710,,,1,2,1,,,,,,
330,144,736,330,143,736,,,0,1,0,,,,,,
331,147,762,331,146,761,,,0,1,1,,,,,,
314,98,49,314,98,49,,,0,0,0,,,,,,
314,98,52,314,98,49,,,0,0,3,,,,,,
314,99,64,314,99,64,,,0,0,0,,,,,,
314,99,81,314,99,82,,,0,0,-1,,,,,,
314,99,101,314,99,101,,,0,0,0,,,,,,
314,100,122,314,99,122,,,0,1,0,,,,,,
314,100,144,314,100,144,,,0,0,0,,,,,,
314,101,167,314,101,167,,,0,0,0,,,,,,
315,102,190,315,102,190,,,0,0,0,,,,,,
315,103,214,315,103,214,,,0,0,0,,,,,,
315,104,238,315,104,238,,,0,0,0,,,,,,
316,105,262,315,105,262,,,1,0,0,,,,,,
316,107,286,316,107,286,,,0,0,0,,,,,,
316,108,311,316,108,310,,,0,0,1,,,,,,
317,110,335,317,110,335,,,0,0,0,,,,,,
317,112,360,317,112,359,,,0,0,1,,,,,,
318,114,384,318,114,384,,,0,0,0,,,,,,
319,116,409,318,116,409,,,1,0,0,,,,,,
319,118,434,319,118,434,,,0,0,0,,,,,,
320,120,459,320,120,459,,,0,0,0,,,,,,
321,122,484,321,122,484,,,0,0,0,,,,,,
322,125,509,321,124,509,,,1,1,0,,,,,,
322,127,534,322,127,534,,,0,0,0,,,,,,
323,130,559,323,130,559,,,0,0,0,,,,,,
324,133,584,324,133,584,,,0,0,0,,,,,,
325,135,609,325,135,609,,,0,0,0,,,,,,
326,138,635,326,138,635,,,0,0,0,,,,,,
327,141,660,327,141,660,,,0,0,0,,,,,,
328,144,685,328,144,685,,,0,0,0,,,,,,
329,147,711,329,147,710,,,0,0,1,,,,,,
331,150,736,331,150,736,,,0,0,0,,,,,,
332,153,762,332,153,761,,,0,0,1,,,,,,
315,113,51,315,115,51,,,0,-2,0,,,,,,
315,113,54,315,115,51,,,0,-2,3,,,,,,
315,114,66,315,116,66,,,0,-2,0,,,,,,
315,114,82,315,116,84,,,0,-2,-2,,,,,,
315,114,102,315,116,102,,,0,-2,0,,,,,,
315,114,123,315,116,123,,,0,-2,0,,,,,,
315,115,145,315,117,145,,,0,-2,0,,,,,,
316,116,168,316,117,168,,,0,-1,0,,,,,,
316,116,191,316,118,191,,,0,-2,0,,,,,,
316,117,214,316,119,214,,,0,-2,0,,,,,,
317,118,238,316,120,238,,,1,-2,0,,,,,,
317,119,262,317,121,262,,,0,-2,0,,,,,,
317,121,286,317,123,286,,,0,-2,0,,,,,,
318,122,311,318,124,311,,,0,-2,0,,,,,,
318,124,335,318,125,335,,,0,-1,0,,,,,,
319,125,360,319,127,360,,,0,-2,0,,,,,,
319,127,384,319,129,384,,,0,-2,0,,,,,,
320,129,409,320,130,409,,,0,-1,0,,,,,,
321,130,434,320,132,434,,,1,-2,0,,,,,,
321,132,459,321,134,459,,,0,-2,0,,,,,,
322,135,484,322,136,484,,,0,-1,0,,,,,,
323,137,509,323,138,509,,,0,-1,0,,,,,,
324,139,534,323,141,534,,,1,-2,0,,,,,,
324,141,559,324,143,559,,,0,-2,0,,,,,,
325,144,584,325,146,584,,,0,-2,0,,,,,,
326,146,610,326,148,609,,,0,-2,1,,,,,,
327,149,635,327,150,635,,,0,-1,0,,,,,,
328,151,660,328,153,660,,,0,-2,0,,,,,,
329,154,686,329,156,685,,,0,-2,1,,,,,,
331,157,711,331,158,711,,,0,-1,0,,,,,,
332,160,736,332,161,736,,,0,-1,0,,,,,,
333,163,762,333,164,762,,,0,-1,0,,,,,,
317,132,54,317,132,54,,,0,0,0,,,,,,
317,132,57,317,132,54,,,0,0,3,,,,,,
317,133,68,317,133,68,,,0,0,0,,,,,,
317,133,84,317,133,85,,,0,0,-1,,,,,,
317,133,103,317,133,103,,,0,0,0,,,,,,
317,133,124,317,133,124,,,0,0,0,,,,,,
317,134,146,317,134,146,,,0,0,0,,,,,,
318,134,169,317,134,169,,,1,0,0,,,,,,
318,135,192,318,135,192,,,0,0,0,,,,,,
318,136,215,318,136,215,,,0,0,0,,,,,,
318,137,239,318,137,239,,,0,0,0,,,,,,
319,138,263,318,138,263,,,1,0,0,,,,,,
319,139,287,319,139,287,,,0,0,0,,,,,,
320,140,311,319,140,311,,,1,0,0,,,,,,
320,141,336,320,141,336,,,0,0,0,,,,,,
321,142,360,320,142,360,,,1,0,0,,,,,,
321,144,385,321,144,385,,,0,0,0,,,,,,
322,145,410,321,145,409,,,1,0,1,,,,,,
322,147,434,322,147,434,,,0,0,0,,,,,,
323,149,459,323,149,459,,,0,0,0,,,,,,
324,151,484,324,151,484,,,0,0,0,,,,,,
325,153,509,324,153,509,,,1,0,0,,,,,,
325,155,534,325,155,534,,,0,0,0,,,,,,
326,157,559,326,157,559,,,0,0,0,,,,,,
327,159,585,327,159,585,,,0,0,0,,,,,,
328,161,610,328,161,610,,,0,0,0,,,,,,
329,163,635,329,163,635,,,0,0,0,,,,,,
330,166,660,330,165,660,,,0,1,0,,,,,,
331,168,686,331,168,686,,,0,0,0,,,,,,
332,171,711,332,170,711,,,0,1,0,,,,,,
334,173,737,334,173,737,,,0,0,0,,,,,,
335,176,762,335,176,762,,,0,0,0,,,,,,
320,154,58,320,155,58,,,0,-1,0,,,,,,
320,154,61,320,155,58,,,0,-1,3,,,,,,
320,154,71,320,155,71,,,0,-1,0,,,,,,
320,154,86,320,155,88,,,0,-1,-2,,,,,,
320,155,105,320,155,105,,,0,0,0,,,,,,
320,155,126,320,156,126,,,0,-1,0,,,,,,
320,155,147,320,156,147,,,0,-1,0,,,,,,
320,156,170,320,157,170,,,0,-1,0,,,,,,
320,156,193,321,157,193,,,-1,-1,0,,,,,,
321,157,216,321,158,216,,,0,-1,0,,,,,,
321,158,240,321,159,240,,,0,-1,0,,,,,,
321,159,263,321,159,263,,,0,0,0,,,,,,
322,159,288,322,160,287,,,0,-1,1,,,,,,
322,160,312,322,161,312,,,0,-1,0,,,,,,
323,162,336,323,162,336,,,0,0,0,,,,,,
323,163,361,323,163,361,,,0,0,0,,,,,,
324,164,385,324,165,385,,,0,-1,0,,,,,,
324,165,410,324,166,410,,,0,-1,0,,,,,,
325,167,435,325,168,434,,,0,-1,1,,,,,,
326,168,460,326,169,459,,,0,-1,1,,,,,,
326,170,484,327,171,484,,,-1,-1,0,,,,,,
327,172,509,327,172,509,,,0,0,0,,,,,,
328,173,535,328,174,534,,,0,-1,1,,,,,,
329,175,560,329,176,559,,,0,-1,1,,,,,,
330,177,585,330,178,585,,,0,-1,0,,,,,,
331,179,610,331,180,610,,,0,-1,0,,,,,,
332,181,635,332,182,635,,,0,-1,0,,,,,,
333,183,661,333,184,660,,,0,-1,1,,,,,,
334,185,686,334,186,686,,,0,-1,0,,,,,,
335,188,711,335,188,711,,,0,0,0,,,,,,
336,190,737,336,191,737,,,0,-1,0,,,,,,
337,192,762,337,193,762,,,0,-1,0,,,,,,
323,178,62,323,178,62,,,0,0,0,,,,,,
323,178,65,323,178,62,,,0,0,3,,,,,,
323,178,75,323,178,75,,,0,0,0,,,,,,
323,178,89,323,178,91,,,0,0,-2,,,,,,
323,178,107,323,178,107,,,0,0,0,,,,,,
323,178,128,323,178,128,,,0,0,0,,,,,,
323,179,149,323,179,149,,,0,0,0,,,,,,
323,179,171,323,179,171,,,0,0,0,,,,,,
324,180,194,324,180,194,,,0,0,0,,,,,,
324,180,217,324,180,217,,,0,0,0,,,,,,
324,181,241,324,181,241,,,0,0,0,,,,,,
325,182,264,324,181,264,,,1,1,0,,,,,,
325,182,288,325,182,288,,,0,0,0,,,,,,
325,183,312,325,183,312,,,0,0,0,,,,,,
326,184,337,326,184,337,,,0,0,0,,,,,,
326,185,361,326,185,361,,,0,0,0,,,,,,
327,186,386,327,186,386,,,0,0,0,,,,,,
328,187,410,327,187,410,,,1,0,0,,,,,,
328,189,435,328,189,435,,,0,0,0,,,,,,
329,190,460,329,190,460,,,0,0,0,,,,,,
330,191,485,330,191,485,,,0,0,0,,,,,,
330,193,510,330,192,510,,,0,1,0,,,,,,
331,194,535,331,194,535,,,0,0,0,,,,,,
332,196,560,332,196,560,,,0,0,0,,,,,,
333,198,585,333,198,585,,,0,0,0,,,,,,
334,199,610,334,199,610,,,0,0,0,,,,,,
335,201,636,335,201,636,,,0,0,0,,,,,,
336,203,661,336,203,661,,,0,0,0,,,,,,
337,205,686,337,205,686,,,0,0,0,,,,,,
338,207,712,338,207,711,,,0,0,1,,,,,,
339,209,737,339,209,737,,,0,0,0,,,,,,
340,211,763,340,211,762,,,0,0,1,,,,,,
327,203,67,327,203,67,,,0,0,0,,,,,,
327,203,70,327,203,67,,,0,0,3,,,,,,
327,203,79,327,203,79,,,0,0,0,,,,,,
327,203,93,327,203,94,,,0,0,-1,,,,,,
327,203,110,327,203,110,,,0,0,0,,,,,,
327,203,130,327,203,130,,,0,0,0,,,,,,
327,203,151,327,204,151,,,0,-1,0,,,,,,
327,204,173,327,204,173,,,0,0,0,,,,,,
328,204,195,328,205,195,,,0,-1,0,,,,,,
328,205,218,328,205,218,,,0,0,0,,,,,,
328,205,242,328,205,242,,,0,0,0,,,,,,
329,206,265,329,206,265,,,0,0,0,,,,,,
329,206,289,329,207,289,,,0,-1,0,,,,,,
329,207,313,329,207,313,,,0,0,0,,,,,,
330,208,338,330,208,338,,,0,0,0,,,,,,
330,209,362,330,209,362,,,0,0,0,,,,,,
331,210,386,331,210,386,,,0,0,0,,,,,,
331,211,411,331,211,411,,,0,0,0,,,,,,
332,212,436,332,212,436,,,0,0,0,,,,,,
333,213,461,333,213,460,,,0,0,1,,,,,,
333,214,485,334,215,485,,,-1,-1,0,,,,,,
334,216,510,334,216,510,,,0,0,0,,,,,,
335,217,535,335,217,535,,,0,0,0,,,,,,
336,218,560,336,219,560,,,0,-1,0,,,,,,
337,220,586,337,221,585,,,0,-1,1,,,,,,
338,222,611,338,222,610,,,0,0,1,,,,,,
339,223,636,339,223,636,,,0,0,0,,,,,,
340,225,661,340,225,661,,,0,0,0,,,,,,
341,227,687,341,227,686,,,0,0,1,,,,,,
342,228,712,342,229,712,,,0,-1,0,,,,,,
343,230,737,343,231,737,,,0,-1,0,,,,,,
344,232,763,344,233,763,,,0,-1,0,,,,,,
331,228,73,331,228,73,,,0,0,0,,,,,,
331,228,75,331,228,73,,,0,0,2,,,,,,
331,228,83,331,228,83,,,0,0,0,,,,,,
331,228,97,331,228,98,,,0,0,-1,,,,,,
332,228,114,332,228,114,,,0,0,0,,,,,,
332,229,133,332,228,133,,,0,1,0,,,,,,
332,229,153,332,229,153,,,0,0,0,,,,,,
332,229,175,332,229,175,,,0,0,0,,,,,,
332,230,197,332,230,197,,,0,0,0,,,,,,
333,230,220,332,230,220,,,1,0,0,,,,,,
333,230,243,333,230,243,,,0,0,0,,,,,,
333,231,267,333,231,266,,,0,0,1,,,,,,
334,232,290,334,232,290,,,0,0,0,,,,,,
334,232,314,334,232,314,,,0,0,0,,,,,,
334,233,339,334,233,339,,,0,0,0,,,,,,
335,234,363,334,234,363,,,1,0,0,,,,,,
335,235,387,335,235,387,,,0,0,0,,,,,,
336,236,412,336,235,412,,,0,1,0,,,,,,
337,236,437,337,236,437,,,0,0,0,,,,,,
337,238,461,337,237,461,,,0,1,0,,,,,,
338,239,486,338,239,486,,,0,0,0,,,,,,
339,240,511,339,240,511,,,0,0,0,,,,,,
340,241,536,340,241,536,,,0,0,0,,,,,,
340,242,561,340,242,561,,,0,0,0,,,,,,
341,244,586,341,244,586,,,0,0,0,,,,,,
342,245,611,342,245,611,,,0,0,0,,,,,,
343,246,636,343,246,636,,,0,0,0,,,,,,
344,248,662,344,248,661,,,0,0,1,,,,,,
345,250,687,345,250,687,,,0,0,0,,,,,,
346,251,712,346,251,712,,,0,0,0,,,,,,
347,253,738,347,253,738,,,0,0,0,,,,,,
348,255,763,348,254,763,,,0,1,0,,,,,,
337,254,79,337,254,79,,,0,0,0,,,,,,
337,254,81,337,254,79,,,0,0,2,,,,,,
337,254,89,337,254,88,,,0,0,1,,,,,,
337,255,101,337,254,103,,,0,1,-2,,,,,,
337,255,117,337,254,117,,,0,1,0,,,,,,
337,255,136,337,255,136,,,0,0,0,,,,,,
337,255,156,337,255,156,,,0,0,0,,,,,,
337,255,177,337,255,177,,,0,0,0,,,,,,
338,256,199,337,256,199,,,1,0,0,,,,,,
338,256,222,338,256,222,,,0,0,0,,,,,,
338,256,245,338,256,245,,,0,0,0,,,,,,
338,257,268,339,257,268,,,-1,0,0,,,,,,
339,257,292,339,258,291,,,0,-1,1,,,,,,
339,258,316,339,258,315,,,0,0,1,,,,,,
340,259,340,340,259,340,,,0,0,0,,,,,,
340,259,364,340,259,364,,,0,0,0,,,,,,
341,260,388,341,260,388,,,0,0,0,,,,,,
341,261,413,341,261,412,,,0,0,1,,,,,,
342,262,437,342,262,437,,,0,0,0,,,,,,
343,263,462,343,263,462,,,0,0,0,,,,,,
343,264,487,343,264,487,,,0,0,0,,,,,,
344,265,512,344,265,511,,,0,0,1,,,,,,
345,266,537,345,266,536,,,0,0,1,,,,,,
346,267,562,346,267,561,,,0,0,1,,,,,,
346,268,587,346,268,586,,,0,0,1,,,,,,
347,269,612,347,269,611,,,0,0,1,,,,,,
348,271,637,348,271,637,,,0,0,0,,,,,,
349,272,662,349,272,662,,,0,0,0,,,,,,
350,273,688,350,274,687,,,0,-1,1,,,,,,
351,275,713,351,275,713,,,0,0,0,,,,,,
352,276,738,352,277,738,,,0,-1,0,,,,,,
354,278,764,353,278,764,,,1,0,0,,,,,,
343,281,85,343,281,85,,,0,0,0,,,,,,
343,281,87,343,281,85,,,0,0,2,,,,,,
343,281,94,343,281,94,,,0,0,0,,,,,,
343,281,106,343,281,107,,,0,0,-1,,,,,,
343,281,121,343,281,121,,,0,0,0,,,,,,
343,282,139,343,281,140,,,0,1,-1,,,,,,
343,282,159,343,282,159,,,0,0,0,,,,,,
343,282,180,343,282,180,,,0,0,0,,,,,,
343,282,201,343,282,201,,,0,0,0,,,,,,
344,283,224,343,282,224,,,1,1,0,,,,,,
344,283,247,344,283,247,,,0,0,0,,,,,,
344,283,270,344,283,270,,,0,0,0,,,,,,
345,284,293,345,284,293,,,0,0,0,,,,,,
345,284,317,345,284,317,,,0,0,0,,,,,,
346,285,341,346,285,341,,,0,0,0,,,,,,
346,286,365,346,285,365,,,0,1,0,,,,,,
347,286,389,347,286,389,,,0,0,0,,,,,,
347,287,414,347,287,413,,,0,0,1,,,,,,
348,288,438,348,288,438,,,0,0,0,,,,,,
348,289,463,348,288,463,,,0,1,0,,,,,,
349,289,488,349,289,488,,,0,0,0,,,,,,
350,290,512,350,290,512,,,0,0,0,,,,,,
351,291,537,351,291,537,,,0,0,0,,,,,,
351,292,562,351,292,562,,,0,0,0,,,,,,
352,293,587,352,293,587,,,0,0,0,,,,,,
353,295,613,353,294,612,,,0,1,1,,,,,,
354,296,638,354,296,638,,,0,0,0,,,,,,
355,297,663,355,297,663,,,0,0,0,,,,,,
356,298,688,356,298,688,,,0,0,0,,,,,,
357,300,713,357,299,713,,,0,1,0,,,,,,
358,301,739,358,301,739,,,0,0,0,,,,,,
359,302,764,359,302,764,,,0,0,0,,,,,,
349,308,91,349,308,91,,,0,0,0,,,,,,
349,308,93,349,308,91,,,0,0,2,,,,,,
349,308,100,349,308,100,,,0,0,0,,,,,,
349,308,111,349,308,112,,,0,0,-1,,,,,,
349,308,126,350,308,125,,,-1,0,1,,,,,,
350,309,143,350,308,144,,,0,1,-1,,,,,,
350,309,162,350,309,162,,,0,0,0,,,,,,
350,309,182,350,309,183,,,0,0,-1,,,,,,
350,309,204,350,309,204,,,0,0,0,,,,,,
350,310,226,350,309,226,,,0,1,0,,,,,,
351,310,249,351,310,249,,,0,0,0,,,,,,
351,310,272,351,310,272,,,0,0,0,,,,,,
351,311,295,351,311,295,,,0,0,0,,,,,,
352,311,318,352,311,318,,,0,0,0,,,,,,
352,312,342,352,312,342,,,0,0,0,,,,,,
353,312,366,353,312,366,,,0,0,0,,,,,,
353,313,391,353,313,390,,,0,0,1,,,,,,
354,313,415,354,313,415,,,0,0,0,,,,,,
354,314,439,354,314,439,,,0,0,0,,,,,,
355,315,464,355,315,464,,,0,0,0,,,,,,
355,316,489,356,315,489,,,-1,1,0,,,,,,
356,317,513,356,316,513,,,0,1,0,,,,,,
357,317,538,357,317,538,,,0,0,0,,,,,,
358,318,563,358,318,563,,,0,0,0,,,,,,
359,319,588,358,319,588,,,1,0,0,,,,,,
359,320,613,359,320,613,,,0,0,0,,,,,,
360,322,638,360,322,638,,,0,0,0,,,,,,
361,323,664,361,323,663,,,0,0,1,,,,,,
362,324,689,362,324,689,,,0,0,0,,,,,,
363,325,714,363,325,714,,,0,0,0,,,,,,
364,326,739,364,326,739,,,0,0,0,,,,,,
365,328,765,365,328,765,,,0,0,0,,,,,,
356,336,98,356,336,98,,,0,0,0,,,,,,
356,336,100,356,336,98,,,0,0,2,,,,,,
356,336,106,356,336,106,,,0,0,0,,,,,,
356,336,116,356,336,118,,,0,0,-2,,,,,,
357,336,130,357,336,130,,,0,0,0,,,,,,
357,336,147,357,336,148,,,0,0,-1,,,,,,
357,336,166,357,336,166,,,0,0,0,,,,,,
357,336,186,357,336,186,,,0,0,0,,,,,,
357,336,207,357,336,207,,,0,0,0,,,,,,
357,337,228,357,336,229,,,0,1,-1,,,,,,
358,337,251,358,337,251,,,0,0,0,,,,,,
358,337,274,358,337,274,,,0,0,0,,,,,,
358,338,297,358,338,297,,,0,0,0,,,,,,
359,338,320,358,338,320,,,1,0,0,,,,,,
359,339,344,359,339,344,,,0,0,0,,,,,,
360,339,368,359,339,368,,,1,0,0,,,,,,
360,340,392,360,340,392,,,0,0,0,,,,,,
361,340,416,360,340,416,,,1,0,0,,,,,,
361,341,441,361,341,441,,,0,0,0,,,,,,
362,342,465,362,341,465,,,0,1,0,,,,,,
363,342,490,363,342,490,,,0,0,0,,,,,,
363,343,514,363,343,514,,,0,0,0,,,,,,
364,344,539,364,344,539,,,0,0,0,,,,,,
365,345,564,364,345,564,,,1,0,0,,,,,,
365,346,589,365,346,589,,,0,0,0,,,,,,
366,347,614,366,347,614,,,0,0,0,,,,,,
367,348,639,367,348,639,,,0,0,0,,,,,,
368,349,664,368,349,664,,,0,0,0,,,,,,
369,350,690,369,350,690,,,0,0,0,,,,,,
370,351,715,370,351,715,,,0,0,0,,,,,,
371,352,740,371,352,740,,,0,0,0,,,,,,
372,353,765,372,353,765,,,0,0,0,,,,,,
364,363,105,364,363,104,,,0,0,1,,,,,,
364,363,106,364,363,104,,,0,0,2,,,,,,
364,363,112,364,363,112,,,0,0,0,,,,,,
364,363,122,364,363,123,,,0,0,-1,,,,,,
364,363,135,365,363,135,,,-1,0,0,,,,,,
364,363,151,365,363,152,,,-1,0,-1,,,,,,
365,364,169,365,363,170,,,0,1,-1,,,,,,
365,364,189,365,363,190,,,0,1,-1,,,,,,
365,364,210,365,364,210,,,0,0,0,,,,,,
365,364,231,365,364,231,,,0,0,0,,,,,,
365,365,253,366,364,253,,,-1,1,0,,,,,,
366,365,276,366,365,276,,,0,0,0,,,,,,
366,365,299,366,365,299,,,0,0,0,,,,,,
366,366,322,366,366,322,,,0,0,0,,,,,,
367,366,346,367,366,345,,,0,0,1,,,,,,
367,367,369,367,367,369,,,0,0,0,,,,,,
368,367,393,368,367,393,,,0,0,0,,,,,,
368,368,418,368,368,417,,,0,0,1,,,,,,
369,368,442,369,368,442,,,0,0,0,,,,,,
369,369,466,369,369,466,,,0,0,0,,,,,,
370,370,491,370,369,491,,,0,1,0,,,,,,
371,370,515,371,370,515,,,0,0,0,,,,,,
371,371,540,372,371,540,,,-1,0,0,,,,,,
372,372,565,372,372,565,,,0,0,0,,,,,,
373,373,590,373,373,590,,,0,0,0,,,,,,
374,373,615,374,373,615,,,0,0,0,,,,,,
375,374,640,375,374,640,,,0,0,0,,,,,,
376,375,665,376,375,665,,,0,0,0,,,,,,
377,376,690,377,376,690,,,0,0,0,,,,,,
378,377,716,378,377,715,,,0,0,1,,,,,,
379,378,741,379,378,741,,,0,0,0,,,,,,
380,380,766,380,379,766,,,0,1,0,,,,,,
372,391,111,372,391,111,,,0,0,0,,,,,,
372,391,113,372,391,111,,,0,0,2,,,,,,
372,391,118,372,391,118,,,0,0,0,,,,,,
373,391,128,372,391,129,,,1,0,-1,,,,,,
373,391,141,373,391,141,,,0,0,0,,,,,,
373,391,156,373,391,157,,,0,0,-1,,,,,,
373,391,174,373,391,174,,,0,0,0,,,,,,
373,392,193,373,391,193,,,0,1,0,,,,,,
373,392,213,373,392,213,,,0,0,0,,,,,,
373,392,234,373,392,234,,,0,0,0,,,,,,
374,392,256,374,392,256,,,0,0,0,,,,,,
374,393,278,374,392,278,,,0,1,0,,,,,,
374,393,301,374,393,301,,,0,0,0,,,,,,
375,393,324,374,393,324,,,1,0,0,,,,,,
375,394,347,375,394,347,,,0,0,0,,,,,,
376,394,371,375,394,371,,,1,0,0,,,,,,
376,395,395,376,395,395,,,0,0,0,,,,,,
377,395,419,376,395,419,,,1,0,0,,,,,,
377,396,443,377,396,443,,,0,0,0,,,,,,
378,396,468,377,396,467,,,1,0,1,,,,,,
378,397,492,378,397,492,,,0,0,0,,,,,,
379,398,517,379,397,516,,,0,1,1,,,,,,
380,398,541,380,398,541,,,0,0,0,,,,,,
380,399,566,380,399,566,,,0,0,0,,,,,,
381,400,591,381,400,591,,,0,0,0,,,,,,
382,401,616,382,400,616,,,0,1,0,,,,,,
383,401,641,383,401,641,,,0,0,0,,,,,,
384,402,666,384,402,666,,,0,0,0,,,,,,
385,403,691,385,403,691,,,0,0,0,,,,,,
386,404,716,386,404,716,,,0,0,0,,,,,,
387,405,742,387,405,742,,,0,0,0,,,,,,
388,406,767,388,406,767,,,0,0,0,,,,,,
381,419,118,381,419,118,,,0,0,0,,,,,,
381,419,120,381,419,118,,,0,0,2,,,,,,
381,419,125,381,419,125,,,0,0,0,,,,,,
381,419,134,381,419,135,,,0,0,-1,,,,,,
381,419,146,382,419,146,,,-1,0,0,,,,,,
382,419,161,382,419,162,,,0,0,-1,,,,,,
382,419,178,382,419,178,,,0,0,0,,,,,,
382,420,197,382,419,197,,,0,1,0,,,,,,
382,420,216,382,420,216,,,0,0,0,,,,,,
382,420,237,382,420,237,,,0,0,0,,,,,,
382,420,259,383,420,259,,,-1,0,0,,,,,,
383,420,281,383,420,281,,,0,0,0,,,,,,
383,421,303,383,421,303,,,0,0,0,,,,,,
383,421,326,383,421,326,,,0,0,0,,,,,,
384,422,350,384,422,349,,,0,0,1,,,,,,
384,422,373,384,422,373,,,0,0,0,,,,,,
385,422,397,385,422,397,,,0,0,0,,,,,,
385,423,421,385,423,421,,,0,0,0,,,,,,
386,423,445,386,423,445,,,0,0,0,,,,,,
386,424,469,386,424,469,,,0,0,0,,,,,,
387,424,493,387,424,493,,,0,0,0,,,,,,
388,425,518,387,425,518,,,1,0,0,,,,,,
388,426,543,388,425,542,,,0,1,1,,,,,,
389,426,567,389,426,567,,,0,0,0,,,,,,
390,427,592,390,427,592,,,0,0,0,,,,,,
390,428,617,390,428,617,,,0,0,0,,,,,,
391,429,642,391,428,642,,,0,1,0,,,,,,
392,429,667,392,429,667,,,0,0,0,,,,,,
393,430,692,393,430,692,,,0,0,0,,,,,,
394,431,717,394,431,717,,,0,0,0,,,,,,
395,432,743,395,432,742,,,0,0,1,,,,,,
396,433,768,396,433,767,,,0,0,1,,,,,,
391,447,126,391,447,126,,,0,0,0,,,,,,
391,447,127,391,447,126,,,0,0,1,,,,,,
391,447,132,391,447,132,,,0,0,0,,,,,,
391,447,140,391,447,142,,,0,0,-2,,,,,,
391,447,152,391,447,152,,,0,0,0,,,,,,
391,447,166,391,447,167,,,0,0,-1,,,,,,
391,448,183,391,448,183,,,0,0,0,,,,,,
391,448,201,391,448,201,,,0,0,0,,,,,,
391,448,220,391,448,220,,,0,0,0,,,,,,
391,448,241,391,448,241,,,0,0,0,,,,,,
392,448,262,392,448,262,,,0,0,0,,,,,,
392,449,284,392,448,284,,,0,1,0,,,,,,
392,449,306,392,449,306,,,0,0,0,,,,,,
393,449,329,392,449,329,,,1,0,0,,,,,,
393,450,352,393,450,352,,,0,0,0,,,,,,
393,450,375,393,450,375,,,0,0,0,,,,,,
394,450,399,394,450,399,,,0,0,0,,,,,,
394,451,423,394,450,423,,,0,1,0,,,,,,
395,451,447,395,451,447,,,0,0,0,,,,,,
395,452,471,395,451,471,,,0,1,0,,,,,,
396,452,495,396,452,495,,,0,0,0,,,,,,
397,453,519,396,452,519,,,1,1,0,,,,,,
397,453,544,397,453,544,,,0,0,0,,,,,,
398,454,569,398,454,568,,,0,0,1,,,,,,
399,455,593,399,455,593,,,0,0,0,,,,,,
400,455,618,399,455,618,,,1,0,0,,,,,,
400,456,643,400,456,643,,,0,0,0,,,,,,
401,457,668,401,457,668,,,0,0,0,,,,,,
402,458,693,402,458,693,,,0,0,0,,,,,,
403,459,718,403,458,718,,,0,1,0,,,,,,
404,459,743,404,459,743,,,0,0,0,,,,,,
405,460,769,405,460,768,,,0,0,1,,,,,,
400,476,133,400,475,133,,,0,1,0,,,,,,
400,476,134,400,475,133,,,0,1,1,,,,,,
400,476,138,401,475,138,,,-1,1,0,,,,,,
400,476,146,401,475,148,,,-1,1,-2,,,,,,
400,476,158,401,475,158,,,-1,1,0,,,,,,
401,476,171,401,475,172,,,0,1,-1,,,,,,
401,476,187,401,476,187,,,0,0,0,,,,,,
401,476,205,401,476,205,,,0,0,0,,,,,,
401,476,224,401,476,224,,,0,0,0,,,,,,
401,476,244,401,476,244,,,0,0,0,,,,,,
401,477,265,402,476,265,,,-1,1,0,,,,,,
402,477,287,402,476,287,,,0,1,0,,,,,,
402,477,309,402,477,309,,,0,0,0,,,,,,
402,477,331,402,477,331,,,0,0,0,,,,,,
403,478,354,403,478,354,,,0,0,0,,,,,,
403,478,377,403,478,377,,,0,0,0,,,,,,
404,478,401,404,478,401,,,0,0,0,,,,,,
404,479,424,404,478,424,,,0,1,0,,,,,,
405,479,448,405,479,448,,,0,0,0,,,,,,
405,480,472,405,479,472,,,0,1,0,,,,,,
406,480,497,406,480,496,,,0,0,1,,,,,,
406,481,521,406,480,521,,,0,1,0,,,,,,
407,481,545,407,481,545,,,0,0,0,,,,,,
408,482,570,407,481,570,,,1,1,0,,,,,,
408,483,595,408,482,594,,,0,1,1,,,,,,
409,483,619,409,483,619,,,0,0,0,,,,,,
410,484,644,410,484,644,,,0,0,0,,,,,,
411,485,669,410,484,669,,,1,1,0,,,,,,
412,485,694,411,485,694,,,1,0,0,,,,,,
412,486,719,412,486,719,,,0,0,0,,,,,,
413,487,744,413,487,744,,,0,0,0,,,,,,
414,488,770,414,487,769,,,0,1,1,,,,,,
410,504,140,410,504,140,,,0,0,0,,,,,,
410,504,141,410,504,140,,,0,0,1,,,,,,
411,504,145,411,504,145,,,0,0,0,,,,,,
411,504,153,411,504,154,,,0,0,-1,,,,,,
411,504,164,411,504,164,,,0,0,0,,,,,,
411,504,177,411,504,178,,,0,0,-1,,,,,,
411,504,192,411,504,192,,,0,0,0,,,,,,
411,504,210,411,504,210,,,0,0,0,,,,,,
411,505,228,411,505,228,,,0,0,0,,,,,,
411,505,248,411,505,248,,,0,0,0,,,,,,
412,505,268,412,505,268,,,0,0,0,,,,,,
412,505,290,412,505,290,,,0,0,0,,,,,,
412,505,312,412,505,312,,,0,0,0,,,,,,
413,506,334,412,505,334,,,1,1,0,,,,,,
413,506,357,413,506,357,,,0,0,0,,,,,,
413,506,380,413,506,380,,,0,0,0,,,,,,
414,507,403,414,507,403,,,0,0,0,,,,,,
414,507,426,414,507,426,,,0,0,0,,,,,,
415,507,450,415,507,450,,,0,0,0,,,,,,
415,508,474,415,507,474,,,0,1,0,,,,,,
416,508,498,416,508,498,,,0,0,0,,,,,,
416,509,523,416,508,522,,,0,1,1,,,,,,
417,509,547,417,509,547,,,0,0,0,,,,,,
418,510,571,417,509,571,,,1,1,0,,,,,,
418,510,596,418,510,596,,,0,0,0,,,,,,
419,511,621,419,511,621,,,0,0,0,,,,,,
420,512,646,420,512,646,,,0,0,0,,,,,,
421,512,670,420,512,670,,,1,0,0,,,,,,
421,513,695,421,513,695,,,0,0,0,,,,,,
422,514,720,422,514,720,,,0,0,0,,,,,,
423,515,746,423,515,746,,,0,0,0,,,,,,
424,515,771,424,515,771,,,0,0,0,,,,,,
421,532,147,421,532,147,,,0,0,0,,,,,,
421,532,148,421,532,147,,,0,0,1,,,,,,
421,532,152,421,532,152,,,0,0,0,,,,,,
421,533,160,421,532,161,,,0,1,-1,,,,,,
421,533,170,421,532,170,,,0,1,0,,,,,,
421,533,183,421,532,183,,,0,1,0,,,,,,
421,533,198,421,532,197,,,0,1,1,,,,,,
422,533,214,421,533,215,,,1,0,-1,,,,,,
422,533,232,422,533,232,,,0,0,0,,,,,,
422,533,252,422,533,252,,,0,0,0,,,,,,
422,533,272,422,533,272,,,0,0,0,,,,,,
422,534,293,422,533,293,,,0,1,0,,,,,,
423,534,315,423,533,315,,,0,1,0,,,,,,
423,534,337,423,534,337,,,0,0,0,,,,,,
423,534,359,423,534,359,,,0,0,0,,,,,,
424,535,382,424,534,382,,,0,1,0,,,,,,
424,535,405,424,535,405,,,0,0,0,,,,,,
425,535,429,425,535,428,,,0,0,1,,,,,,
425,536,452,425,535,452,,,0,1,0,,,,,,
426,536,476,426,536,476,,,0,0,0,,,,,,
426,537,500,426,536,500,,,0,1,0,,,,,,
427,537,524,427,537,524,,,0,0,0,,,,,,
427,538,549,427,537,548,,,0,1,1,,,,,,
428,538,573,428,538,573,,,0,0,0,,,,,,
429,539,598,428,538,597,,,1,1,1,,,,,,
429,539,622,429,539,622,,,0,0,0,,,,,,
430,540,647,430,540,647,,,0,0,0,,,,,,
431,540,672,431,540,671,,,0,0,1,,,,,,
432,541,697,431,541,696,,,1,0,1,,,,,,
433,542,722,432,542,721,,,1,0,1,,,,,,
433,543,747,433,543,747,,,0,0,0,,,,,,
434,543,772,434,543,772,,,0,0,0,,,,,,
432,561,155,432,561,155,,,0,0,0,,,,,,
432,561,156,432,561,155,,,0,0,1,,,,,,
432,561,160,432,561,160,,,0,0,0,,,,,,
432,561,166,432,561,168,,,0,0,-2,,,,,,
432,561,176,432,561,176,,,0,0,0,,,,,,
432,561,188,432,561,189,,,0,0,-1,,,,,,
432,561,203,432,561,203,,,0,0,0,,,,,,
433,561,219,432,561,220,,,1,0,-1,,,,,,
433,562,237,433,562,237,,,0,0,0,,,,,,
433,562,256,433,562,256,,,0,0,0,,,,,,
433,562,276,433,562,276,,,0,0,0,,,,,,
433,562,297,433,562,297,,,0,0,0,,,,,,
434,562,318,434,562,318,,,0,0,0,,,,,,
434,563,340,434,562,340,,,0,1,0,,,,,,
434,563,362,434,563,362,,,0,0,0,,,,,,
435,563,385,434,563,385,,,1,0,0,,,,,,
435,563,408,435,563,408,,,0,0,0,,,,,,
435,564,431,435,563,431,,,0,1,0,,,,,,
436,564,454,436,564,454,,,0,0,0,,,,,,
436,565,478,436,564,478,,,0,1,0,,,,,,
437,565,502,437,565,502,,,0,0,0,,,,,,
438,565,526,437,565,526,,,1,0,0,,,,,,
438,566,550,438,566,550,,,0,0,0,,,,,,
439,566,575,438,566,574,,,1,0,1,,,,,,
439,567,599,439,567,599,,,0,0,0,,,,,,
440,567,624,440,567,623,,,0,0,1,,,,,,
441,568,648,441,568,648,,,0,0,0,,,,,,
442,569,673,441,568,673,,,1,1,0,,,,,,
442,569,698,442,569,698,,,0,0,0,,,,,,
443,570,723,443,570,723,,,0,0,0,,,,,,
444,571,748,444,571,748,,,0,0,0,,,,,,
445,571,773,445,571,773,,,0,0,0,,,,,,
443,590,162,443,590,162,,,0,0,0,,,,,,
443,590,163,443,590,162,,,0,0,1,,,,,,
443,590,167,443,590,167,,,0,0,0,,,,,,
443,590,173,443,590,174,,,0,0,-1,,,,,,
443,590,183,443,590,182,,,0,0,1,,,,,,
444,590,194,443,590,195,,,1,0,-1,,,,,,
444,590,208,443,590,208,,,1,0,0,,,,,,
444,590,224,444,590,225,,,0,0,-1,,,,,,
444,590,242,444,590,242,,,0,0,0,,,,,,
444,590,260,444,590,261,,,0,0,-1,,,,,,
444,591,280,444,590,280,,,0,1,0,,,,,,
445,591,300,444,590,300,,,1,1,0,,,,,,
445,591,321,445,591,321,,,0,0,0,,,,,,
445,591,343,445,591,343,,,0,0,0,,,,,,
446,591,365,445,591,365,,,1,0,0,,,,,,
446,592,387,446,591,387,,,0,1,0,,,,,,
446,592,410,446,592,410,,,0,0,0,,,,,,
447,592,433,447,592,433,,,0,0,0,,,,,,
447,593,457,447,592,456,,,0,1,1,,,,,,
448,593,480,448,593,480,,,0,0,0,,,,,,
448,593,504,448,593,504,,,0,0,0,,,,,,
449,594,528,449,594,528,,,0,0,0,,,,,,
449,594,552,449,594,552,,,0,0,0,,,,,,
450,595,576,450,595,576,,,0,0,0,,,,,,
450,595,601,450,595,601,,,0,0,0,,,,,,
451,596,625,451,596,625,,,0,0,0,,,,,,
452,596,650,452,596,650,,,0,0,0,,,,,,
453,597,675,452,597,674,,,1,0,1,,,,,,
453,598,699,453,597,699,,,0,1,0,,,,,,
454,598,724,454,598,724,,,0,0,0,,,,,,
455,599,749,455,599,749,,,0,0,0,,,,,,
456,599,774,456,599,774,,,0,0,0,,,,,,
455,619,170,455,619,170,,,0,0,0,,,,,,
455,619,170,455,619,170,,,0,0,0,,,,,,
455,619,174,455,619,174,,,0,0,0,,,,,,
455,619,180,455,619,181,,,0,0,-1,,,,,,
455,619,189,455,619,189,,,0,0,0,,,,,,
455,619,201,455,619,201,,,0,0,0,,,,,,
455,619,214,455,619,214,,,0,0,0,,,,,,
455,619,230,455,619,230,,,0,0,0,,,,,,
456,619,247,456,619,247,,,0,0,0,,,,,,
456,619,265,456,619,265,,,0,0,0,,,,,,
456,619,284,456,619,284,,,0,0,0,,,,,,
456,620,304,456,619,304,,,0,1,0,,,,,,
456,620,325,456,620,325,,,0,0,0,,,,,,
457,620,346,456,620,346,,,1,0,0,,,,,,
457,620,368,457,620,368,,,0,0,0,,,,,,
457,620,390,457,620,390,,,0,0,0,,,,,,
458,621,413,458,621,413,,,0,0,0,,,,,,
458,621,436,458,621,436,,,0,0,0,,,,,,
459,621,459,459,621,459,,,0,0,0,,,,,,
459,622,483,459,621,482,,,0,1,1,,,,,,
460,622,506,460,622,506,,,0,0,0,,,,,,
460,623,530,460,622,530,,,0,1,0,,,,,,
461,623,554,461,623,554,,,0,0,0,,,,,,
461,623,578,461,623,578,,,0,0,0,,,,,,
462,624,603,462,624,603,,,0,0,0,,,,,,
463,624,627,462,624,627,,,1,0,0,,,,,,
463,625,652,463,625,652,,,0,0,0,,,,,,
464,625,676,464,625,676,,,0,0,0,,,,,,
465,626,701,465,626,701,,,0,0,0,,,,,,
465,627,726,465,626,726,,,0,1,0,,,,,,
466,627,751,466,627,751,,,0,0,0,,,,,,
467,628,776,467,627,776,,,0,1,0,,,,,,
467,647,177,467,647,177,,,0,0,0,,,,,,
467,647,178,467,647,177,,,0,0,1,,,,,,
467,647,181,467,647,181,,,0,0,0,,,,,,
467,648,187,467,647,188,,,0,1,-1,,,,,,
467,648,196,467,648,196,,,0,0,0,,,,,,
467,648,207,467,648,208,,,0,0,-1,,,,,,
467,648,220,467,648,220,,,0,0,0,,,,,,
467,648,235,467,648,236,,,0,0,-1,,,,,,
467,648,252,468,648,252,,,-1,0,0,,,,,,
468,648,269,468,648,270,,,0,0,-1,,,,,,
468,648,288,468,648,288,,,0,0,0,,,,,,
468,648,308,468,648,308,,,0,0,0,,,,,,
468,649,328,468,648,328,,,0,1,0,,,,,,
469,649,350,468,648,350,,,1,1,0,,,,,,
469,649,371,469,649,371,,,0,0,0,,,,,,
469,649,393,469,649,393,,,0,0,0,,,,,,
470,650,416,470,649,416,,,0,1,0,,,,,,
470,650,439,470,649,438,,,0,1,1,,,,,,
470,650,462,471,650,461,,,-1,0,1,,,,,,
471,650,485,471,650,485,,,0,0,0,,,,,,
471,651,509,472,651,508,,,-1,0,1,,,,,,
472,651,532,472,651,532,,,0,0,0,,,,,,
472,652,556,473,651,556,,,-1,1,0,,,,,,
473,652,580,473,652,580,,,0,0,0,,,,,,
474,652,604,474,652,604,,,0,0,0,,,,,,
474,653,629,474,653,629,,,0,0,0,,,,,,
475,653,653,475,653,653,,,0,0,0,,,,,,
476,654,678,475,654,678,,,1,0,0,,,,,,
476,654,703,476,654,702,,,0,0,1,,,,,,
477,655,727,477,655,727,,,0,0,0,,,,,,
478,656,752,478,655,752,,,0,1,0,,,,,,
479,656,777,478,656,777,,,1,0,0,,,,,,
479,676,185,479,676,185,,,0,0,0,,,,,,
479,676,185,479,676,185,,,0,0,0,,,,,,
479,676,189,479,676,189,,,0,0,0,,,,,,
479,676,194,479,676,196,,,0,0,-2,,,,,,
479,677,203,479,677,203,,,0,0,0,,,,,,
479,677,213,479,677,214,,,0,0,-1,,,,,,
479,677,226,479,677,226,,,0,0,0,,,,,,
480,677,241,479,677,241,,,1,0,0,,,,,,
480,677,257,480,677,257,,,0,0,0,,,,,,
480,677,274,480,677,275,,,0,0,-1,,,,,,
480,677,293,480,677,293,,,0,0,0,,,,,,
480,677,312,480,677,312,,,0,0,0,,,,,,
481,677,332,481,677,332,,,0,0,0,,,,,,
481,678,353,481,677,353,,,0,1,0,,,,,,
481,678,375,481,678,375,,,0,0,0,,,,,,
481,678,396,481,678,397,,,0,0,-1,,,,,,
482,678,419,482,678,419,,,0,0,0,,,,,,
482,679,441,482,678,441,,,0,1,0,,,,,,
483,679,464,483,679,464,,,0,0,0,,,,,,
483,679,487,483,679,487,,,0,0,0,,,,,,
484,680,511,484,680,511,,,0,0,0,,,,,,
484,680,535,484,680,534,,,0,0,1,,,,,,
485,680,558,485,680,558,,,0,0,0,,,,,,
485,681,582,485,680,582,,,0,1,0,,,,,,
486,681,606,486,681,606,,,0,0,0,,,,,,
486,682,631,486,681,630,,,0,1,1,,,,,,
487,682,655,487,682,655,,,0,0,0,,,,,,
488,683,680,487,682,679,,,1,1,1,,,,,,
488,683,704,488,683,704,,,0,0,0,,,,,,
489,684,729,489,683,729,,,0,1,0,,,,,,
490,684,754,490,684,754,,,0,0,0,,,,,,
491,685,779,490,684,778,,,1,1,1,,,,,,
492,705,192,491,705,192,,,1,0,0,,,,,,
492,705,193,491,705,192,,,1,0,1,,,,,,
492,705,196,491,705,196,,,1,0,0,,,,,,
492,705,202,491,705,202,,,1,0,0,,,,,,
492,706,209,491,706,209,,,1,0,0,,,,,,
492,706,220,491,706,220,,,1,0,0,,,,,,
492,706,232,492,706,232,,,0,0,0,,,,,,
492,706,246,492,706,247,,,0,0,-1,,,,,,
492,706,262,492,706,262,,,0,0,0,,,,,,
492,706,279,492,706,279,,,0,0,0,,,,,,
493,706,297,492,706,297,,,1,0,0,,,,,,
493,706,316,493,706,316,,,0,0,0,,,,,,
493,706,336,493,706,336,,,0,0,0,,,,,,
493,707,357,493,706,357,,,0,1,0,,,,,,
494,707,378,493,707,378,,,1,0,0,,,,,,
494,707,400,494,707,400,,,0,0,0,,,,,,
494,707,422,494,707,422,,,0,0,0,,,,,,
495,708,444,495,707,444,,,0,1,0,,,,,,
495,708,467,495,708,467,,,0,0,0,,,,,,
495,708,490,495,708,490,,,0,0,0,,,,,,
496,708,513,496,708,513,,,0,0,0,,,,,,
496,709,537,496,708,537,,,0,1,0,,,,,,
497,709,561,497,709,560,,,0,0,1,,,,,,
497,710,584,497,709,584,,,0,1,0,,,,,,
498,710,608,498,710,608,,,0,0,0,,,,,,
499,710,633,499,710,632,,,0,0,1,,,,,,
499,711,657,499,711,657,,,0,0,0,,,,,,
500,711,681,500,711,681,,,0,0,0,,,,,,
501,712,706,500,712,706,,,1,0,0,,,,,,
501,712,731,501,712,730,,,0,0,1,,,,,,
502,713,755,502,713,755,,,0,0,0,,,,,,
503,713,780,502,713,780,,,1,0,0,,,,,,
504,735,200,504,735,200,,,0,0,0,,,,,,
504,735,201,504,735,200,,,0,0,1,,,,,,
504,735,203,504,735,203,,,0,0,0,,,,,,
504,735,209,504,735,209,,,0,0,0,,,,,,
504,735,216,504,735,216,,,0,0,0,,,,,,
505,735,226,504,735,227,,,1,0,-1,,,,,,
505,735,238,505,735,238,,,0,0,0,,,,,,
505,735,252,505,735,252,,,0,0,0,,,,,,
505,735,267,505,735,267,,,0,0,0,,,,,,
505,735,284,505,735,284,,,0,0,0,,,,,,
505,735,302,505,735,302,,,0,0,0,,,,,,
505,735,321,505,735,321,,,0,0,0,,,,,,
506,735,340,506,735,340,,,0,0,0,,,,,,
506,736,361,506,735,361,,,0,1,0,,,,,,
506,736,382,506,736,382,,,0,0,0,,,,,,
507,736,403,506,736,403,,,1,0,0,,,,,,
507,736,425,507,736,425,,,0,0,0,,,,,,
507,737,447,507,736,447,,,0,1,0,,,,,,
508,737,470,508,737,470,,,0,0,0,,,,,,
508,737,493,508,737,493,,,0,0,0,,,,,,
508,737,516,508,737,516,,,0,0,0,,,,,,
509,738,539,508,737,539,,,1,1,0,,,,,,
509,738,563,509,738,563,,,0,0,0,,,,,,
510,738,587,510,738,587,,,0,0,0,,,,,,
511,739,611,511,739,611,,,0,0,0,,,,,,
511,739,635,511,739,635,,,0,0,0,,,,,,
512,740,659,512,740,659,,,0,0,0,,,,,,
512,740,683,512,740,683,,,0,0,0,,,,,,
513,741,708,513,741,708,,,0,0,0,,,,,,
514,741,732,513,741,732,,,1,0,0,,,,,,
514,742,757,514,742,757,,,0,0,0,,,,,,
515,742,782,515,742,782,,,0,0,0,,,,,,
517,764,207,517,764,207,,,0,0,0,,,,,,
517,764,208,517,764,207,,,0,0,1,,,,,,
517,764,211,517,764,210,,,0,0,1,,,,,,
517,764,216,517,764,216,,,0,0,0,,,,,,
517,764,223,517,764,223,,,0,0,0,,,,,,
517,764,233,517,764,233,,,0,0,0,,,,,,
518,764,245,518,764,244,,,0,0,1,,,,,,
518,764,258,518,764,258,,,0,0,0,,,,,,
518,764,273,518,764,273,,,0,0,0,,,,,,
518,764,289,518,764,290,,,0,0,-1,,,,,,
518,764,307,518,764,307,,,0,0,0,,,,,,
518,764,325,518,764,325,,,0,0,0,,,,,,
519,765,345,519,764,344,,,0,1,1,,,,,,
519,765,365,519,764,365,,,0,1,0,,,,,,
519,765,386,519,765,385,,,0,0,1,,,,,,
519,765,407,519,765,407,,,0,0,0,,,,,,
520,765,428,520,765,428,,,0,0,0,,,,,,
520,766,451,520,765,450,,,0,1,1,,,,,,
520,766,473,521,766,473,,,-1,0,0,,,,,,
521,766,496,521,766,495,,,0,0,1,,,,,,
521,766,519,521,766,518,,,0,0,1,,,,,,
522,767,542,521,766,542,,,1,1,0,,,,,,
522,767,565,522,767,565,,,0,0,0,,,,,,
523,767,589,522,767,589,,,1,0,0,,,,,,
523,768,613,523,768,613,,,0,0,0,,,,,,
524,768,637,524,768,637,,,0,0,0,,,,,,
524,769,661,524,769,661,,,0,0,0,,,,,,
525,769,685,525,769,685,,,0,0,0,,,,,,
526,769,710,526,769,710,,,0,0,0,,,,,,
526,770,734,526,770,734,,,0,0,0,,,,,,
527,770,759,527,770,759,,,0,0,0,,,,,,
528,771,783,527,771,783,,,1,0,0,,,,,,
530,793,215,530,793,215,,,0,0,0,,,,,,
530,793,216,530,793,215,,,0,0,1,,,,,,
530,793,218,530,793,218,,,0,0,0,,,,,,
531,793,223,530,793,224,,,1,0,-1,,,,,,
531,793,230,531,793,230,,,0,0,0,,,,,,
531,793,240,531,793,240,,,0,0,0,,,,,,
531,793,251,531,793,251,,,0,0,0,,,,,,
531,793,264,531,793,265,,,0,0,-1,,,,,,
531,793,279,531,793,279,,,0,0,0,,,,,,
531,793,295,531,793,295,,,0,0,0,,,,,,
531,793,312,531,793,312,,,0,0,0,,,,,,
532,794,330,531,793,330,,,1,1,0,,,,,,
532,794,349,532,794,349,,,0,0,0,,,,,,
532,794,369,532,794,369,,,0,0,0,,,,,,
532,794,389,532,794,389,,,0,0,0,,,,,,
533,794,410,532,794,410,,,1,0,0,,,,,,
533,794,432,533,794,432,,,0,0,0,,,,,,
533,795,454,533,794,454,,,0,1,0,,,,,,
534,795,476,534,795,476,,,0,0,0,,,,,,
534,795,499,534,795,498,,,0,0,1,,,,,,
534,796,521,534,796,521,,,0,0,0,,,,,,
535,796,545,534,796,544,,,1,0,1,,,,,,
535,796,568,535,796,568,,,0,0,0,,,,,,
536,796,591,535,796,591,,,1,0,0,,,,,,
536,797,615,536,797,615,,,0,0,0,,,,,,
537,797,639,536,797,639,,,1,0,0,,,,,,
537,798,663,537,798,663,,,0,0,0,,,,,,
538,798,687,538,798,687,,,0,0,0,,,,,,
539,798,712,539,798,712,,,0,0,0,,,,,,
539,799,736,539,798,736,,,0,1,0,,,,,,
540,799,761,540,799,761,,,0,0,0,,,,,,
541,800,785,540,799,785,,,1,1,0,,,,,,
544,822,223,543,822,222,,,1,0,1,,,,,,
544,822,223,543,822,222,,,1,0,1,,,,,,
544,822,226,543,822,226,,,1,0,0,,,,,,
544,822,231,543,822,231,,,1,0,0,,,,,,
544,822,238,544,822,237,,,0,0,1,,,,,,
544,822,247,544,822,247,,,0,0,0,,,,,,
544,822,258,544,822,257,,,0,0,1,,,,,,
544,822,270,544,822,271,,,0,0,-1,,,,,,
544,822,285,544,822,284,,,0,0,1,,,,,,
544,823,300,544,822,300,,,0,1,0,,,,,,
545,823,317,544,822,317,,,1,1,0,,,,,,
545,823,335,545,822,335,,,0,1,0,,,,,,
545,823,354,545,823,353,,,0,0,1,,,,,,
545,823,373,545,823,373,,,0,0,0,,,,,,
546,823,393,545,823,393,,,1,0,0,,,,,,
546,823,414,546,823,414,,,0,0,0,,,,,,
546,824,435,546,823,435,,,0,1,0,,,,,,
547,824,457,546,823,457,,,1,1,0,,,,,,
547,824,479,547,824,479,,,0,0,0,,,,,,
547,824,502,547,824,501,,,0,0,1,,,,,,
548,825,524,547,825,524,,,1,0,0,,,,,,
548,825,547,548,825,547,,,0,0,0,,,,,,
549,825,571,548,825,570,,,1,0,1,,,,,,
549,826,594,549,825,594,,,0,1,0,,,,,,
550,826,618,549,826,617,,,1,0,1,,,,,,
550,826,641,550,826,641,,,0,0,0,,,,,,
551,827,665,550,827,665,,,1,0,0,,,,,,
551,827,689,551,827,689,,,0,0,0,,,,,,
552,827,714,552,827,714,,,0,0,0,,,,,,
552,828,738,552,827,738,,,0,1,0,,,,,,
553,828,763,553,828,762,,,0,0,1,,,,,,
554,829,787,553,828,787,,,1,1,0,,,,,,
557,851,230,557,851,230,,,0,0,0,,,,,,
557,851,231,557,851,230,,,0,0,1,,,,,,
557,851,234,557,851,234,,,0,0,0,,,,,,
557,851,238,557,851,239,,,0,0,-1,,,,,,
557,851,245,557,851,245,,,0,0,0,,,,,,
558,852,254,557,851,254,,,1,1,0,,,,,,
558,852,264,558,852,264,,,0,0,0,,,,,,
558,852,276,558,852,277,,,0,0,-1,,,,,,
558,852,290,558,852,290,,,0,0,0,,,,,,
558,852,306,558,852,306,,,0,0,0,,,,,,
558,852,322,558,852,322,,,0,0,0,,,,,,
558,852,340,558,852,340,,,0,0,0,,,,,,
559,852,358,559,852,358,,,0,0,0,,,,,,
559,852,378,559,852,378,,,0,0,0,,,,,,
559,853,398,559,853,398,,,0,0,0,,,,,,
559,853,418,559,853,418,,,0,0,0,,,,,,
560,853,439,560,853,439,,,0,0,0,,,,,,
560,853,461,560,853,461,,,0,0,0,,,,,,
560,853,483,560,853,483,,,0,0,0,,,,,,
561,854,505,560,853,505,,,1,1,0,,,,,,
561,854,527,561,854,527,,,0,0,0,,,,,,
562,854,550,561,854,550,,,1,0,0,,,,,,
562,854,573,562,854,573,,,0,0,0,,,,,,
562,855,597,562,854,596,,,0,1,1,,,,,,
563,855,620,563,855,620,,,0,0,0,,,,,,
563,855,644,563,855,644,,,0,0,0,,,,,,
564,856,668,564,856,668,,,0,0,0,,,,,,
565,856,692,564,856,692,,,1,0,0,,,,,,
565,857,716,565,857,716,,,0,0,0,,,,,,
566,857,740,565,857,740,,,1,0,0,,,,,,
566,857,764,566,857,764,,,0,0,0,,,,,,
567,858,789,567,857,789,,,0,1,0,,,,,,
571,881,238,571,880,238,,,0,1,0,,,,,,
571,881,239,571,880,238,,,0,1,1,,,,,,
571,881,241,571,880,241,,,0,1,0,,,,,,
571,881,246,571,880,246,,,0,1,0,,,,,,
571,881,252,571,880,252,,,0,1,0,,,,,,
571,881,260,571,880,261,,,0,1,-1,,,,,,
571,881,271,571,881,271,,,0,0,0,,,,,,
571,881,283,571,881,283,,,0,0,0,,,,,,
572,881,296,571,881,296,,,1,0,0,,,,,,
572,881,311,571,881,312,,,1,0,-1,,,,,,
572,881,328,572,881,327,,,0,0,1,,,,,,
572,881,345,572,881,345,,,0,0,0,,,,,,
572,882,363,572,881,363,,,0,1,0,,,,,,
573,882,382,572,881,382,,,1,1,0,,,,,,
573,882,402,573,882,402,,,0,0,0,,,,,,
573,882,422,573,882,422,,,0,0,0,,,,,,
573,882,443,573,882,443,,,0,0,0,,,,,,
574,882,464,573,882,464,,,1,0,0,,,,,,
574,883,486,574,882,486,,,0,1,0,,,,,,
574,883,508,574,882,508,,,0,1,0,,,,,,
575,883,531,575,883,530,,,0,0,1,,,,,,
575,883,553,575,883,553,,,0,0,0,,,,,,
576,884,576,575,883,576,,,1,1,0,,,,,,
576,884,599,576,884,599,,,0,0,0,,,,,,
577,884,623,576,884,622,,,1,0,1,,,,,,
577,885,646,577,884,646,,,0,1,0,,,,,,
578,885,670,577,885,670,,,1,0,0,,,,,,
578,885,694,578,885,694,,,0,0,0,,,,,,
579,886,718,578,886,718,,,1,0,0,,,,,,
579,886,742,579,886,742,,,0,0,0,,,,,,
580,887,767,580,886,766,,,0,1,1,,,,,,
581,887,791,580,887,791,,,1,0,0,,,,,,
340,94,52,340,94,51,,,0,0,1,,,,,,
340,94,55,340,94,51,,,0,0,4,,,,,,
340,94,66,340,94,66,,,0,0,0,,,,,,
340,94,82,340,94,84,,,0,0,-2,,,,,,
340,95,102,340,94,102,,,0,1,0,,,,,,
340,95,123,340,95,123,,,0,0,0,,,,,,
341,96,145,340,96,145,,,1,0,0,,,,,,
341,97,168,340,97,168,,,1,0,0,,,,,,
341,98,191,341,98,191,,,0,0,0,,,,,,
341,99,215,341,99,214,,,0,0,1,,,,,,
341,100,238,341,100,238,,,0,0,0,,,,,,
342,101,262,341,101,262,,,1,0,0,,,,,,
342,103,287,342,103,286,,,0,0,1,,,,,,
343,105,311,342,104,311,,,1,1,0,,,,,,
343,106,335,343,106,335,,,0,0,0,,,,,,
343,108,360,343,108,360,,,0,0,0,,,,,,
344,110,385,344,110,384,,,0,0,1,,,,,,
345,112,409,344,112,409,,,1,0,0,,,,,,
345,114,434,345,114,434,,,0,0,0,,,,,,
346,117,459,345,116,459,,,1,1,0,,,,,,
346,119,484,346,119,484,,,0,0,0,,,,,,
347,122,509,347,121,509,,,0,1,0,,,,,,
348,124,534,348,124,534,,,0,0,0,,,,,,
349,127,559,348,127,559,,,1,0,0,,,,,,
350,129,584,349,129,584,,,1,0,0,,,,,,
351,132,610,350,132,609,,,1,0,1,,,,,,
351,135,635,351,135,635,,,0,0,0,,,,,,
352,138,660,352,138,660,,,0,0,0,,,,,,
353,141,686,353,141,685,,,0,0,1,,,,,,
354,144,711,354,144,711,,,0,0,0,,,,,,
356,147,736,356,147,736,,,0,0,0,,,,,,
357,150,762,357,150,762,,,0,0,0,,,,,,
340,96,52,340,94,51,,,0,2,1,,,,,,
340,96,55,340,94,51,,,0,2,4,,,,,,
340,97,66,340,94,66,,,0,3,0,,,,,,
340,97,83,340,94,84,,,0,3,-1,,,,,,
340,97,102,340,94,102,,,0,3,0,,,,,,
341,98,123,340,95,123,,,1,3,0,,,,,,
341,98,145,340,96,145,,,1,2,0,,,,,,
341,99,168,340,97,168,,,1,2,0,,,,,,
341,100,191,341,98,191,,,0,2,0,,,,,,
341,101,215,341,99,214,,,0,2,1,,,,,,
342,102,238,341,100,238,,,1,2,0,,,,,,
342,104,262,341,101,262,,,1,3,0,,,,,,
342,105,287,342,103,286,,,0,2,1,,,,,,
343,107,311,342,104,311,,,1,3,0,,,,,,
343,108,335,343,106,335,,,0,2,0,,,,,,
344,110,360,343,108,360,,,1,2,0,,,,,,
344,112,385,344,110,384,,,0,2,1,,,,,,
345,114,409,344,112,409,,,1,2,0,,,,,,
345,116,434,345,114,434,,,0,2,0,,,,,,
346,119,459,345,116,459,,,1,3,0,,,,,,
347,121,484,346,119,484,,,1,2,0,,,,,,
347,123,509,347,121,509,,,0,2,0,,,,,,
348,126,534,348,124,534,,,0,2,0,,,,,,
349,128,559,348,127,559,,,1,1,0,,,,,,
350,131,584,349,129,584,,,1,2,0,,,,,,
351,134,610,350,132,609,,,1,2,1,,,,,,
352,137,635,351,135,635,,,1,2,0,,,,,,
353,140,660,352,138,660,,,1,2,0,,,,,,
354,143,686,353,141,685,,,1,2,1,,,,,,
355,146,711,354,144,711,,,1,2,0,,,,,,
356,149,736,356,147,736,,,0,2,0,,,,,,
357,152,762,357,150,762,,,0,2,0,,,,,,
341,105,53,341,105,53,,,0,0,0,,,,,,
341,105,56,341,105,53,,,0,0,3,,,,,,
341,105,67,341,105,67,,,0,0,0,,,,,,
341,105,83,341,105,85,,,0,0,-2,,,,,,
341,106,103,341,105,103,,,0,1,0,,,,,,
341,106,124,341,106,124,,,0,0,0,,,,,,
341,107,146,341,106,145,,,0,1,1,,,,,,
341,107,168,341,107,168,,,0,0,0,,,,,,
342,108,191,342,108,191,,,0,0,0,,,,,,
342,109,215,342,109,214,,,0,0,1,,,,,,
342,110,239,342,110,238,,,0,0,1,,,,,,
343,112,263,342,111,262,,,1,1,1,,,,,,
343,113,287,343,113,286,,,0,0,1,,,,,,
343,114,311,343,114,311,,,0,0,0,,,,,,
344,116,335,344,116,335,,,0,0,0,,,,,,
344,118,360,344,117,360,,,0,1,0,,,,,,
345,119,385,345,119,384,,,0,0,1,,,,,,
345,121,409,345,121,409,,,0,0,0,,,,,,
346,123,434,346,123,434,,,0,0,0,,,,,,
347,125,459,346,125,459,,,1,0,0,,,,,,
347,128,484,347,127,484,,,0,1,0,,,,,,
348,130,509,348,130,509,,,0,0,0,,,,,,
349,132,534,348,132,534,,,1,0,0,,,,,,
350,135,559,349,135,559,,,1,0,0,,,,,,
350,137,584,350,137,584,,,0,0,0,,,,,,
351,140,610,351,140,609,,,0,0,1,,,,,,
352,143,635,352,143,635,,,0,0,0,,,,,,
353,145,660,353,145,660,,,0,0,0,,,,,,
354,148,686,354,148,685,,,0,0,1,,,,,,
355,151,711,355,151,711,,,0,0,0,,,,,,
356,154,737,356,154,736,,,0,0,1,,,,,,
357,157,762,357,157,762,,,0,0,0,,,,,,
342,119,55,342,121,55,,,0,-2,0,,,,,,
342,119,58,342,121,55,,,0,-2,3,,,,,,
342,119,69,342,121,69,,,0,-2,0,,,,,,
342,119,85,342,121,86,,,0,-2,-1,,,,,,
342,120,104,342,121,104,,,0,-1,0,,,,,,
342,120,124,342,122,125,,,0,-2,-1,,,,,,
342,121,146,342,122,146,,,0,-1,0,,,,,,
343,121,169,343,123,169,,,0,-2,0,,,,,,
343,122,192,343,124,192,,,0,-2,0,,,,,,
343,123,215,343,125,215,,,0,-2,0,,,,,,
343,124,239,343,126,239,,,0,-2,0,,,,,,
344,125,263,344,127,263,,,0,-2,0,,,,,,
344,126,287,344,128,287,,,0,-2,0,,,,,,
345,127,311,344,129,311,,,1,-2,0,,,,,,
345,129,336,345,130,336,,,0,-1,0,,,,,,
345,130,360,345,132,360,,,0,-2,0,,,,,,
346,132,385,346,134,385,,,0,-2,0,,,,,,
347,134,410,346,135,409,,,1,-1,1,,,,,,
347,135,434,347,137,434,,,0,-2,0,,,,,,
348,137,459,348,139,459,,,0,-2,0,,,,,,
348,139,484,349,141,484,,,-1,-2,0,,,,,,
349,141,509,349,143,509,,,0,-2,0,,,,,,
350,144,534,350,145,534,,,0,-1,0,,,,,,
351,146,559,351,148,559,,,0,-2,0,,,,,,
352,148,585,352,150,584,,,0,-2,1,,,,,,
352,151,610,352,152,610,,,0,-1,0,,,,,,
353,153,635,353,155,635,,,0,-2,0,,,,,,
354,156,660,354,157,660,,,0,-1,0,,,,,,
355,158,686,355,160,685,,,0,-2,1,,,,,,
356,161,711,356,163,711,,,0,-2,0,,,,,,
357,164,737,358,165,736,,,-1,-1,1,,,,,,
359,166,762,359,168,762,,,0,-2,0,,,,,,
344,137,58,344,137,57,,,0,0,1,,,,,,
344,137,61,344,137,57,,,0,0,4,,,,,,
344,137,71,344,137,71,,,0,0,0,,,,,,
344,138,86,344,137,88,,,0,1,-2,,,,,,
344,138,105,344,138,105,,,0,0,0,,,,,,
344,138,125,344,138,126,,,0,0,-1,,,,,,
344,139,147,344,139,147,,,0,0,0,,,,,,
344,139,170,344,139,170,,,0,0,0,,,,,,
345,140,193,345,140,193,,,0,0,0,,,,,,
345,140,216,345,140,216,,,0,0,0,,,,,,
345,141,240,345,141,239,,,0,0,1,,,,,,
346,142,263,345,142,263,,,1,0,0,,,,,,
346,143,288,346,143,287,,,0,0,1,,,,,,
346,144,312,346,144,312,,,0,0,0,,,,,,
347,146,336,346,145,336,,,1,1,0,,,,,,
347,147,361,347,147,361,,,0,0,0,,,,,,
348,148,385,347,148,385,,,1,0,0,,,,,,
348,150,410,348,150,410,,,0,0,0,,,,,,
349,151,435,348,151,434,,,1,0,1,,,,,,
349,153,460,349,153,459,,,0,0,1,,,,,,
350,155,484,350,155,484,,,0,0,0,,,,,,
351,157,509,351,157,509,,,0,0,0,,,,,,
352,159,535,351,159,534,,,1,0,1,,,,,,
352,161,560,352,161,559,,,0,0,1,,,,,,
353,163,585,353,163,585,,,0,0,0,,,,,,
354,165,610,354,165,610,,,0,0,0,,,,,,
355,167,635,355,167,635,,,0,0,0,,,,,,
356,170,661,356,169,660,,,0,1,1,,,,,,
357,172,686,357,172,686,,,0,0,0,,,,,,
358,174,711,358,174,711,,,0,0,0,,,,,,
359,177,737,359,177,737,,,0,0,0,,,,,,
360,179,762,360,179,762,,,0,0,0,,,,,,
346,158,61,346,159,61,,,0,-1,0,,,,,,
346,158,64,346,159,61,,,0,-1,3,,,,,,
346,158,74,346,159,74,,,0,-1,0,,,,,,
346,159,89,346,159,90,,,0,0,-1,,,,,,
346,159,107,346,159,107,,,0,0,0,,,,,,
346,159,127,346,160,127,,,0,-1,0,,,,,,
347,159,148,346,160,148,,,1,-1,0,,,,,,
347,160,171,347,161,171,,,0,-1,0,,,,,,
347,160,194,347,161,194,,,0,-1,0,,,,,,
347,161,217,347,162,217,,,0,-1,0,,,,,,
348,162,240,347,163,240,,,1,-1,0,,,,,,
348,163,264,348,163,264,,,0,0,0,,,,,,
348,163,288,348,164,288,,,0,-1,0,,,,,,
349,164,312,349,165,312,,,0,-1,0,,,,,,
349,165,337,349,166,337,,,0,-1,0,,,,,,
350,167,361,349,167,361,,,1,0,0,,,,,,
350,168,386,350,169,386,,,0,-1,0,,,,,,
351,169,410,350,170,410,,,1,-1,0,,,,,,
351,171,435,351,171,435,,,0,0,0,,,,,,
352,172,460,352,173,460,,,0,-1,0,,,,,,
352,174,485,353,174,485,,,-1,0,0,,,,,,
353,175,510,353,176,510,,,0,-1,0,,,,,,
354,177,535,354,178,535,,,0,-1,0,,,,,,
355,179,560,355,180,560,,,0,-1,0,,,,,,
356,181,585,356,182,585,,,0,-1,0,,,,,,
356,183,610,356,183,610,,,0,0,0,,,,,,
357,185,636,357,185,635,,,0,0,1,,,,,,
358,187,661,358,187,661,,,0,0,0,,,,,,
359,189,686,359,190,686,,,0,-1,0,,,,,,
360,191,712,360,192,711,,,0,-1,1,,,,,,
361,193,737,362,194,737,,,-1,-1,0,,,,,,
362,196,763,363,197,762,,,-1,-1,1,,,,,,
349,181,65,349,181,65,,,0,0,0,,,,,,
349,181,68,349,181,65,,,0,0,3,,,,,,
349,181,77,349,181,77,,,0,0,0,,,,,,
349,181,91,349,181,93,,,0,0,-2,,,,,,
349,182,109,349,181,109,,,0,1,0,,,,,,
349,182,129,349,182,129,,,0,0,0,,,,,,
350,182,150,349,182,150,,,1,0,0,,,,,,
350,183,172,350,183,172,,,0,0,0,,,,,,
350,183,195,350,183,195,,,0,0,0,,,,,,
350,184,218,350,184,218,,,0,0,0,,,,,,
351,184,241,350,184,241,,,1,0,0,,,,,,
351,185,265,351,185,265,,,0,0,0,,,,,,
351,186,289,351,185,289,,,0,1,0,,,,,,
352,187,313,351,186,313,,,1,1,0,,,,,,
352,187,337,352,187,337,,,0,0,0,,,,,,
353,188,362,352,188,362,,,1,0,0,,,,,,
353,190,386,353,189,386,,,0,1,0,,,,,,
354,191,411,353,190,411,,,1,1,0,,,,,,
354,192,436,354,192,435,,,0,0,1,,,,,,
355,193,460,355,193,460,,,0,0,0,,,,,,
355,195,485,356,194,485,,,-1,1,0,,,,,,
356,196,510,356,196,510,,,0,0,0,,,,,,
357,198,535,357,197,535,,,0,1,0,,,,,,
358,199,560,357,199,560,,,1,0,0,,,,,,
358,201,585,358,201,585,,,0,0,0,,,,,,
359,203,611,359,202,610,,,0,1,1,,,,,,
360,204,636,360,204,636,,,0,0,0,,,,,,
361,206,661,361,206,661,,,0,0,0,,,,,,
362,208,686,362,208,686,,,0,0,0,,,,,,
363,210,712,363,210,712,,,0,0,0,,,,,,
364,212,737,364,212,737,,,0,0,0,,,,,,
365,214,763,365,214,762,,,0,0,1,,,,,,
353,206,70,353,206,70,,,0,0,0,,,,,,
353,206,73,353,206,70,,,0,0,3,,,,,,
353,206,81,353,206,81,,,0,0,0,,,,,,
353,206,95,353,206,96,,,0,0,-1,,,,,,
353,206,112,353,206,112,,,0,0,0,,,,,,
353,206,131,353,206,132,,,0,0,-1,,,,,,
353,206,152,353,207,152,,,0,-1,0,,,,,,
353,207,174,353,207,174,,,0,0,0,,,,,,
354,207,196,354,208,196,,,0,-1,0,,,,,,
354,208,219,354,208,219,,,0,0,0,,,,,,
354,208,242,354,208,242,,,0,0,0,,,,,,
354,209,266,355,209,266,,,-1,0,0,,,,,,
355,209,290,355,210,290,,,0,-1,0,,,,,,
355,210,314,355,210,314,,,0,0,0,,,,,,
356,211,338,356,211,338,,,0,0,0,,,,,,
356,212,362,356,212,362,,,0,0,0,,,,,,
357,213,387,357,213,387,,,0,0,0,,,,,,
357,214,411,357,214,411,,,0,0,0,,,,,,
358,215,436,358,215,436,,,0,0,0,,,,,,
358,216,461,359,216,461,,,-1,0,0,,,,,,
359,217,486,359,218,486,,,0,-1,0,,,,,,
360,219,511,360,219,511,,,0,0,0,,,,,,
360,220,536,361,220,536,,,-1,0,0,,,,,,
361,221,561,361,222,561,,,0,-1,0,,,,,,
362,223,586,362,223,586,,,0,0,0,,,,,,
363,224,611,363,225,611,,,0,-1,0,,,,,,
364,226,636,364,226,636,,,0,0,0,,,,,,
365,228,662,365,228,661,,,0,0,1,,,,,,
366,229,687,366,230,687,,,0,-1,0,,,,,,
367,231,712,367,232,712,,,0,-1,0,,,,,,
368,233,738,368,233,737,,,0,0,1,,,,,,
369,235,763,369,235,763,,,0,0,0,,,,,,
357,231,75,357,231,75,,,0,0,0,,,,,,
357,231,78,357,231,75,,,0,0,3,,,,,,
357,231,86,357,231,85,,,0,0,1,,,,,,
357,231,99,357,231,100,,,0,0,-1,,,,,,
357,231,115,357,231,115,,,0,0,0,,,,,,
357,231,134,357,231,135,,,0,0,-1,,,,,,
357,232,154,357,231,154,,,0,1,0,,,,,,
358,232,176,357,232,176,,,1,0,0,,,,,,
358,232,198,358,232,198,,,0,0,0,,,,,,
358,233,221,358,232,221,,,0,1,0,,,,,,
358,233,244,358,233,244,,,0,0,0,,,,,,
359,234,267,359,233,267,,,0,1,0,,,,,,
359,234,291,359,234,291,,,0,0,0,,,,,,
359,235,315,359,235,315,,,0,0,0,,,,,,
360,236,339,360,235,339,,,0,1,0,,,,,,
360,236,363,360,236,363,,,0,0,0,,,,,,
361,237,388,361,237,387,,,0,0,1,,,,,,
361,238,412,361,238,412,,,0,0,0,,,,,,
362,239,437,362,239,437,,,0,0,0,,,,,,
363,240,462,363,240,461,,,0,0,1,,,,,,
363,241,486,363,241,486,,,0,0,0,,,,,,
364,242,511,364,242,511,,,0,0,0,,,,,,
365,243,536,365,243,536,,,0,0,0,,,,,,
365,245,561,365,245,561,,,0,0,0,,,,,,
366,246,586,366,246,586,,,0,0,0,,,,,,
367,247,612,367,247,611,,,0,0,1,,,,,,
368,249,637,368,249,636,,,0,0,1,,,,,,
369,250,662,369,250,662,,,0,0,0,,,,,,
370,252,687,370,252,687,,,0,0,0,,,,,,
371,254,713,371,254,712,,,0,0,1,,,,,,
372,255,738,372,255,738,,,0,0,0,,,,,,
373,257,763,373,257,763,,,0,0,0,,,,,,
362,257,81,362,257,81,,,0,0,0,,,,,,
362,257,83,362,257,81,,,0,0,2,,,,,,
362,257,91,362,257,90,,,0,0,1,,,,,,
362,257,103,362,257,104,,,0,0,-1,,,,,,
362,257,119,362,257,119,,,0,0,0,,,,,,
362,257,137,362,257,138,,,0,0,-1,,,,,,
362,257,157,362,257,157,,,0,0,0,,,,,,
363,258,178,362,258,178,,,1,0,0,,,,,,
363,258,200,363,258,200,,,0,0,0,,,,,,
363,258,222,363,258,222,,,0,0,0,,,,,,
363,259,245,363,259,245,,,0,0,0,,,,,,
364,259,269,364,259,269,,,0,0,0,,,,,,
364,260,292,364,260,292,,,0,0,0,,,,,,
364,260,316,364,260,316,,,0,0,0,,,,,,
365,261,340,365,261,340,,,0,0,0,,,,,,
365,262,364,365,262,364,,,0,0,0,,,,,,
366,262,389,366,263,388,,,0,-1,1,,,,,,
366,263,413,366,263,413,,,0,0,0,,,,,,
367,264,438,367,264,437,,,0,0,1,,,,,,
367,265,462,368,265,462,,,-1,0,0,,,,,,
368,266,487,368,266,487,,,0,0,0,,,,,,
369,267,512,369,267,512,,,0,0,0,,,,,,
369,268,537,370,268,537,,,-1,0,0,,,,,,
370,269,562,370,269,562,,,0,0,0,,,,,,
371,270,587,371,271,587,,,0,-1,0,,,,,,
372,272,612,372,272,612,,,0,0,0,,,,,,
373,273,637,373,273,637,,,0,0,0,,,,,,
374,274,663,374,274,662,,,0,0,1,,,,,,
374,276,688,375,276,688,,,-1,0,0,,,,,,
375,277,713,376,277,713,,,-1,0,0,,,,,,
376,279,739,377,279,738,,,-1,0,1,,,,,,
378,280,764,378,280,764,,,0,0,0,,,,,,
367,283,87,368,283,87,,,-1,0,0,,,,,,
367,283,89,368,283,87,,,-1,0,2,,,,,,
367,283,96,368,283,96,,,-1,0,0,,,,,,
368,283,108,368,283,109,,,0,0,-1,,,,,,
368,283,123,368,283,122,,,0,0,1,,,,,,
368,284,140,368,283,141,,,0,1,-1,,,,,,
368,284,160,368,284,160,,,0,0,0,,,,,,
368,284,181,368,284,181,,,0,0,0,,,,,,
368,284,202,368,284,202,,,0,0,0,,,,,,
368,285,224,368,284,224,,,0,1,0,,,,,,
369,285,247,369,285,247,,,0,0,0,,,,,,
369,285,270,369,285,270,,,0,0,0,,,,,,
369,286,294,369,286,293,,,0,0,1,,,,,,
370,286,317,370,286,317,,,0,0,0,,,,,,
370,287,341,370,287,341,,,0,0,0,,,,,,
371,288,365,371,287,365,,,0,1,0,,,,,,
371,288,390,371,288,389,,,0,0,1,,,,,,
372,289,414,372,289,414,,,0,0,0,,,,,,
372,290,439,372,290,438,,,0,0,1,,,,,,
373,291,463,373,290,463,,,0,1,0,,,,,,
373,292,488,373,291,488,,,0,1,0,,,,,,
374,292,513,374,292,512,,,0,0,1,,,,,,
375,293,538,375,293,537,,,0,0,1,,,,,,
375,294,563,375,294,562,,,0,0,1,,,,,,
376,295,588,376,295,587,,,0,0,1,,,,,,
377,297,613,377,296,612,,,0,1,1,,,,,,
378,298,638,378,298,638,,,0,0,0,,,,,,
379,299,663,379,299,663,,,0,0,0,,,,,,
380,300,688,380,300,688,,,0,0,0,,,,,,
381,302,714,381,301,713,,,0,1,1,,,,,,
382,303,739,382,303,739,,,0,0,0,,,,,,
383,304,764,383,304,764,,,0,0,0,,,,,,
374,310,93,374,310,93,,,0,0,0,,,,,,
374,310,95,374,310,93,,,0,0,2,,,,,,
374,310,102,374,310,101,,,0,0,1,,,,,,
374,310,113,374,310,114,,,0,0,-1,,,,,,
374,310,127,374,310,127,,,0,0,0,,,,,,
374,310,144,374,310,145,,,0,0,-1,,,,,,
374,311,163,374,311,163,,,0,0,0,,,,,,
374,311,183,374,311,184,,,0,0,-1,,,,,,
374,311,205,374,311,204,,,0,0,1,,,,,,
375,311,227,375,311,227,,,0,0,0,,,,,,
375,312,249,375,312,249,,,0,0,0,,,,,,
375,312,272,375,312,272,,,0,0,0,,,,,,
375,313,295,375,312,295,,,0,1,0,,,,,,
376,313,319,376,313,319,,,0,0,0,,,,,,
376,314,343,376,313,343,,,0,1,0,,,,,,
377,314,367,377,314,367,,,0,0,0,,,,,,
377,315,391,377,315,391,,,0,0,0,,,,,,
378,315,415,378,315,415,,,0,0,0,,,,,,
378,316,440,378,316,439,,,0,0,1,,,,,,
379,317,464,379,317,464,,,0,0,0,,,,,,
379,318,489,380,317,489,,,-1,1,0,,,,,,
380,318,514,380,318,513,,,0,0,1,,,,,,
381,319,539,381,319,538,,,0,0,1,,,,,,
381,320,563,381,320,563,,,0,0,0,,,,,,
382,321,588,382,321,588,,,0,0,0,,,,,,
383,322,613,383,322,613,,,0,0,0,,,,,,
384,323,639,384,323,638,,,0,0,1,,,,,,
385,324,664,385,324,664,,,0,0,0,,,,,,
386,326,689,386,325,689,,,0,1,0,,,,,,
387,327,714,387,327,714,,,0,0,0,,,,,,
388,328,740,388,328,739,,,0,0,1,,,,,,
389,329,765,389,329,765,,,0,0,0,,,,,,
380,337,100,380,337,100,,,0,0,0,,,,,,
380,337,101,380,337,100,,,0,0,1,,,,,,
380,337,107,380,337,107,,,0,0,0,,,,,,
380,337,118,380,337,119,,,0,0,-1,,,,,,
380,338,132,381,337,131,,,-1,1,1,,,,,,
380,338,148,381,337,149,,,-1,1,-1,,,,,,
381,338,167,381,338,167,,,0,0,0,,,,,,
381,338,187,381,338,187,,,0,0,0,,,,,,
381,338,207,381,338,207,,,0,0,0,,,,,,
381,338,229,381,338,229,,,0,0,0,,,,,,
381,339,251,382,339,251,,,-1,0,0,,,,,,
382,339,274,382,339,274,,,0,0,0,,,,,,
382,340,297,382,339,297,,,0,1,0,,,,,,
382,340,321,382,340,321,,,0,0,0,,,,,,
383,340,344,383,340,344,,,0,0,0,,,,,,
383,341,368,383,341,368,,,0,0,0,,,,,,
384,342,392,384,341,392,,,0,1,0,,,,,,
384,342,417,384,342,416,,,0,0,1,,,,,,
385,343,441,385,343,441,,,0,0,0,,,,,,
385,343,465,385,343,465,,,0,0,0,,,,,,
386,344,490,386,344,490,,,0,0,0,,,,,,
387,345,515,387,345,514,,,0,0,1,,,,,,
387,346,539,387,346,539,,,0,0,0,,,,,,
388,347,564,388,346,564,,,0,1,0,,,,,,
389,347,589,388,347,589,,,1,0,0,,,,,,
389,348,614,389,348,614,,,0,0,0,,,,,,
390,349,639,390,349,639,,,0,0,0,,,,,,
391,350,665,391,350,664,,,0,0,1,,,,,,
392,352,690,392,351,690,,,0,1,0,,,,,,
393,353,715,393,352,715,,,0,1,0,,,,,,
394,354,740,394,354,740,,,0,0,0,,,,,,
395,355,766,395,355,765,,,0,0,1,,,,,,
387,365,106,388,365,106,,,-1,0,0,,,,,,
387,365,108,388,365,106,,,-1,0,2,,,,,,
387,365,114,388,365,113,,,-1,0,1,,,,,,
388,365,123,388,365,125,,,0,0,-2,,,,,,
388,365,137,388,365,136,,,0,0,1,,,,,,
388,365,153,388,365,153,,,0,0,0,,,,,,
388,365,171,388,365,171,,,0,0,0,,,,,,
388,365,190,388,365,190,,,0,0,0,,,,,,
388,366,210,388,365,210,,,0,1,0,,,,,,
388,366,232,389,366,232,,,-1,0,0,,,,,,
389,366,254,389,366,254,,,0,0,0,,,,,,
389,366,276,389,366,276,,,0,0,0,,,,,,
389,367,299,389,367,299,,,0,0,0,,,,,,
390,367,323,390,367,322,,,0,0,1,,,,,,
390,368,346,390,368,346,,,0,0,0,,,,,,
390,368,370,391,368,370,,,-1,0,0,,,,,,
391,369,394,391,369,394,,,0,0,0,,,,,,
391,369,418,392,369,418,,,-1,0,0,,,,,,
392,370,442,392,370,442,,,0,0,0,,,,,,
392,370,467,393,370,466,,,-1,0,1,,,,,,
393,371,491,393,371,491,,,0,0,0,,,,,,
394,372,516,394,372,515,,,0,0,1,,,,,,
394,373,541,395,372,540,,,-1,1,1,,,,,,
395,373,565,395,373,565,,,0,0,0,,,,,,
396,374,590,396,374,590,,,0,0,0,,,,,,
397,375,615,397,375,615,,,0,0,0,,,,,,
397,376,640,398,376,640,,,-1,0,0,,,,,,
398,377,665,398,377,665,,,0,0,0,,,,,,
399,378,691,399,378,690,,,0,0,1,,,,,,
400,379,716,400,379,716,,,0,0,0,,,,,,
401,380,741,401,380,741,,,0,0,0,,,,,,
402,381,766,402,381,766,,,0,0,0,,,,,,
395,392,113,395,392,113,,,0,0,0,,,,,,
395,393,115,395,392,113,,,0,1,2,,,,,,
395,393,120,395,392,120,,,0,1,0,,,,,,
395,393,129,395,392,131,,,0,1,-2,,,,,,
395,393,142,396,392,142,,,-1,1,0,,,,,,
395,393,157,396,392,158,,,-1,1,-1,,,,,,
396,393,175,396,393,175,,,0,0,0,,,,,,
396,393,194,396,393,194,,,0,0,0,,,,,,
396,393,214,396,393,214,,,0,0,0,,,,,,
396,394,235,396,393,235,,,0,1,0,,,,,,
396,394,256,397,393,256,,,-1,1,0,,,,,,
397,394,279,397,394,279,,,0,0,0,,,,,,
397,394,302,397,394,301,,,0,0,1,,,,,,
397,395,325,397,395,324,,,0,0,1,,,,,,
398,395,348,398,395,347,,,0,0,1,,,,,,
398,396,372,398,396,371,,,0,0,1,,,,,,
399,396,395,399,396,395,,,0,0,0,,,,,,
399,397,419,399,397,419,,,0,0,0,,,,,,
400,397,444,400,397,443,,,0,0,1,,,,,,
400,398,468,400,398,468,,,0,0,0,,,,,,
401,398,492,401,398,492,,,0,0,0,,,,,,
401,399,517,401,399,517,,,0,0,0,,,,,,
402,400,542,402,399,541,,,0,1,1,,,,,,
403,400,566,403,400,566,,,0,0,0,,,,,,
403,401,591,403,401,591,,,0,0,0,,,,,,
404,402,616,404,402,616,,,0,0,0,,,,,,
405,403,641,405,402,641,,,0,1,0,,,,,,
406,404,666,406,403,666,,,0,1,0,,,,,,
407,405,691,407,404,691,,,0,1,0,,,,,,
407,406,717,408,405,716,,,-1,1,1,,,,,,
408,407,742,409,406,742,,,-1,1,0,,,,,,
409,408,767,410,407,767,,,-1,1,0,,,,,,
403,420,120,404,420,120,,,-1,0,0,,,,,,
403,420,121,404,420,120,,,-1,0,1,,,,,,
403,420,126,404,420,126,,,-1,0,0,,,,,,
404,420,135,404,420,137,,,0,0,-2,,,,,,
404,421,147,404,420,147,,,0,1,0,,,,,,
404,421,162,404,420,163,,,0,1,-1,,,,,,
404,421,179,404,421,179,,,0,0,0,,,,,,
404,421,197,404,421,198,,,0,0,-1,,,,,,
404,421,217,404,421,217,,,0,0,0,,,,,,
404,421,238,405,421,238,,,-1,0,0,,,,,,
405,422,259,405,421,259,,,0,1,0,,,,,,
405,422,281,405,421,281,,,0,1,0,,,,,,
405,422,304,405,422,304,,,0,0,0,,,,,,
406,422,327,406,422,327,,,0,0,0,,,,,,
406,423,350,406,423,350,,,0,0,0,,,,,,
406,423,373,407,423,373,,,-1,0,0,,,,,,
407,424,397,407,424,397,,,0,0,0,,,,,,
407,424,421,407,424,421,,,0,0,0,,,,,,
408,425,445,408,425,445,,,0,0,0,,,,,,
408,425,469,408,425,469,,,0,0,0,,,,,,
409,426,494,409,426,494,,,0,0,0,,,,,,
409,426,518,410,426,518,,,-1,0,0,,,,,,
410,427,543,410,427,543,,,0,0,0,,,,,,
411,428,568,411,427,567,,,0,1,1,,,,,,
411,428,592,412,428,592,,,-1,0,0,,,,,,
412,429,617,412,429,617,,,0,0,0,,,,,,
413,430,642,413,430,642,,,0,0,0,,,,,,
414,431,667,414,430,667,,,0,1,0,,,,,,
415,432,692,415,431,692,,,0,1,0,,,,,,
415,432,717,416,432,717,,,-1,0,0,,,,,,
416,433,743,417,433,742,,,-1,0,1,,,,,,
417,434,768,418,434,768,,,-1,0,0,,,,,,
412,448,127,413,448,127,,,-1,0,0,,,,,,
412,448,128,413,448,127,,,-1,0,1,,,,,,
412,449,133,413,448,133,,,-1,1,0,,,,,,
412,449,141,413,448,143,,,-1,1,-2,,,,,,
412,449,153,413,448,153,,,-1,1,0,,,,,,
412,449,167,413,448,168,,,-1,1,-1,,,,,,
413,449,183,413,449,184,,,0,0,-1,,,,,,
413,449,202,413,449,202,,,0,0,0,,,,,,
413,449,221,413,449,221,,,0,0,0,,,,,,
413,449,241,413,449,241,,,0,0,0,,,,,,
413,450,262,414,449,262,,,-1,1,0,,,,,,
414,450,284,414,449,284,,,0,1,0,,,,,,
414,450,306,414,450,306,,,0,0,0,,,,,,
414,450,329,414,450,329,,,0,0,0,,,,,,
415,451,352,415,451,352,,,0,0,0,,,,,,
415,451,376,415,451,376,,,0,0,0,,,,,,
415,452,399,416,451,399,,,-1,1,0,,,,,,
416,452,423,416,452,423,,,0,0,0,,,,,,
416,452,447,416,452,447,,,0,0,0,,,,,,
417,453,471,417,453,471,,,0,0,0,,,,,,
417,453,495,417,453,495,,,0,0,0,,,,,,
418,454,520,418,454,520,,,0,0,0,,,,,,
419,455,544,419,454,544,,,0,1,0,,,,,,
419,455,569,419,455,569,,,0,0,0,,,,,,
420,456,594,420,456,593,,,0,0,1,,,,,,
421,457,618,421,456,618,,,0,1,0,,,,,,
421,457,643,421,457,643,,,0,0,0,,,,,,
422,458,668,422,458,668,,,0,0,0,,,,,,
423,459,693,423,459,693,,,0,0,0,,,,,,
424,460,718,424,459,718,,,0,1,0,,,,,,
425,461,744,425,460,743,,,0,1,1,,,,,,
426,461,769,426,461,768,,,0,0,1,,,,,,
421,477,134,422,476,134,,,-1,1,0,,,,,,
421,477,135,422,476,134,,,-1,1,1,,,,,,
421,477,140,422,476,139,,,-1,1,1,,,,,,
421,477,148,422,476,149,,,-1,1,-1,,,,,,
422,477,159,422,476,159,,,0,1,0,,,,,,
422,477,172,422,477,173,,,0,0,-1,,,,,,
422,477,188,422,477,188,,,0,0,0,,,,,,
422,477,206,422,477,206,,,0,0,0,,,,,,
422,477,225,422,477,225,,,0,0,0,,,,,,
422,477,245,422,477,245,,,0,0,0,,,,,,
422,478,266,423,477,265,,,-1,1,1,,,,,,
423,478,287,423,478,287,,,0,0,0,,,,,,
423,478,309,423,478,309,,,0,0,0,,,,,,
423,479,332,423,478,332,,,0,1,0,,,,,,
424,479,355,424,479,355,,,0,0,0,,,,,,
424,479,378,424,479,378,,,0,0,0,,,,,,
424,480,401,425,479,401,,,-1,1,0,,,,,,
425,480,425,425,480,425,,,0,0,0,,,,,,
425,480,449,426,480,448,,,-1,0,1,,,,,,
426,481,473,426,481,472,,,0,0,1,,,,,,
426,481,497,427,481,497,,,-1,0,0,,,,,,
427,482,521,427,482,521,,,0,0,0,,,,,,
428,482,546,428,482,546,,,0,0,0,,,,,,
428,483,570,428,483,570,,,0,0,0,,,,,,
429,484,595,429,483,595,,,0,1,0,,,,,,
430,484,620,430,484,619,,,0,0,1,,,,,,
430,485,645,431,485,644,,,-1,0,1,,,,,,
431,486,669,431,485,669,,,0,1,0,,,,,,
432,486,694,432,486,694,,,0,0,0,,,,,,
433,487,720,433,487,719,,,0,0,1,,,,,,
434,488,745,434,488,744,,,0,0,1,,,,,,
435,489,770,435,489,769,,,0,0,1,,,,,,
431,505,141,431,505,141,,,0,0,0,,,,,,
431,505,142,431,505,141,,,0,0,1,,,,,,
431,505,147,431,505,146,,,0,0,1,,,,,,
431,505,154,431,505,155,,,0,0,-1,,,,,,
431,505,165,431,505,165,,,0,0,0,,,,,,
431,505,178,431,505,179,,,0,0,-1,,,,,,
431,505,193,432,505,193,,,-1,0,0,,,,,,
431,505,210,432,505,211,,,-1,0,-1,,,,,,
432,506,229,432,506,229,,,0,0,0,,,,,,
432,506,249,432,506,249,,,0,0,0,,,,,,
432,506,269,432,506,269,,,0,0,0,,,,,,
432,506,290,432,506,290,,,0,0,0,,,,,,
433,506,312,433,506,312,,,0,0,0,,,,,,
433,507,334,433,506,335,,,0,1,-1,,,,,,
433,507,357,433,507,357,,,0,0,0,,,,,,
434,507,380,434,507,380,,,0,0,0,,,,,,
434,508,403,434,508,403,,,0,0,0,,,,,,
434,508,427,435,508,427,,,-1,0,0,,,,,,
435,509,451,435,508,450,,,0,1,1,,,,,,
435,509,475,436,509,474,,,-1,0,1,,,,,,
436,509,499,436,509,498,,,0,0,1,,,,,,
437,510,523,437,510,523,,,0,0,0,,,,,,
437,510,547,437,510,547,,,0,0,0,,,,,,
438,511,572,438,511,572,,,0,0,0,,,,,,
438,512,596,438,511,596,,,0,1,0,,,,,,
439,512,621,439,512,621,,,0,0,0,,,,,,
440,513,646,440,513,646,,,0,0,0,,,,,,
441,514,671,441,513,670,,,0,1,1,,,,,,
441,514,696,441,514,695,,,0,0,1,,,,,,
442,515,721,442,515,720,,,0,0,1,,,,,,
443,516,746,443,516,746,,,0,0,0,,,,,,
444,516,771,444,516,771,,,0,0,0,,,,,,
441,533,149,441,533,148,,,0,0,1,,,,,,
441,533,150,441,533,148,,,0,0,2,,,,,,
441,534,154,441,533,153,,,0,1,1,,,,,,
441,534,161,441,533,162,,,0,1,-1,,,,,,
441,534,171,441,533,171,,,0,1,0,,,,,,
441,534,184,441,533,184,,,0,1,0,,,,,,
441,534,198,442,533,198,,,-1,1,0,,,,,,
442,534,215,442,534,215,,,0,0,0,,,,,,
442,534,233,442,534,233,,,0,0,0,,,,,,
442,534,252,442,534,253,,,0,0,-1,,,,,,
442,534,273,442,534,272,,,0,0,1,,,,,,
442,535,294,443,534,294,,,-1,1,0,,,,,,
443,535,315,443,534,315,,,0,1,0,,,,,,
443,535,337,443,535,337,,,0,0,0,,,,,,
443,535,360,443,535,360,,,0,0,0,,,,,,
444,536,382,444,535,382,,,0,1,0,,,,,,
444,536,406,444,536,405,,,0,0,1,,,,,,
444,536,429,445,536,429,,,-1,0,0,,,,,,
445,537,453,445,536,452,,,0,1,1,,,,,,
445,537,476,446,537,476,,,-1,0,0,,,,,,
446,538,500,446,537,500,,,0,1,0,,,,,,
446,538,525,447,538,524,,,-1,0,1,,,,,,
447,539,549,447,538,549,,,0,1,0,,,,,,
448,539,573,448,539,573,,,0,0,0,,,,,,
448,540,598,448,539,598,,,0,1,0,,,,,,
449,540,622,449,540,622,,,0,0,0,,,,,,
450,541,647,450,541,647,,,0,0,0,,,,,,
450,541,672,451,541,672,,,-1,0,0,,,,,,
451,542,697,451,542,696,,,0,0,1,,,,,,
452,543,722,452,543,721,,,0,0,1,,,,,,
453,544,747,453,544,747,,,0,0,0,,,,,,
454,544,772,454,544,772,,,0,0,0,,,,,,
451,562,156,452,562,156,,,-1,0,0,,,,,,
451,562,157,452,562,156,,,-1,0,1,,,,,,
451,562,161,452,562,161,,,-1,0,0,,,,,,
452,562,167,452,562,169,,,0,0,-2,,,,,,
452,562,177,452,562,177,,,0,0,0,,,,,,
452,562,189,452,562,190,,,0,0,-1,,,,,,
452,562,204,452,562,204,,,0,0,0,,,,,,
452,562,220,452,562,220,,,0,0,0,,,,,,
452,563,238,452,563,237,,,0,0,1,,,,,,
452,563,257,452,563,257,,,0,0,0,,,,,,
452,563,276,453,563,276,,,-1,0,0,,,,,,
453,563,297,453,563,297,,,0,0,0,,,,,,
453,563,318,453,563,318,,,0,0,0,,,,,,
453,564,340,453,563,340,,,0,1,0,,,,,,
454,564,362,454,564,362,,,0,0,0,,,,,,
454,564,385,454,564,385,,,0,0,0,,,,,,
454,564,408,455,564,408,,,-1,0,0,,,,,,
455,565,431,455,564,431,,,0,1,0,,,,,,
455,565,455,455,565,454,,,0,0,1,,,,,,
456,566,478,456,565,478,,,0,1,0,,,,,,
456,566,502,456,566,502,,,0,0,0,,,,,,
457,566,526,457,566,526,,,0,0,0,,,,,,
457,567,551,457,567,550,,,0,0,1,,,,,,
458,567,575,458,567,575,,,0,0,0,,,,,,
458,568,599,458,568,599,,,0,0,0,,,,,,
459,568,624,459,568,624,,,0,0,0,,,,,,
460,569,649,460,569,648,,,0,0,1,,,,,,
461,570,673,461,569,673,,,0,1,0,,,,,,
461,570,698,461,570,698,,,0,0,0,,,,,,
462,571,723,462,571,723,,,0,0,0,,,,,,
463,572,748,463,572,748,,,0,0,0,,,,,,
464,572,773,464,572,773,,,0,0,0,,,,,,
462,591,163,463,590,163,,,-1,1,0,,,,,,
462,591,164,463,590,163,,,-1,1,1,,,,,,
462,591,168,463,590,168,,,-1,1,0,,,,,,
462,591,174,463,590,175,,,-1,1,-1,,,,,,
462,591,184,463,591,183,,,-1,0,1,,,,,,
462,591,195,463,591,196,,,-1,0,-1,,,,,,
463,591,209,463,591,209,,,0,0,0,,,,,,
463,591,225,463,591,226,,,0,0,-1,,,,,,
463,591,242,463,591,242,,,0,0,0,,,,,,
463,591,261,463,591,261,,,0,0,0,,,,,,
463,592,280,464,591,280,,,-1,1,0,,,,,,
463,592,301,464,591,301,,,-1,1,0,,,,,,
464,592,322,464,592,322,,,0,0,0,,,,,,
464,592,343,464,592,343,,,0,0,0,,,,,,
464,592,365,465,592,365,,,-1,0,0,,,,,,
465,593,388,465,592,388,,,0,1,0,,,,,,
465,593,411,465,593,410,,,0,0,1,,,,,,
465,593,434,466,593,433,,,-1,0,1,,,,,,
466,594,457,466,593,457,,,0,1,0,,,,,,
466,594,481,467,594,480,,,-1,0,1,,,,,,
467,594,504,467,594,504,,,0,0,0,,,,,,
467,595,528,468,595,528,,,-1,0,0,,,,,,
468,595,552,468,595,552,,,0,0,0,,,,,,
468,596,577,469,596,576,,,-1,0,1,,,,,,
469,596,601,469,596,601,,,0,0,0,,,,,,
470,597,626,470,597,625,,,0,0,1,,,,,,
470,597,650,471,597,650,,,-1,0,0,,,,,,
471,598,675,471,598,674,,,0,0,1,,,,,,
472,598,700,472,598,699,,,0,0,1,,,,,,
473,599,725,473,599,724,,,0,0,1,,,,,,
473,600,749,474,600,749,,,-1,0,0,,,,,,
474,600,775,474,600,774,,,0,0,1,,,,,,
473,619,171,474,619,171,,,-1,0,0,,,,,,
473,619,172,474,619,171,,,-1,0,1,,,,,,
473,619,175,474,619,175,,,-1,0,0,,,,,,
473,620,181,474,619,182,,,-1,1,-1,,,,,,
473,620,190,474,620,190,,,-1,0,0,,,,,,
474,620,201,474,620,202,,,0,0,-1,,,,,,
474,620,215,474,620,215,,,0,0,0,,,,,,
474,620,230,474,620,231,,,0,0,-1,,,,,,
474,620,247,474,620,247,,,0,0,0,,,,,,
474,620,265,474,620,266,,,0,0,-1,,,,,,
474,620,285,475,620,284,,,-1,0,1,,,,,,
475,620,305,475,620,305,,,0,0,0,,,,,,
475,621,325,475,621,325,,,0,0,0,,,,,,
475,621,347,475,621,347,,,0,0,0,,,,,,
475,621,368,476,621,368,,,-1,0,0,,,,,,
476,621,391,476,621,391,,,0,0,0,,,,,,
476,622,413,476,622,413,,,0,0,0,,,,,,
476,622,436,477,622,436,,,-1,0,0,,,,,,
477,622,459,477,622,459,,,0,0,0,,,,,,
477,623,483,478,622,483,,,-1,1,0,,,,,,
478,623,507,478,623,506,,,0,0,1,,,,,,
478,623,530,479,623,530,,,-1,0,0,,,,,,
479,624,554,479,624,554,,,0,0,0,,,,,,
479,624,579,480,624,578,,,-1,0,1,,,,,,
480,625,603,480,625,603,,,0,0,0,,,,,,
481,625,627,481,625,627,,,0,0,0,,,,,,
481,626,652,481,626,652,,,0,0,0,,,,,,
482,626,676,482,626,676,,,0,0,0,,,,,,
483,627,701,483,627,701,,,0,0,0,,,,,,
483,627,726,484,627,726,,,-1,0,0,,,,,,
484,628,751,484,628,751,,,0,0,0,,,,,,
485,629,776,485,628,776,,,0,1,0,,,,,,
485,648,178,485,648,178,,,0,0,0,,,,,,
485,648,179,485,648,178,,,0,0,1,,,,,,
485,648,182,485,648,182,,,0,0,0,,,,,,
485,648,188,485,648,189,,,0,0,-1,,,,,,
485,648,197,485,648,196,,,0,0,1,,,,,,
485,648,208,485,648,208,,,0,0,0,,,,,,
485,649,221,485,648,221,,,0,1,0,,,,,,
485,649,236,485,648,236,,,0,1,0,,,,,,
485,649,252,486,649,252,,,-1,0,0,,,,,,
486,649,270,486,649,270,,,0,0,0,,,,,,
486,649,289,486,649,289,,,0,0,0,,,,,,
486,649,309,486,649,309,,,0,0,0,,,,,,
486,649,329,486,649,329,,,0,0,0,,,,,,
486,650,350,487,649,350,,,-1,1,0,,,,,,
487,650,372,487,650,372,,,0,0,0,,,,,,
487,650,394,487,650,394,,,0,0,0,,,,,,
487,650,416,488,650,416,,,-1,0,0,,,,,,
488,651,439,488,650,439,,,0,1,0,,,,,,
488,651,462,489,651,462,,,-1,0,0,,,,,,
489,651,485,489,651,485,,,0,0,0,,,,,,
489,652,509,490,651,509,,,-1,1,0,,,,,,
490,652,533,490,652,532,,,0,0,1,,,,,,
490,652,556,491,652,556,,,-1,0,0,,,,,,
491,653,581,491,653,580,,,0,0,1,,,,,,
491,653,605,492,653,604,,,-1,0,1,,,,,,
492,654,629,492,654,629,,,0,0,0,,,,,,
493,654,654,493,654,653,,,0,0,1,,,,,,
493,655,678,493,655,678,,,0,0,0,,,,,,
494,655,703,494,655,702,,,0,0,1,,,,,,
495,656,727,495,656,727,,,0,0,0,,,,,,
495,656,752,496,656,752,,,-1,0,0,,,,,,
496,657,777,496,657,777,,,0,0,0,,,,,,
497,677,186,497,677,186,,,0,0,0,,,,,,
497,677,186,497,677,186,,,0,0,0,,,,,,
497,677,190,497,677,190,,,0,0,0,,,,,,
497,677,195,497,677,196,,,0,0,-1,,,,,,
497,677,203,497,677,203,,,0,0,0,,,,,,
497,677,214,497,677,215,,,0,0,-1,,,,,,
497,677,227,497,677,227,,,0,0,0,,,,,,
497,678,241,497,677,242,,,0,1,-1,,,,,,
497,678,257,497,678,257,,,0,0,0,,,,,,
497,678,275,497,678,275,,,0,0,0,,,,,,
497,678,293,498,678,293,,,-1,0,0,,,,,,
498,678,313,498,678,313,,,0,0,0,,,,,,
498,678,333,498,678,332,,,0,0,1,,,,,,
498,678,354,498,678,354,,,0,0,0,,,,,,
498,679,375,499,679,375,,,-1,0,0,,,,,,
499,679,397,499,679,397,,,0,0,0,,,,,,
499,679,419,499,679,419,,,0,0,0,,,,,,
499,679,442,500,679,442,,,-1,0,0,,,,,,
500,680,465,500,680,464,,,0,0,1,,,,,,
500,680,488,501,680,488,,,-1,0,0,,,,,,
501,680,511,501,680,511,,,0,0,0,,,,,,
501,681,535,502,680,535,,,-1,1,0,,,,,,
502,681,559,502,681,558,,,0,0,1,,,,,,
502,682,583,503,681,582,,,-1,1,1,,,,,,
503,682,607,503,682,606,,,0,0,1,,,,,,
503,682,631,504,682,631,,,-1,0,0,,,,,,
504,683,655,504,683,655,,,0,0,0,,,,,,
505,683,680,505,683,680,,,0,0,0,,,,,,
505,684,704,505,684,704,,,0,0,0,,,,,,
506,684,729,506,684,729,,,0,0,0,,,,,,
507,685,754,507,685,754,,,0,0,0,,,,,,
508,686,779,508,685,778,,,0,1,1,,,,,,
509,706,193,509,706,193,,,0,0,0,,,,,,
509,706,194,509,706,193,,,0,0,1,,,,,,
509,706,197,509,706,197,,,0,0,0,,,,,,
509,706,202,509,706,203,,,0,0,-1,,,,,,
509,706,210,509,706,210,,,0,0,0,,,,,,
509,706,221,509,706,221,,,0,0,0,,,,,,
509,706,233,509,706,233,,,0,0,0,,,,,,
509,706,247,509,706,247,,,0,0,0,,,,,,
509,707,263,509,706,262,,,0,1,1,,,,,,
509,707,280,509,706,280,,,0,1,0,,,,,,
509,707,298,510,707,298,,,-1,0,0,,,,,,
510,707,317,510,707,317,,,0,0,0,,,,,,
510,707,337,510,707,336,,,0,0,1,,,,,,
510,707,357,510,707,357,,,0,0,0,,,,,,
510,708,379,511,707,379,,,-1,1,0,,,,,,
511,708,400,511,707,400,,,0,1,0,,,,,,
511,708,422,511,708,422,,,0,0,0,,,,,,
511,708,445,512,708,445,,,-1,0,0,,,,,,
512,709,467,512,708,467,,,0,1,0,,,,,,
512,709,490,512,709,490,,,0,0,0,,,,,,
513,709,514,513,709,514,,,0,0,0,,,,,,
513,710,537,513,709,537,,,0,1,0,,,,,,
514,710,561,514,710,561,,,0,0,0,,,,,,
514,710,585,514,710,584,,,0,0,1,,,,,,
515,711,609,515,710,608,,,0,1,1,,,,,,
515,711,633,516,711,633,,,-1,0,0,,,,,,
516,712,657,516,711,657,,,0,1,0,,,,,,
517,712,682,517,712,681,,,0,0,1,,,,,,
517,713,706,517,712,706,,,0,1,0,,,,,,
518,713,731,518,713,730,,,0,0,1,,,,,,
519,714,755,519,713,755,,,0,1,0,,,,,,
519,714,780,519,714,780,,,0,0,0,,,,,,
521,735,201,521,735,201,,,0,0,0,,,,,,
521,735,201,521,735,201,,,0,0,0,,,,,,
521,735,204,521,735,204,,,0,0,0,,,,,,
521,735,210,521,735,210,,,0,0,0,,,,,,
521,735,217,521,735,217,,,0,0,0,,,,,,
521,735,227,521,735,228,,,0,0,-1,,,,,,
521,735,239,521,735,239,,,0,0,0,,,,,,
521,736,253,521,735,253,,,0,1,0,,,,,,
521,736,268,522,735,268,,,-1,1,0,,,,,,
521,736,285,522,735,285,,,-1,1,0,,,,,,
522,736,303,522,736,302,,,0,0,1,,,,,,
522,736,321,522,736,321,,,0,0,0,,,,,,
522,736,341,522,736,340,,,0,0,1,,,,,,
522,736,361,522,736,361,,,0,0,0,,,,,,
523,737,382,523,736,382,,,0,1,0,,,,,,
523,737,404,523,736,404,,,0,1,0,,,,,,
523,737,425,524,737,425,,,-1,0,0,,,,,,
524,737,448,524,737,448,,,0,0,0,,,,,,
524,738,470,524,737,470,,,0,1,0,,,,,,
524,738,493,524,737,493,,,0,1,0,,,,,,
525,738,516,525,738,516,,,0,0,0,,,,,,
525,738,540,525,738,540,,,0,0,0,,,,,,
526,739,563,526,739,563,,,0,0,0,,,,,,
526,739,587,526,739,587,,,0,0,0,,,,,,
527,740,611,527,739,611,,,0,1,0,,,,,,
527,740,635,528,740,635,,,-1,0,0,,,,,,
528,740,659,528,740,659,,,0,0,0,,,,,,
529,741,684,529,741,683,,,0,0,1,,,,,,
529,741,708,529,741,708,,,0,0,0,,,,,,
530,742,733,530,742,732,,,0,0,1,,,,,,
531,742,757,531,742,757,,,0,0,0,,,,,,
531,743,782,531,743,782,,,0,0,0,,,,,,
533,764,208,533,764,208,,,0,0,0,,,,,,
533,764,209,533,764,208,,,0,0,1,,,,,,
533,764,212,533,764,211,,,0,0,1,,,,,,
533,764,217,533,764,217,,,0,0,0,,,,,,
533,764,224,534,764,224,,,-1,0,0,,,,,,
533,764,234,534,764,234,,,-1,0,0,,,,,,
534,765,245,534,764,245,,,0,1,0,,,,,,
534,765,259,534,764,259,,,0,1,0,,,,,,
534,765,274,534,764,273,,,0,1,1,,,,,,
534,765,290,534,764,290,,,0,1,0,,,,,,
534,765,307,534,765,307,,,0,0,0,,,,,,
534,765,326,534,765,326,,,0,0,0,,,,,,
535,765,345,535,765,345,,,0,0,0,,,,,,
535,765,365,535,765,365,,,0,0,0,,,,,,
535,766,386,535,765,386,,,0,1,0,,,,,,
535,766,407,536,765,407,,,-1,1,0,,,,,,
536,766,429,536,766,429,,,0,0,0,,,,,,
536,766,451,536,766,451,,,0,0,0,,,,,,
536,767,473,537,766,473,,,-1,1,0,,,,,,
537,767,496,537,766,496,,,0,1,0,,,,,,
537,767,519,537,767,519,,,0,0,0,,,,,,
538,767,542,538,767,542,,,0,0,0,,,,,,
538,768,566,538,768,566,,,0,0,0,,,,,,
539,768,589,539,768,589,,,0,0,0,,,,,,
539,768,613,539,768,613,,,0,0,0,,,,,,
540,769,637,540,769,637,,,0,0,0,,,,,,
540,769,661,540,769,661,,,0,0,0,,,,,,
541,770,685,541,769,685,,,0,1,0,,,,,,
542,770,710,542,770,710,,,0,0,0,,,,,,
542,771,734,542,770,734,,,0,1,0,,,,,,
543,771,759,543,771,759,,,0,0,0,,,,,,
544,772,784,544,771,783,,,0,1,1,,,,,,
546,794,216,546,793,216,,,0,1,0,,,,,,
546,794,217,546,793,216,,,0,1,1,,,,,,
546,794,219,546,793,219,,,0,1,0,,,,,,
546,794,224,546,793,225,,,0,1,-1,,,,,,
546,794,231,547,793,231,,,-1,1,0,,,,,,
546,794,240,547,793,241,,,-1,1,-1,,,,,,
546,794,252,547,793,251,,,-1,1,1,,,,,,
546,794,265,547,793,265,,,-1,1,0,,,,,,
547,794,279,547,794,279,,,0,0,0,,,,,,
547,794,295,547,794,296,,,0,0,-1,,,,,,
547,794,312,547,794,312,,,0,0,0,,,,,,
547,794,331,547,794,331,,,0,0,0,,,,,,
547,794,350,548,794,349,,,-1,0,1,,,,,,
548,795,369,548,794,369,,,0,1,0,,,,,,
548,795,390,548,794,389,,,0,1,1,,,,,,
548,795,411,548,794,411,,,0,1,0,,,,,,
548,795,432,549,795,432,,,-1,0,0,,,,,,
549,795,454,549,795,454,,,0,0,0,,,,,,
549,796,476,550,795,476,,,-1,1,0,,,,,,
549,796,499,550,796,499,,,-1,0,0,,,,,,
550,796,522,550,796,521,,,0,0,1,,,,,,
550,796,545,550,796,545,,,0,0,0,,,,,,
551,797,568,551,797,568,,,0,0,0,,,,,,
551,797,592,551,797,592,,,0,0,0,,,,,,
552,797,615,552,797,615,,,0,0,0,,,,,,
552,798,639,552,798,639,,,0,0,0,,,,,,
553,798,663,553,798,663,,,0,0,0,,,,,,
553,799,688,553,798,687,,,0,1,1,,,,,,
554,799,712,554,799,712,,,0,0,0,,,,,,
555,800,736,555,799,736,,,0,1,0,,,,,,
555,800,761,556,800,761,,,-1,0,0,,,,,,
556,800,785,556,800,785,,,0,0,0,,,,,,
559,823,224,559,822,223,,,0,1,1,,,,,,
559,823,224,559,822,223,,,0,1,1,,,,,,
559,823,227,559,822,226,,,0,1,1,,,,,,
559,823,231,559,822,232,,,0,1,-1,,,,,,
559,823,238,559,822,238,,,0,1,0,,,,,,
559,823,247,559,822,248,,,0,1,-1,,,,,,
559,823,258,560,823,258,,,-1,0,0,,,,,,
559,823,271,560,823,271,,,-1,0,0,,,,,,
559,823,285,560,823,285,,,-1,0,0,,,,,,
560,823,301,560,823,301,,,0,0,0,,,,,,
560,823,318,560,823,317,,,0,0,1,,,,,,
560,823,335,560,823,335,,,0,0,0,,,,,,
560,824,354,561,823,354,,,-1,1,0,,,,,,
560,824,374,561,823,373,,,-1,1,1,,,,,,
561,824,394,561,824,393,,,0,0,1,,,,,,
561,824,415,561,824,414,,,0,0,1,,,,,,
561,824,436,562,824,436,,,-1,0,0,,,,,,
562,825,458,562,824,457,,,0,1,1,,,,,,
562,825,480,562,824,479,,,0,1,1,,,,,,
562,825,502,562,825,502,,,0,0,0,,,,,,
563,825,525,563,825,524,,,0,0,1,,,,,,
563,826,548,563,825,547,,,0,1,1,,,,,,
564,826,571,564,826,571,,,0,0,0,,,,,,
564,826,594,564,826,594,,,0,0,0,,,,,,
565,827,618,565,826,618,,,0,1,0,,,,,,
565,827,642,565,827,641,,,0,0,1,,,,,,
566,827,666,566,827,665,,,0,0,1,,,,,,
566,828,690,566,827,689,,,0,1,1,,,,,,
567,828,714,567,828,714,,,0,0,0,,,,,,
567,829,738,567,828,738,,,0,1,0,,,,,,
568,829,763,568,829,762,,,0,0,1,,,,,,
569,829,787,569,829,787,,,0,0,0,,,,,,
572,852,231,572,852,231,,,0,0,0,,,,,,
572,852,232,572,852,231,,,0,0,1,,,,,,
572,852,234,572,852,234,,,0,0,0,,,,,,
572,852,239,572,852,240,,,0,0,-1,,,,,,
572,852,246,572,852,245,,,0,0,1,,,,,,
572,852,254,572,852,255,,,0,0,-1,,,,,,
572,852,265,573,852,264,,,-1,0,1,,,,,,
573,852,277,573,852,277,,,0,0,0,,,,,,
573,852,291,573,852,291,,,0,0,0,,,,,,
573,852,306,573,852,306,,,0,0,0,,,,,,
573,853,323,573,852,322,,,0,1,1,,,,,,
573,853,340,573,852,340,,,0,1,0,,,,,,
573,853,359,574,852,358,,,-1,1,1,,,,,,
574,853,378,574,853,378,,,0,0,0,,,,,,
574,853,398,574,853,398,,,0,0,0,,,,,,
574,853,419,574,853,418,,,0,0,1,,,,,,
574,854,440,575,853,439,,,-1,1,1,,,,,,
575,854,461,575,853,461,,,0,1,0,,,,,,
575,854,483,575,854,483,,,0,0,0,,,,,,
575,854,505,575,854,505,,,0,0,0,,,,,,
576,854,528,576,854,527,,,0,0,1,,,,,,
576,855,551,576,854,550,,,0,1,1,,,,,,
577,855,574,577,855,573,,,0,0,1,,,,,,
577,855,597,577,855,597,,,0,0,0,,,,,,
578,856,620,578,855,620,,,0,1,0,,,,,,
578,856,644,578,856,644,,,0,0,0,,,,,,
579,856,668,579,856,668,,,0,0,0,,,,,,
579,857,692,579,857,692,,,0,0,0,,,,,,
580,857,716,580,857,716,,,0,0,0,,,,,,
580,858,740,580,857,740,,,0,1,0,,,,,,
581,858,765,581,858,764,,,0,0,1,,,,,,
582,858,789,582,858,789,,,0,0,0,,,,,,
586,881,239,586,881,238,,,0,0,1,,,,,,
586,881,240,586,881,238,,,0,0,2,,,,,,
586,881,242,586,881,242,,,0,0,0,,,,,,
586,881,246,586,881,247,,,0,0,-1,,,,,,
586,881,253,586,881,252,,,0,0,1,,,,,,
586,881,261,586,881,262,,,0,0,-1,,,,,,
586,882,271,586,881,271,,,0,1,0,,,,,,
586,882,283,586,881,284,,,0,1,-1,,,,,,
586,882,297,586,881,297,,,0,1,0,,,,,,
586,882,312,586,881,312,,,0,1,0,,,,,,
586,882,328,587,882,328,,,-1,0,0,,,,,,
586,882,345,587,882,345,,,-1,0,0,,,,,,
587,882,364,587,882,363,,,0,0,1,,,,,,
587,882,383,587,882,382,,,0,0,1,,,,,,
587,882,402,588,882,402,,,-1,0,0,,,,,,
587,883,423,588,882,422,,,-1,1,1,,,,,,
588,883,443,588,883,443,,,0,0,0,,,,,,
588,883,465,588,883,465,,,0,0,0,,,,,,
588,883,486,589,883,486,,,-1,0,0,,,,,,
589,883,508,589,883,508,,,0,0,0,,,,,,
589,884,531,589,883,530,,,0,1,1,,,,,,
589,884,554,589,884,553,,,0,0,1,,,,,,
590,884,576,590,884,576,,,0,0,0,,,,,,
590,885,600,590,884,599,,,0,1,1,,,,,,
591,885,623,591,885,623,,,0,0,0,,,,,,
591,885,647,591,885,646,,,0,0,1,,,,,,
592,886,670,592,885,670,,,0,1,0,,,,,,
592,886,694,592,886,694,,,0,0,0,,,,,,
593,886,718,593,886,718,,,0,0,0,,,,,,
593,887,742,593,886,742,,,0,1,0,,,,,,
594,887,767,594,887,766,,,0,0,1,,,,,,
595,888,791,595,887,791,,,0,1,0,,,,,,
367,102,56,367,102,56,,,0,0,0,,,,,,
367,102,59,367,102,56,,,0,0,3,,,,,,
367,102,69,367,102,69,,,0,0,0,,,,,,
367,102,85,367,102,86,,,0,0,-1,,,,,,
368,102,104,368,102,104,,,0,0,0,,,,,,
368,103,125,368,102,125,,,0,1,0,,,,,,
368,103,146,368,103,146,,,0,0,0,,,,,,
368,104,169,368,104,169,,,0,0,0,,,,,,
368,105,192,368,105,192,,,0,0,0,,,,,,
368,106,215,368,106,215,,,0,0,0,,,,,,
369,107,239,369,107,239,,,0,0,0,,,,,,
369,108,263,369,108,263,,,0,0,0,,,,,,
369,110,287,369,110,287,,,0,0,0,,,,,,
370,111,311,369,111,311,,,1,0,0,,,,,,
370,113,336,370,113,336,,,0,0,0,,,,,,
371,115,360,370,115,360,,,1,0,0,,,,,,
371,117,385,371,117,385,,,0,0,0,,,,,,
372,118,410,371,119,409,,,1,-1,1,,,,,,
372,121,434,372,121,434,,,0,0,0,,,,,,
373,123,459,372,123,459,,,1,0,0,,,,,,
373,125,484,373,125,484,,,0,0,0,,,,,,
374,127,509,374,127,509,,,0,0,0,,,,,,
375,130,534,375,130,534,,,0,0,0,,,,,,
375,132,559,375,132,559,,,0,0,0,,,,,,
376,135,585,376,135,585,,,0,0,0,,,,,,
377,138,610,377,137,610,,,0,1,0,,,,,,
378,140,635,378,140,635,,,0,0,0,,,,,,
379,143,660,379,143,660,,,0,0,0,,,,,,
380,146,686,380,146,686,,,0,0,0,,,,,,
381,149,711,381,149,711,,,0,0,0,,,,,,
382,152,737,382,152,737,,,0,0,0,,,,,,
383,155,762,383,155,762,,,0,0,0,,,,,,
368,104,56,367,102,56,,,1,2,0,,,,,,
368,104,59,367,102,56,,,1,2,3,,,,,,
368,104,69,367,102,69,,,1,2,0,,,,,,
368,104,85,367,102,86,,,1,2,-1,,,,,,
368,105,104,368,102,104,,,0,3,0,,,,,,
368,105,125,368,102,125,,,0,3,0,,,,,,
368,106,147,368,103,146,,,0,3,1,,,,,,
368,106,169,368,104,169,,,0,2,0,,,,,,
368,107,192,368,105,192,,,0,2,0,,,,,,
369,108,216,368,106,215,,,1,2,1,,,,,,
369,109,239,369,107,239,,,0,2,0,,,,,,
369,110,263,369,108,263,,,0,2,0,,,,,,
369,112,287,369,110,287,,,0,2,0,,,,,,
370,113,311,369,111,311,,,1,2,0,,,,,,
370,115,336,370,113,336,,,0,2,0,,,,,,
371,117,360,370,115,360,,,1,2,0,,,,,,
371,118,385,371,117,385,,,0,1,0,,,,,,
372,120,410,371,119,409,,,1,1,1,,,,,,
372,122,435,372,121,434,,,0,1,1,,,,,,
373,124,459,372,123,459,,,1,1,0,,,,,,
373,127,484,373,125,484,,,0,2,0,,,,,,
374,129,509,374,127,509,,,0,2,0,,,,,,
375,131,534,375,130,534,,,0,1,0,,,,,,
376,134,559,375,132,559,,,1,2,0,,,,,,
376,136,585,376,135,585,,,0,1,0,,,,,,
377,139,610,377,137,610,,,0,2,0,,,,,,
378,142,635,378,140,635,,,0,2,0,,,,,,
379,145,660,379,143,660,,,0,2,0,,,,,,
380,147,686,380,146,686,,,0,1,0,,,,,,
381,150,711,381,149,711,,,0,1,0,,,,,,
382,153,737,382,152,737,,,0,1,0,,,,,,
383,156,762,383,155,762,,,0,1,0,,,,,,
368,112,57,368,112,57,,,0,0,0,,,,,,
368,112,60,368,112,57,,,0,0,3,,,,,,
368,112,70,368,112,70,,,0,0,0,,,,,,
368,112,86,368,112,87,,,0,0,-1,,,,,,
368,112,105,368,112,105,,,0,0,0,,,,,,
368,113,125,368,112,126,,,0,1,-1,,,,,,
369,113,147,369,113,147,,,0,0,0,,,,,,
369,114,169,369,114,169,,,0,0,0,,,,,,
369,115,192,369,115,192,,,0,0,0,,,,,,
369,116,216,369,116,215,,,0,0,1,,,,,,
369,117,239,369,117,239,,,0,0,0,,,,,,
370,118,263,369,118,263,,,1,0,0,,,,,,
370,119,287,370,119,287,,,0,0,0,,,,,,
370,121,312,370,120,311,,,0,1,1,,,,,,
371,122,336,371,122,336,,,0,0,0,,,,,,
371,124,361,371,123,360,,,0,1,1,,,,,,
372,125,385,372,125,385,,,0,0,0,,,,,,
372,127,410,372,127,410,,,0,0,0,,,,,,
373,129,435,373,129,435,,,0,0,0,,,,,,
373,131,459,373,131,459,,,0,0,0,,,,,,
374,133,484,374,133,484,,,0,0,0,,,,,,
375,135,509,374,135,509,,,1,0,0,,,,,,
375,138,534,375,138,534,,,0,0,0,,,,,,
376,140,560,376,140,559,,,0,0,1,,,,,,
377,142,585,377,142,585,,,0,0,0,,,,,,
378,145,610,378,145,610,,,0,0,0,,,,,,
379,148,635,379,148,635,,,0,0,0,,,,,,
379,150,661,379,150,660,,,0,0,1,,,,,,
380,153,686,380,153,686,,,0,0,0,,,,,,
381,156,711,381,156,711,,,0,0,0,,,,,,
382,159,737,382,159,737,,,0,0,0,,,,,,
383,161,762,383,161,762,,,0,0,0,,,,,,
369,125,59,369,127,59,,,0,-2,0,,,,,,
369,125,62,369,127,59,,,0,-2,3,,,,,,
369,125,72,369,127,72,,,0,-2,0,,,,,,
369,125,87,369,127,89,,,0,-2,-2,,,,,,
369,126,105,369,127,106,,,0,-1,-1,,,,,,
369,126,126,369,128,126,,,0,-2,0,,,,,,
370,126,148,370,128,147,,,0,-2,1,,,,,,
370,127,170,370,129,170,,,0,-2,0,,,,,,
370,128,193,370,130,193,,,0,-2,0,,,,,,
370,129,216,370,130,216,,,0,-1,0,,,,,,
370,129,240,370,131,239,,,0,-2,1,,,,,,
371,130,264,371,132,263,,,0,-2,1,,,,,,
371,132,288,371,133,287,,,0,-1,1,,,,,,
371,133,312,371,134,312,,,0,-1,0,,,,,,
372,134,336,372,136,336,,,0,-2,0,,,,,,
372,136,361,372,137,361,,,0,-1,0,,,,,,
373,137,385,373,139,385,,,0,-2,0,,,,,,
373,139,410,373,140,410,,,0,-1,0,,,,,,
374,140,435,374,142,435,,,0,-2,0,,,,,,
374,142,460,374,144,459,,,0,-2,1,,,,,,
375,144,485,375,146,484,,,0,-2,1,,,,,,
376,146,510,376,148,509,,,0,-2,1,,,,,,
376,148,535,376,150,534,,,0,-2,1,,,,,,
377,151,560,377,152,559,,,0,-1,1,,,,,,
378,153,585,378,154,585,,,0,-1,0,,,,,,
379,155,610,379,157,610,,,0,-2,0,,,,,,
380,158,635,380,159,635,,,0,-1,0,,,,,,
381,160,661,380,162,660,,,1,-2,1,,,,,,
381,163,686,381,164,686,,,0,-1,0,,,,,,
382,165,711,382,167,711,,,0,-2,0,,,,,,
383,168,737,383,170,737,,,0,-2,0,,,,,,
384,171,762,384,172,762,,,0,-1,0,,,,,,
371,142,61,371,142,61,,,0,0,0,,,,,,
371,142,64,371,142,61,,,0,0,3,,,,,,
371,142,74,371,142,74,,,0,0,0,,,,,,
371,143,89,371,142,90,,,0,1,-1,,,,,,
371,143,107,371,143,107,,,0,0,0,,,,,,
371,143,127,371,143,127,,,0,0,0,,,,,,
371,144,148,371,144,148,,,0,0,0,,,,,,
371,144,171,371,144,171,,,0,0,0,,,,,,
372,145,194,372,145,194,,,0,0,0,,,,,,
372,145,217,372,145,217,,,0,0,0,,,,,,
372,146,240,372,146,240,,,0,0,0,,,,,,
372,147,264,372,147,264,,,0,0,0,,,,,,
373,148,288,373,148,288,,,0,0,0,,,,,,
373,149,312,373,149,312,,,0,0,0,,,,,,
373,150,337,373,150,337,,,0,0,0,,,,,,
374,152,361,373,151,361,,,1,1,0,,,,,,
374,153,386,374,153,386,,,0,0,0,,,,,,
375,154,410,374,154,410,,,1,0,0,,,,,,
375,156,435,375,156,435,,,0,0,0,,,,,,
376,158,460,376,157,460,,,0,1,0,,,,,,
377,159,485,377,159,485,,,0,0,0,,,,,,
377,161,510,377,161,510,,,0,0,0,,,,,,
378,163,535,378,163,535,,,0,0,0,,,,,,
379,165,560,379,165,560,,,0,0,0,,,,,,
380,167,585,380,167,585,,,0,0,0,,,,,,
380,169,610,380,169,610,,,0,0,0,,,,,,
381,171,636,381,171,636,,,0,0,0,,,,,,
382,174,661,382,173,661,,,0,1,0,,,,,,
383,176,686,383,176,686,,,0,0,0,,,,,,
384,178,712,384,178,711,,,0,0,1,,,,,,
385,181,737,385,181,737,,,0,0,0,,,,,,
386,183,763,386,183,762,,,0,0,1,,,,,,
373,163,65,373,163,65,,,0,0,0,,,,,,
373,163,67,373,163,65,,,0,0,2,,,,,,
373,163,77,373,163,77,,,0,0,0,,,,,,
373,163,91,373,163,93,,,0,0,-2,,,,,,
373,163,109,373,164,109,,,0,-1,0,,,,,,
373,163,129,373,164,129,,,0,-1,0,,,,,,
373,164,150,373,165,149,,,0,-1,1,,,,,,
374,164,172,374,165,172,,,0,-1,0,,,,,,
374,165,195,374,166,195,,,0,-1,0,,,,,,
374,165,218,374,166,218,,,0,-1,0,,,,,,
374,166,241,374,167,241,,,0,-1,0,,,,,,
375,167,265,375,167,265,,,0,0,0,,,,,,
375,168,289,375,168,289,,,0,0,0,,,,,,
375,169,313,375,169,313,,,0,0,0,,,,,,
376,170,337,375,170,337,,,1,0,0,,,,,,
376,171,362,376,171,362,,,0,0,0,,,,,,
377,172,386,376,173,386,,,1,-1,0,,,,,,
377,173,411,377,174,411,,,0,-1,0,,,,,,
378,175,435,377,175,435,,,1,0,0,,,,,,
378,176,460,378,177,460,,,0,-1,0,,,,,,
379,178,485,379,178,485,,,0,0,0,,,,,,
379,179,510,380,180,510,,,-1,-1,0,,,,,,
380,181,535,380,182,535,,,0,-1,0,,,,,,
381,183,560,381,183,560,,,0,0,0,,,,,,
382,184,585,382,185,585,,,0,-1,0,,,,,,
382,186,611,382,187,610,,,0,-1,1,,,,,,
383,188,636,383,189,636,,,0,-1,0,,,,,,
384,190,661,384,191,661,,,0,-1,0,,,,,,
385,192,686,385,193,686,,,0,-1,0,,,,,,
386,195,712,386,195,712,,,0,0,0,,,,,,
387,197,737,387,198,737,,,0,-1,0,,,,,,
388,199,763,388,200,762,,,0,-1,1,,,,,,
376,185,69,376,185,69,,,0,0,0,,,,,,
376,185,71,376,185,69,,,0,0,2,,,,,,
376,185,80,376,185,80,,,0,0,0,,,,,,
376,185,94,376,185,95,,,0,0,-1,,,,,,
376,185,111,376,185,111,,,0,0,0,,,,,,
376,186,130,376,185,131,,,0,1,-1,,,,,,
376,186,151,376,186,151,,,0,0,0,,,,,,
376,186,173,376,186,173,,,0,0,0,,,,,,
377,187,196,377,187,196,,,0,0,0,,,,,,
377,187,219,377,187,219,,,0,0,0,,,,,,
377,188,242,377,188,242,,,0,0,0,,,,,,
377,189,266,377,188,266,,,0,1,0,,,,,,
378,189,290,378,189,290,,,0,0,0,,,,,,
378,190,314,378,190,314,,,0,0,0,,,,,,
378,191,338,378,191,338,,,0,0,0,,,,,,
379,192,362,378,192,362,,,1,0,0,,,,,,
379,193,387,379,193,387,,,0,0,0,,,,,,
380,194,411,379,194,411,,,1,0,0,,,,,,
380,195,436,380,195,436,,,0,0,0,,,,,,
381,197,461,381,196,461,,,0,1,0,,,,,,
382,198,486,382,198,486,,,0,0,0,,,,,,
382,199,511,382,199,511,,,0,0,0,,,,,,
383,201,536,383,201,536,,,0,0,0,,,,,,
384,203,561,383,202,561,,,1,1,0,,,,,,
384,204,586,384,204,586,,,0,0,0,,,,,,
385,206,611,385,206,611,,,0,0,0,,,,,,
386,208,636,386,208,636,,,0,0,0,,,,,,
387,209,661,387,209,661,,,0,0,0,,,,,,
388,211,687,388,211,687,,,0,0,0,,,,,,
389,213,712,389,213,712,,,0,0,0,,,,,,
390,215,738,390,215,738,,,0,0,0,,,,,,
391,217,763,391,217,763,,,0,0,0,,,,,,
379,209,73,379,209,73,,,0,0,0,,,,,,
379,209,76,379,209,73,,,0,0,3,,,,,,
379,209,84,379,209,84,,,0,0,0,,,,,,
379,209,97,379,209,99,,,0,0,-2,,,,,,
379,209,114,379,209,114,,,0,0,0,,,,,,
379,209,133,379,209,133,,,0,0,0,,,,,,
380,210,153,379,210,153,,,1,0,0,,,,,,
380,210,175,380,210,175,,,0,0,0,,,,,,
380,210,197,380,211,197,,,0,-1,0,,,,,,
380,211,220,380,211,220,,,0,0,0,,,,,,
380,211,243,380,212,243,,,0,-1,0,,,,,,
381,212,267,381,212,267,,,0,0,0,,,,,,
381,213,290,381,213,291,,,0,0,-1,,,,,,
381,213,314,381,213,315,,,0,0,-1,,,,,,
382,214,339,382,214,339,,,0,0,0,,,,,,
382,215,363,382,215,363,,,0,0,0,,,,,,
383,216,387,383,216,387,,,0,0,0,,,,,,
383,217,412,383,217,412,,,0,0,0,,,,,,
384,218,437,384,218,436,,,0,0,1,,,,,,
384,219,461,384,219,461,,,0,0,0,,,,,,
385,220,486,385,221,486,,,0,-1,0,,,,,,
385,222,511,386,222,511,,,-1,0,0,,,,,,
386,223,536,386,223,536,,,0,0,0,,,,,,
387,224,561,387,225,561,,,0,-1,0,,,,,,
388,226,586,387,226,586,,,1,0,0,,,,,,
388,227,611,388,228,611,,,0,-1,0,,,,,,
389,229,637,389,230,636,,,0,-1,1,,,,,,
390,230,662,390,231,662,,,0,-1,0,,,,,,
391,232,687,391,233,687,,,0,-1,0,,,,,,
392,234,712,392,234,712,,,0,0,0,,,,,,
393,236,738,393,236,738,,,0,0,0,,,,,,
394,238,763,394,238,763,,,0,0,0,,,,,,
383,234,78,383,234,78,,,0,0,0,,,,,,
383,234,80,383,234,78,,,0,0,2,,,,,,
383,234,88,383,234,88,,,0,0,0,,,,,,
383,234,101,383,234,102,,,0,0,-1,,,,,,
383,234,117,383,234,117,,,0,0,0,,,,,,
383,234,135,383,234,136,,,0,0,-1,,,,,,
383,234,156,383,234,156,,,0,0,0,,,,,,
384,235,177,383,234,177,,,1,1,0,,,,,,
384,235,199,384,235,199,,,0,0,0,,,,,,
384,235,222,384,235,222,,,0,0,0,,,,,,
384,236,245,384,236,245,,,0,0,0,,,,,,
385,236,268,384,236,268,,,1,0,0,,,,,,
385,237,292,385,237,292,,,0,0,0,,,,,,
385,238,316,385,237,316,,,0,1,0,,,,,,
386,238,340,386,238,340,,,0,0,0,,,,,,
386,239,364,386,239,364,,,0,0,0,,,,,,
387,240,388,387,240,388,,,0,0,0,,,,,,
387,241,413,387,241,412,,,0,0,1,,,,,,
388,242,437,388,242,437,,,0,0,0,,,,,,
388,243,462,388,243,462,,,0,0,0,,,,,,
389,244,487,389,244,487,,,0,0,0,,,,,,
389,245,512,389,245,512,,,0,0,0,,,,,,
390,246,537,390,246,537,,,0,0,0,,,,,,
391,247,562,390,247,562,,,1,0,0,,,,,,
391,249,587,391,249,587,,,0,0,0,,,,,,
392,250,612,392,250,612,,,0,0,0,,,,,,
393,252,637,393,252,637,,,0,0,0,,,,,,
394,253,662,394,253,662,,,0,0,0,,,,,,
395,255,688,395,255,688,,,0,0,0,,,,,,
396,256,713,396,256,713,,,0,0,0,,,,,,
397,258,738,397,258,738,,,0,0,0,,,,,,
398,259,764,398,259,763,,,0,0,1,,,,,,
388,259,84,388,260,83,,,0,-1,1,,,,,,
388,259,86,388,260,83,,,0,-1,3,,,,,,
388,259,93,388,260,93,,,0,-1,0,,,,,,
388,259,105,388,260,106,,,0,-1,-1,,,,,,
388,260,120,388,260,120,,,0,0,0,,,,,,
388,260,138,388,260,139,,,0,0,-1,,,,,,
388,260,158,388,260,158,,,0,0,0,,,,,,
388,260,179,388,260,179,,,0,0,0,,,,,,
388,261,201,388,261,201,,,0,0,0,,,,,,
389,261,223,388,261,223,,,1,0,0,,,,,,
389,261,246,389,261,246,,,0,0,0,,,,,,
389,262,269,389,262,269,,,0,0,0,,,,,,
389,262,293,389,262,293,,,0,0,0,,,,,,
390,263,317,390,263,317,,,0,0,0,,,,,,
390,264,341,390,263,341,,,0,1,0,,,,,,
391,264,365,391,264,365,,,0,0,0,,,,,,
391,265,389,391,265,389,,,0,0,0,,,,,,
391,266,414,392,266,413,,,-1,0,1,,,,,,
392,267,438,392,267,438,,,0,0,0,,,,,,
393,267,463,393,268,462,,,0,-1,1,,,,,,
393,268,488,393,269,487,,,0,-1,1,,,,,,
394,269,512,394,270,512,,,0,-1,0,,,,,,
394,271,537,394,271,537,,,0,0,0,,,,,,
395,272,562,395,272,562,,,0,0,0,,,,,,
396,273,587,396,273,587,,,0,0,0,,,,,,
397,274,612,396,274,612,,,1,0,0,,,,,,
397,275,638,397,276,637,,,0,-1,1,,,,,,
398,277,663,398,277,663,,,0,0,0,,,,,,
399,278,688,399,278,688,,,0,0,0,,,,,,
400,279,713,400,280,713,,,0,-1,0,,,,,,
401,281,739,401,281,738,,,0,0,1,,,,,,
402,283,764,402,283,764,,,0,0,0,,,,,,
393,286,89,393,286,89,,,0,0,0,,,,,,
393,286,91,393,286,89,,,0,0,2,,,,,,
393,286,98,393,286,98,,,0,0,0,,,,,,
393,286,109,393,286,111,,,0,0,-2,,,,,,
393,286,124,393,286,124,,,0,0,0,,,,,,
393,286,142,393,286,142,,,0,0,0,,,,,,
393,286,161,393,286,161,,,0,0,0,,,,,,
393,286,182,393,286,182,,,0,0,0,,,,,,
393,287,203,393,287,203,,,0,0,0,,,,,,
394,287,225,393,287,225,,,1,0,0,,,,,,
394,287,248,394,287,248,,,0,0,0,,,,,,
394,288,271,394,287,271,,,0,1,0,,,,,,
394,288,294,394,288,294,,,0,0,0,,,,,,
395,289,318,394,288,318,,,1,1,0,,,,,,
395,289,342,395,289,342,,,0,0,0,,,,,,
396,290,366,395,290,366,,,1,0,0,,,,,,
396,291,390,396,291,390,,,0,0,0,,,,,,
397,291,415,396,291,414,,,1,0,1,,,,,,
397,292,439,397,292,439,,,0,0,0,,,,,,
398,293,464,397,293,463,,,1,0,1,,,,,,
398,294,488,398,294,488,,,0,0,0,,,,,,
399,295,513,398,295,513,,,1,0,0,,,,,,
399,296,538,399,296,538,,,0,0,0,,,,,,
400,297,563,400,297,563,,,0,0,0,,,,,,
401,298,588,401,298,588,,,0,0,0,,,,,,
402,299,613,401,299,613,,,1,0,0,,,,,,
402,300,638,402,300,638,,,0,0,0,,,,,,
403,301,663,403,301,663,,,0,0,0,,,,,,
404,302,689,404,302,689,,,0,0,0,,,,,,
405,304,714,405,303,714,,,0,1,0,,,,,,
406,305,739,406,305,739,,,0,0,0,,,,,,
407,307,765,407,306,764,,,0,1,1,,,,,,
398,312,96,399,312,95,,,-1,0,1,,,,,,
398,312,97,399,312,95,,,-1,0,2,,,,,,
398,312,104,399,312,103,,,-1,0,1,,,,,,
398,312,114,399,312,116,,,-1,0,-2,,,,,,
398,312,129,399,312,128,,,-1,0,1,,,,,,
399,313,146,399,312,146,,,0,1,0,,,,,,
399,313,164,399,313,164,,,0,0,0,,,,,,
399,313,184,399,313,185,,,0,0,-1,,,,,,
399,313,206,399,313,205,,,0,0,1,,,,,,
399,313,228,399,313,227,,,0,0,1,,,,,,
400,314,250,400,314,250,,,0,0,0,,,,,,
400,314,273,400,314,273,,,0,0,0,,,,,,
400,315,296,400,314,296,,,0,1,0,,,,,,
400,315,320,400,315,319,,,0,0,1,,,,,,
401,316,343,401,315,343,,,0,1,0,,,,,,
401,316,367,401,316,367,,,0,0,0,,,,,,
402,317,391,402,317,391,,,0,0,0,,,,,,
402,317,416,402,317,415,,,0,0,1,,,,,,
403,318,440,403,318,440,,,0,0,0,,,,,,
403,319,465,403,319,464,,,0,0,1,,,,,,
404,320,489,404,320,489,,,0,0,0,,,,,,
404,320,514,404,321,514,,,0,-1,0,,,,,,
405,321,539,405,322,539,,,0,-1,0,,,,,,
406,322,564,405,322,564,,,1,0,0,,,,,,
406,323,589,406,323,589,,,0,0,0,,,,,,
407,324,614,407,324,614,,,0,0,0,,,,,,
408,325,639,408,325,639,,,0,0,0,,,,,,
409,326,664,409,326,664,,,0,0,0,,,,,,
410,328,689,410,327,689,,,0,1,0,,,,,,
410,329,715,410,329,714,,,0,0,1,,,,,,
411,330,740,411,330,740,,,0,0,0,,,,,,
412,331,765,412,331,765,,,0,0,0,,,,,,
405,339,102,405,339,102,,,0,0,0,,,,,,
405,339,103,405,339,102,,,0,0,1,,,,,,
405,339,109,405,339,109,,,0,0,0,,,,,,
405,339,120,405,339,121,,,0,0,-1,,,,,,
405,339,133,405,339,133,,,0,0,0,,,,,,
405,340,150,405,339,150,,,0,1,0,,,,,,
405,340,168,405,340,168,,,0,0,0,,,,,,
405,340,188,405,340,188,,,0,0,0,,,,,,
405,340,208,405,340,208,,,0,0,0,,,,,,
405,340,230,405,340,230,,,0,0,0,,,,,,
406,341,252,406,341,252,,,0,0,0,,,,,,
406,341,275,406,341,275,,,0,0,0,,,,,,
406,341,298,406,341,298,,,0,0,0,,,,,,
407,342,321,406,341,321,,,1,1,0,,,,,,
407,342,345,407,342,345,,,0,0,0,,,,,,
407,343,369,407,342,369,,,0,1,0,,,,,,
408,343,393,408,343,393,,,0,0,0,,,,,,
408,344,417,408,344,417,,,0,0,0,,,,,,
409,345,441,409,345,441,,,0,0,0,,,,,,
409,345,466,409,345,465,,,0,0,1,,,,,,
410,346,490,410,346,490,,,0,0,0,,,,,,
410,347,515,410,347,515,,,0,0,0,,,,,,
411,348,540,411,348,540,,,0,0,0,,,,,,
412,348,565,411,348,565,,,1,0,0,,,,,,
412,349,590,412,349,590,,,0,0,0,,,,,,
413,350,615,413,350,615,,,0,0,0,,,,,,
414,351,640,414,351,640,,,0,0,0,,,,,,
415,352,665,415,352,665,,,0,0,0,,,,,,
416,353,690,416,353,690,,,0,0,0,,,,,,
416,354,715,416,354,715,,,0,0,0,,,,,,
417,356,741,417,356,741,,,0,0,0,,,,,,
418,357,766,418,357,766,,,0,0,0,,,,,,
411,367,108,412,366,108,,,-1,1,0,,,,,,
411,367,110,412,366,108,,,-1,1,2,,,,,,
411,367,115,412,366,115,,,-1,1,0,,,,,,
411,367,125,412,366,126,,,-1,1,-1,,,,,,
411,367,138,412,366,138,,,-1,1,0,,,,,,
412,367,154,412,367,155,,,0,0,-1,,,,,,
412,367,172,412,367,172,,,0,0,0,,,,,,
412,367,191,412,367,191,,,0,0,0,,,,,,
412,367,211,412,367,211,,,0,0,0,,,,,,
412,368,233,412,367,233,,,0,1,0,,,,,,
412,368,255,413,368,254,,,-1,0,1,,,,,,
413,368,277,413,368,277,,,0,0,0,,,,,,
413,369,300,413,368,300,,,0,1,0,,,,,,
413,369,323,413,369,323,,,0,0,0,,,,,,
414,369,347,414,369,346,,,0,0,1,,,,,,
414,370,370,414,370,370,,,0,0,0,,,,,,
414,370,394,415,370,394,,,-1,0,0,,,,,,
415,371,418,415,371,418,,,0,0,0,,,,,,
415,371,443,416,372,442,,,-1,-1,1,,,,,,
416,372,467,416,372,467,,,0,0,0,,,,,,
417,373,492,417,373,491,,,0,0,1,,,,,,
417,373,516,417,373,516,,,0,0,0,,,,,,
418,374,541,418,374,541,,,0,0,0,,,,,,
418,375,566,418,375,566,,,0,0,0,,,,,,
419,376,591,419,376,591,,,0,0,0,,,,,,
420,377,615,420,376,615,,,0,1,0,,,,,,
421,378,641,421,377,640,,,0,1,1,,,,,,
421,379,666,421,378,665,,,0,1,1,,,,,,
422,380,691,422,379,691,,,0,1,0,,,,,,
423,381,716,423,380,716,,,0,1,0,,,,,,
424,382,741,424,382,741,,,0,0,0,,,,,,
425,383,767,425,383,766,,,0,0,1,,,,,,
419,394,115,419,394,115,,,0,0,0,,,,,,
419,394,116,419,394,115,,,0,0,1,,,,,,
419,394,122,419,394,122,,,0,0,0,,,,,,
419,394,131,419,394,132,,,0,0,-1,,,,,,
419,394,143,419,394,143,,,0,0,0,,,,,,
419,394,158,419,394,159,,,0,0,-1,,,,,,
419,395,176,419,395,176,,,0,0,0,,,,,,
419,395,195,419,395,195,,,0,0,0,,,,,,
419,395,215,419,395,215,,,0,0,0,,,,,,
419,395,236,419,395,236,,,0,0,0,,,,,,
420,395,257,420,395,257,,,0,0,0,,,,,,
420,396,279,420,395,279,,,0,1,0,,,,,,
420,396,302,420,396,302,,,0,0,0,,,,,,
421,396,325,420,396,325,,,1,0,0,,,,,,
421,397,348,421,397,348,,,0,0,0,,,,,,
421,397,372,421,397,372,,,0,0,0,,,,,,
422,398,396,422,398,396,,,0,0,0,,,,,,
422,398,420,422,398,420,,,0,0,0,,,,,,
423,399,444,423,399,444,,,0,0,0,,,,,,
423,399,468,423,399,468,,,0,0,0,,,,,,
424,400,493,424,400,493,,,0,0,0,,,,,,
424,401,517,424,400,517,,,0,1,0,,,,,,
425,401,542,425,401,542,,,0,0,0,,,,,,
426,402,567,425,402,567,,,1,0,0,,,,,,
426,403,592,426,403,592,,,0,0,0,,,,,,
427,403,616,427,403,616,,,0,0,0,,,,,,
428,404,641,428,404,641,,,0,0,0,,,,,,
428,405,667,428,405,666,,,0,0,1,,,,,,
429,406,692,429,406,692,,,0,0,0,,,,,,
430,407,717,430,407,717,,,0,0,0,,,,,,
431,408,742,431,408,742,,,0,0,0,,,,,,
432,409,767,432,409,767,,,0,0,0,,,,,,
426,422,122,427,422,122,,,-1,0,0,,,,,,
426,422,123,427,422,122,,,-1,0,1,,,,,,
426,422,128,427,422,128,,,-1,0,0,,,,,,
426,422,137,427,422,138,,,-1,0,-1,,,,,,
426,422,149,427,422,148,,,-1,0,1,,,,,,
427,422,163,427,422,164,,,0,0,-1,,,,,,
427,422,180,427,422,180,,,0,0,0,,,,,,
427,422,198,427,422,199,,,0,0,-1,,,,,,
427,423,218,427,423,218,,,0,0,0,,,,,,
427,423,239,427,423,239,,,0,0,0,,,,,,
427,423,260,428,423,260,,,-1,0,0,,,,,,
428,423,282,428,423,282,,,0,0,0,,,,,,
428,424,304,428,423,304,,,0,1,0,,,,,,
428,424,327,428,424,327,,,0,0,0,,,,,,
429,424,351,429,424,350,,,0,0,1,,,,,,
429,425,374,429,425,374,,,0,0,0,,,,,,
429,425,398,430,425,398,,,-1,0,0,,,,,,
430,426,422,430,426,421,,,0,0,1,,,,,,
430,426,446,430,426,445,,,0,0,1,,,,,,
431,427,470,431,427,470,,,0,0,0,,,,,,
431,427,494,431,427,494,,,0,0,0,,,,,,
432,428,519,432,428,519,,,0,0,0,,,,,,
432,428,543,433,428,543,,,-1,0,0,,,,,,
433,429,568,433,429,568,,,0,0,0,,,,,,
434,430,593,434,430,593,,,0,0,0,,,,,,
434,431,618,434,430,617,,,0,1,1,,,,,,
435,431,642,435,431,642,,,0,0,0,,,,,,
436,432,667,436,432,667,,,0,0,0,,,,,,
437,433,693,437,433,693,,,0,0,0,,,,,,
438,434,718,437,434,718,,,1,0,0,,,,,,
438,435,743,438,435,743,,,0,0,0,,,,,,
439,436,768,439,436,768,,,0,0,0,,,,,,
435,450,129,435,450,129,,,0,0,0,,,,,,
435,450,130,435,450,129,,,0,0,1,,,,,,
435,450,134,435,450,134,,,0,0,0,,,,,,
435,450,143,435,450,144,,,0,0,-1,,,,,,
435,450,154,435,450,154,,,0,0,0,,,,,,
435,450,168,435,450,169,,,0,0,-1,,,,,,
435,450,185,435,450,185,,,0,0,0,,,,,,
435,450,202,435,450,203,,,0,0,-1,,,,,,
435,451,222,435,451,222,,,0,0,0,,,,,,
435,451,242,435,451,242,,,0,0,0,,,,,,
436,451,263,436,451,263,,,0,0,0,,,,,,
436,451,285,436,451,285,,,0,0,0,,,,,,
436,451,307,436,451,307,,,0,0,0,,,,,,
436,452,330,436,451,330,,,0,1,0,,,,,,
437,452,353,437,452,353,,,0,0,0,,,,,,
437,453,376,437,452,376,,,0,1,0,,,,,,
438,453,400,438,453,400,,,0,0,0,,,,,,
438,453,423,438,453,423,,,0,0,0,,,,,,
438,454,447,438,454,447,,,0,0,0,,,,,,
439,454,471,438,454,471,,,1,0,0,,,,,,
439,455,496,439,455,496,,,0,0,0,,,,,,
440,455,520,440,455,520,,,0,0,0,,,,,,
441,456,545,441,456,545,,,0,0,0,,,,,,
441,457,569,441,456,569,,,0,1,0,,,,,,
442,457,594,442,457,594,,,0,0,0,,,,,,
443,458,619,442,458,619,,,1,0,0,,,,,,
443,459,644,443,459,644,,,0,0,0,,,,,,
444,459,669,444,459,669,,,0,0,0,,,,,,
445,460,694,445,460,694,,,0,0,0,,,,,,
446,461,719,445,461,719,,,1,0,0,,,,,,
446,462,744,446,462,744,,,0,0,0,,,,,,
447,463,769,447,463,769,,,0,0,0,,,,,,
443,478,136,443,478,136,,,0,0,0,,,,,,
443,478,137,443,478,136,,,0,0,1,,,,,,
443,478,141,443,478,141,,,0,0,0,,,,,,
443,478,149,443,478,150,,,0,0,-1,,,,,,
443,478,160,443,478,160,,,0,0,0,,,,,,
443,478,174,443,478,174,,,0,0,0,,,,,,
444,478,189,444,478,189,,,0,0,0,,,,,,
444,478,207,444,478,207,,,0,0,0,,,,,,
444,479,226,444,479,226,,,0,0,0,,,,,,
444,479,246,444,479,246,,,0,0,0,,,,,,
444,479,266,444,479,266,,,0,0,0,,,,,,
445,479,288,444,479,288,,,1,0,0,,,,,,
445,479,310,445,479,310,,,0,0,0,,,,,,
445,480,332,445,479,332,,,0,1,0,,,,,,
445,480,355,445,480,355,,,0,0,0,,,,,,
446,480,378,446,480,378,,,0,0,0,,,,,,
446,481,402,446,481,402,,,0,0,0,,,,,,
447,481,425,446,481,425,,,1,0,0,,,,,,
447,482,449,447,482,449,,,0,0,0,,,,,,
448,482,473,447,482,473,,,1,0,0,,,,,,
448,483,497,448,483,497,,,0,0,0,,,,,,
449,483,522,448,483,522,,,1,0,0,,,,,,
449,484,546,449,484,546,,,0,0,0,,,,,,
450,484,571,450,484,571,,,0,0,0,,,,,,
450,485,595,450,485,595,,,0,0,0,,,,,,
451,486,620,451,485,620,,,0,1,0,,,,,,
452,486,645,452,486,645,,,0,0,0,,,,,,
452,487,670,452,487,670,,,0,0,0,,,,,,
453,488,695,453,487,695,,,0,1,0,,,,,,
454,488,720,454,488,720,,,0,0,0,,,,,,
455,489,745,455,489,745,,,0,0,0,,,,,,
456,490,770,455,490,770,,,1,0,0,,,,,,
452,506,143,452,506,143,,,0,0,0,,,,,,
452,506,144,452,506,143,,,0,0,1,,,,,,
452,506,148,452,506,148,,,0,0,0,,,,,,
452,506,155,452,506,157,,,0,0,-2,,,,,,
452,506,166,452,506,166,,,0,0,0,,,,,,
453,506,179,452,506,180,,,1,0,-1,,,,,,
453,507,194,453,507,194,,,0,0,0,,,,,,
453,507,211,453,507,212,,,0,0,-1,,,,,,
453,507,230,453,507,230,,,0,0,0,,,,,,
453,507,249,453,507,250,,,0,0,-1,,,,,,
453,507,270,453,507,270,,,0,0,0,,,,,,
454,507,291,453,507,291,,,1,0,0,,,,,,
454,508,313,454,508,313,,,0,0,0,,,,,,
454,508,335,454,508,335,,,0,0,0,,,,,,
454,508,358,454,508,358,,,0,0,0,,,,,,
455,509,380,454,508,381,,,1,1,-1,,,,,,
455,509,404,455,509,404,,,0,0,0,,,,,,
456,509,427,455,509,427,,,1,0,0,,,,,,
456,510,451,456,510,451,,,0,0,0,,,,,,
457,510,475,456,510,475,,,1,0,0,,,,,,
457,511,499,457,511,499,,,0,0,0,,,,,,
458,511,523,457,511,523,,,1,0,0,,,,,,
458,512,548,458,512,548,,,0,0,0,,,,,,
459,512,572,458,512,572,,,1,0,0,,,,,,
459,513,597,459,513,597,,,0,0,0,,,,,,
460,513,621,460,513,621,,,0,0,0,,,,,,
461,514,646,461,514,646,,,0,0,0,,,,,,
461,515,671,461,514,671,,,0,1,0,,,,,,
462,515,696,462,515,696,,,0,0,0,,,,,,
463,516,721,463,516,721,,,0,0,0,,,,,,
464,517,746,464,517,746,,,0,0,0,,,,,,
465,518,771,464,517,771,,,1,1,0,,,,,,
462,535,150,462,534,150,,,0,1,0,,,,,,
462,535,151,462,534,150,,,0,1,1,,,,,,
462,535,155,462,534,155,,,0,1,0,,,,,,
462,535,162,462,534,163,,,0,1,-1,,,,,,
462,535,172,462,534,172,,,0,1,0,,,,,,
462,535,185,462,534,185,,,0,1,0,,,,,,
462,535,199,462,535,199,,,0,0,0,,,,,,
462,535,216,462,535,216,,,0,0,0,,,,,,
462,535,234,462,535,234,,,0,0,0,,,,,,
463,535,253,462,535,253,,,1,0,0,,,,,,
463,536,273,463,535,273,,,0,1,0,,,,,,
463,536,294,463,535,294,,,0,1,0,,,,,,
463,536,316,463,536,316,,,0,0,0,,,,,,
464,536,338,463,536,338,,,1,0,0,,,,,,
464,537,360,464,536,360,,,0,1,0,,,,,,
464,537,383,464,537,383,,,0,0,0,,,,,,
465,537,406,465,537,406,,,0,0,0,,,,,,
465,538,429,465,537,429,,,0,1,0,,,,,,
466,538,453,465,538,453,,,1,0,0,,,,,,
466,538,477,466,538,477,,,0,0,0,,,,,,
466,539,501,466,539,501,,,0,0,0,,,,,,
467,539,525,467,539,525,,,0,0,0,,,,,,
468,540,549,467,540,549,,,1,0,0,,,,,,
468,540,574,468,540,574,,,0,0,0,,,,,,
469,541,598,468,541,598,,,1,0,0,,,,,,
469,541,623,469,541,623,,,0,0,0,,,,,,
470,542,647,470,542,647,,,0,0,0,,,,,,
471,543,672,471,542,672,,,0,1,0,,,,,,
471,543,697,471,543,697,,,0,0,0,,,,,,
472,544,722,472,544,722,,,0,0,0,,,,,,
473,545,747,473,545,747,,,0,0,0,,,,,,
474,545,772,474,545,772,,,0,0,0,,,,,,
472,563,157,472,563,157,,,0,0,0,,,,,,
472,563,158,472,563,157,,,0,0,1,,,,,,
472,563,162,472,563,162,,,0,0,0,,,,,,
472,563,169,472,563,170,,,0,0,-1,,,,,,
472,563,178,472,563,178,,,0,0,0,,,,,,
472,563,190,472,563,191,,,0,0,-1,,,,,,
472,563,205,472,563,205,,,0,0,0,,,,,,
472,564,221,472,563,221,,,0,1,0,,,,,,
472,564,238,472,564,238,,,0,0,0,,,,,,
473,564,257,472,564,257,,,1,0,0,,,,,,
473,564,277,473,564,277,,,0,0,0,,,,,,
473,564,298,473,564,298,,,0,0,0,,,,,,
473,564,319,473,564,319,,,0,0,0,,,,,,
474,565,341,473,564,341,,,1,1,0,,,,,,
474,565,363,474,565,363,,,0,0,0,,,,,,
474,565,386,474,565,385,,,0,0,1,,,,,,
475,566,408,475,566,408,,,0,0,0,,,,,,
475,566,432,475,566,431,,,0,0,1,,,,,,
475,566,455,475,566,455,,,0,0,0,,,,,,
476,567,479,475,566,479,,,1,1,0,,,,,,
476,567,503,476,567,503,,,0,0,0,,,,,,
477,567,527,476,567,527,,,1,0,0,,,,,,
477,568,551,477,568,551,,,0,0,0,,,,,,
478,568,575,477,568,575,,,1,0,0,,,,,,
478,569,600,478,569,600,,,0,0,0,,,,,,
479,569,624,479,569,624,,,0,0,0,,,,,,
480,570,649,480,570,649,,,0,0,0,,,,,,
480,571,674,480,570,673,,,0,1,1,,,,,,
481,571,698,481,571,698,,,0,0,0,,,,,,
482,572,723,482,572,723,,,0,0,0,,,,,,
483,573,748,483,573,748,,,0,0,0,,,,,,
483,573,773,483,573,773,,,0,0,0,,,,,,
482,592,164,482,591,164,,,0,1,0,,,,,,
482,592,165,482,591,164,,,0,1,1,,,,,,
482,592,169,482,591,169,,,0,1,0,,,,,,
482,592,175,482,591,176,,,0,1,-1,,,,,,
482,592,185,482,592,184,,,0,0,1,,,,,,
482,592,196,482,592,197,,,0,0,-1,,,,,,
482,592,210,482,592,210,,,0,0,0,,,,,,
482,592,226,482,592,226,,,0,0,0,,,,,,
483,592,243,482,592,243,,,1,0,0,,,,,,
483,592,262,483,592,262,,,0,0,0,,,,,,
483,593,281,483,592,281,,,0,1,0,,,,,,
483,593,301,483,592,301,,,0,1,0,,,,,,
483,593,322,483,593,322,,,0,0,0,,,,,,
484,593,344,484,593,344,,,0,0,0,,,,,,
484,593,366,484,593,366,,,0,0,0,,,,,,
484,594,388,484,594,388,,,0,0,0,,,,,,
485,594,411,485,594,411,,,0,0,0,,,,,,
485,594,434,485,594,434,,,0,0,0,,,,,,
486,595,457,485,594,457,,,1,1,0,,,,,,
486,595,481,486,595,481,,,0,0,0,,,,,,
486,595,505,486,595,505,,,0,0,0,,,,,,
487,596,529,487,596,529,,,0,0,0,,,,,,
487,596,553,487,596,553,,,0,0,0,,,,,,
488,597,577,488,597,577,,,0,0,0,,,,,,
489,597,601,488,597,601,,,1,0,0,,,,,,
489,598,626,489,598,626,,,0,0,0,,,,,,
490,598,650,490,598,650,,,0,0,0,,,,,,
491,599,675,490,599,675,,,1,0,0,,,,,,
491,599,700,491,599,699,,,0,0,1,,,,,,
492,600,725,492,600,724,,,0,0,1,,,,,,
493,601,750,493,601,749,,,0,0,1,,,,,,
493,601,775,493,601,774,,,0,0,1,,,,,,
493,620,172,493,620,172,,,0,0,0,,,,,,
493,620,173,493,620,172,,,0,0,1,,,,,,
493,620,176,493,620,176,,,0,0,0,,,,,,
493,620,182,493,620,183,,,0,0,-1,,,,,,
493,621,191,493,621,191,,,0,0,0,,,,,,
493,621,202,493,621,203,,,0,0,-1,,,,,,
493,621,216,493,621,216,,,0,0,0,,,,,,
493,621,231,493,621,232,,,0,0,-1,,,,,,
493,621,248,493,621,248,,,0,0,0,,,,,,
493,621,266,493,621,266,,,0,0,0,,,,,,
494,621,285,494,621,285,,,0,0,0,,,,,,
494,621,305,494,621,305,,,0,0,0,,,,,,
494,622,326,494,622,326,,,0,0,0,,,,,,
494,622,347,494,622,347,,,0,0,0,,,,,,
495,622,369,495,622,369,,,0,0,0,,,,,,
495,622,391,495,622,391,,,0,0,0,,,,,,
495,623,414,495,623,414,,,0,0,0,,,,,,
496,623,437,495,623,437,,,1,0,0,,,,,,
496,623,460,496,623,460,,,0,0,0,,,,,,
496,624,483,496,623,483,,,0,1,0,,,,,,
497,624,507,497,624,507,,,0,0,0,,,,,,
497,624,531,497,624,531,,,0,0,0,,,,,,
498,625,555,498,625,555,,,0,0,0,,,,,,
498,625,579,498,625,579,,,0,0,0,,,,,,
499,626,603,499,626,603,,,0,0,0,,,,,,
500,626,628,499,626,627,,,1,0,1,,,,,,
500,627,652,500,627,652,,,0,0,0,,,,,,
501,627,677,501,627,676,,,0,0,1,,,,,,
502,628,701,502,628,701,,,0,0,0,,,,,,
502,628,726,502,628,726,,,0,0,0,,,,,,
503,629,751,503,629,751,,,0,0,0,,,,,,
504,630,776,504,629,776,,,0,1,0,,,,,,
504,649,179,504,649,179,,,0,0,0,,,,,,
504,649,180,504,649,179,,,0,0,1,,,,,,
504,649,183,504,649,183,,,0,0,0,,,,,,
504,649,189,504,649,190,,,0,0,-1,,,,,,
504,649,198,504,649,197,,,0,0,1,,,,,,
504,649,209,504,649,209,,,0,0,0,,,,,,
504,649,222,504,649,222,,,0,0,0,,,,,,
504,650,237,504,649,237,,,0,1,0,,,,,,
504,650,253,504,650,253,,,0,0,0,,,,,,
504,650,271,504,650,271,,,0,0,0,,,,,,
505,650,289,505,650,289,,,0,0,0,,,,,,
505,650,309,505,650,309,,,0,0,0,,,,,,
505,650,330,505,650,329,,,0,0,1,,,,,,
505,651,351,505,650,351,,,0,1,0,,,,,,
506,651,372,506,651,372,,,0,0,0,,,,,,
506,651,394,506,651,394,,,0,0,0,,,,,,
506,651,417,506,651,417,,,0,0,0,,,,,,
507,652,439,506,651,439,,,1,1,0,,,,,,
507,652,462,507,652,462,,,0,0,0,,,,,,
507,652,486,507,652,486,,,0,0,0,,,,,,
508,653,509,508,652,509,,,0,1,0,,,,,,
508,653,533,508,653,533,,,0,0,0,,,,,,
509,653,557,509,653,557,,,0,0,0,,,,,,
509,654,581,509,654,581,,,0,0,0,,,,,,
510,654,605,510,654,605,,,0,0,0,,,,,,
510,655,629,510,655,629,,,0,0,0,,,,,,
511,655,654,511,655,654,,,0,0,0,,,,,,
512,656,678,511,656,678,,,1,0,0,,,,,,
512,656,703,512,656,703,,,0,0,0,,,,,,
513,657,728,513,657,727,,,0,0,1,,,,,,
514,657,753,514,657,752,,,0,0,1,,,,,,
515,658,777,514,658,777,,,1,0,0,,,,,,
515,678,187,515,678,187,,,0,0,0,,,,,,
515,678,187,515,678,187,,,0,0,0,,,,,,
515,678,191,515,678,191,,,0,0,0,,,,,,
515,678,196,515,678,197,,,0,0,-1,,,,,,
515,678,204,515,678,204,,,0,0,0,,,,,,
515,678,215,515,678,216,,,0,0,-1,,,,,,
515,678,228,515,678,228,,,0,0,0,,,,,,
515,678,242,515,678,243,,,0,0,-1,,,,,,
515,679,258,515,679,258,,,0,0,0,,,,,,
516,679,275,515,679,276,,,1,0,-1,,,,,,
516,679,294,516,679,294,,,0,0,0,,,,,,
516,679,313,516,679,313,,,0,0,0,,,,,,
516,679,333,516,679,333,,,0,0,0,,,,,,
516,679,354,516,679,354,,,0,0,0,,,,,,
517,680,376,517,680,376,,,0,0,0,,,,,,
517,680,397,517,680,398,,,0,0,-1,,,,,,
517,680,420,517,680,420,,,0,0,0,,,,,,
518,680,442,517,680,442,,,1,0,0,,,,,,
518,681,465,518,681,465,,,0,0,0,,,,,,
519,681,488,518,681,488,,,1,0,0,,,,,,
519,681,512,519,681,512,,,0,0,0,,,,,,
519,682,535,519,681,535,,,0,1,0,,,,,,
520,682,559,520,682,559,,,0,0,0,,,,,,
520,682,583,520,682,583,,,0,0,0,,,,,,
521,683,607,521,683,607,,,0,0,0,,,,,,
522,683,631,521,683,631,,,1,0,0,,,,,,
522,684,656,522,684,656,,,0,0,0,,,,,,
523,684,680,522,684,680,,,1,0,0,,,,,,
523,685,705,523,685,705,,,0,0,0,,,,,,
524,685,729,524,685,729,,,0,0,0,,,,,,
525,686,754,525,686,754,,,0,0,0,,,,,,
526,686,779,525,686,779,,,1,0,0,,,,,,
526,707,194,526,707,194,,,0,0,0,,,,,,
526,707,195,526,707,194,,,0,0,1,,,,,,
526,707,198,526,707,198,,,0,0,0,,,,,,
526,707,203,526,707,204,,,0,0,-1,,,,,,
527,707,211,526,707,211,,,1,0,0,,,,,,
527,707,221,526,707,222,,,1,0,-1,,,,,,
527,707,234,526,707,234,,,1,0,0,,,,,,
527,707,248,526,707,248,,,1,0,0,,,,,,
527,707,263,527,707,263,,,0,0,0,,,,,,
527,708,280,527,707,281,,,0,1,-1,,,,,,
527,708,298,527,708,298,,,0,0,0,,,,,,
527,708,318,527,708,317,,,0,0,1,,,,,,
528,708,337,527,708,337,,,1,0,0,,,,,,
528,708,358,528,708,358,,,0,0,0,,,,,,
528,708,379,528,708,379,,,0,0,0,,,,,,
529,709,401,528,708,401,,,1,1,0,,,,,,
529,709,423,529,709,423,,,0,0,0,,,,,,
529,709,445,529,709,445,,,0,0,0,,,,,,
530,709,468,529,709,468,,,1,0,0,,,,,,
530,710,491,530,709,491,,,0,1,0,,,,,,
530,710,514,530,710,514,,,0,0,0,,,,,,
531,710,538,531,710,538,,,0,0,0,,,,,,
531,711,561,531,711,561,,,0,0,0,,,,,,
532,711,585,532,711,585,,,0,0,0,,,,,,
532,712,609,532,711,609,,,0,1,0,,,,,,
533,712,633,533,712,633,,,0,0,0,,,,,,
533,712,657,533,712,657,,,0,0,0,,,,,,
534,713,682,534,713,682,,,0,0,0,,,,,,
535,713,706,534,713,706,,,1,0,0,,,,,,
535,714,731,535,714,731,,,0,0,0,,,,,,
536,714,756,536,714,755,,,0,0,1,,,,,,
537,715,781,537,715,780,,,0,0,1,,,,,,
538,736,202,538,736,202,,,0,0,0,,,,,,
538,736,202,538,736,202,,,0,0,0,,,,,,
538,736,205,538,736,205,,,0,0,0,,,,,,
538,736,210,538,736,211,,,0,0,-1,,,,,,
538,736,218,538,736,218,,,0,0,0,,,,,,
538,736,228,538,736,229,,,0,0,-1,,,,,,
538,736,240,538,736,240,,,0,0,0,,,,,,
539,736,253,538,736,254,,,1,0,-1,,,,,,
539,736,269,539,736,269,,,0,0,0,,,,,,
539,737,285,539,736,286,,,0,1,-1,,,,,,
539,737,303,539,737,303,,,0,0,0,,,,,,
539,737,322,539,737,322,,,0,0,0,,,,,,
539,737,341,539,737,341,,,0,0,0,,,,,,
540,737,362,539,737,362,,,1,0,0,,,,,,
540,737,383,540,737,383,,,0,0,0,,,,,,
540,738,404,540,737,404,,,0,1,0,,,,,,
541,738,426,541,738,426,,,0,0,0,,,,,,
541,738,448,541,738,448,,,0,0,0,,,,,,
541,738,471,541,738,471,,,0,0,0,,,,,,
542,739,494,541,738,494,,,1,1,0,,,,,,
542,739,517,542,739,517,,,0,0,0,,,,,,
543,739,540,542,739,540,,,1,0,0,,,,,,
543,740,564,543,740,564,,,0,0,0,,,,,,
544,740,587,543,740,587,,,1,0,0,,,,,,
544,740,611,544,740,611,,,0,0,0,,,,,,
545,741,635,544,740,635,,,1,1,0,,,,,,
545,741,659,545,741,659,,,0,0,0,,,,,,
546,742,684,545,741,683,,,1,1,1,,,,,,
546,742,708,546,742,708,,,0,0,0,,,,,,
547,743,733,547,742,732,,,0,1,1,,,,,,
548,743,757,548,743,757,,,0,0,0,,,,,,
548,744,782,548,743,782,,,0,1,0,,,,,,
550,765,209,550,765,209,,,0,0,0,,,,,,
550,765,210,550,765,209,,,0,0,1,,,,,,
550,765,213,550,765,212,,,0,0,1,,,,,,
550,765,218,550,765,218,,,0,0,0,,,,,,
550,765,225,550,765,225,,,0,0,0,,,,,,
550,765,235,550,765,235,,,0,0,0,,,,,,
551,765,246,550,765,246,,,1,0,0,,,,,,
551,765,259,550,765,260,,,1,0,-1,,,,,,
551,765,274,551,765,274,,,0,0,0,,,,,,
551,766,291,551,765,291,,,0,1,0,,,,,,
551,766,308,551,766,308,,,0,0,0,,,,,,
551,766,326,551,766,326,,,0,0,0,,,,,,
552,766,346,551,766,345,,,1,0,1,,,,,,
552,766,366,551,766,366,,,1,0,0,,,,,,
552,766,386,552,766,386,,,0,0,0,,,,,,
552,767,408,552,766,408,,,0,1,0,,,,,,
553,767,429,553,767,429,,,0,0,0,,,,,,
553,767,451,553,767,451,,,0,0,0,,,,,,
553,767,474,553,767,474,,,0,0,0,,,,,,
554,768,496,553,767,496,,,1,1,0,,,,,,
554,768,519,554,768,519,,,0,0,0,,,,,,
555,768,543,554,768,543,,,1,0,0,,,,,,
555,769,566,555,769,566,,,0,0,0,,,,,,
555,769,590,555,769,590,,,0,0,0,,,,,,
556,769,613,556,769,613,,,0,0,0,,,,,,
556,770,637,556,769,637,,,0,1,0,,,,,,
557,770,661,557,770,661,,,0,0,0,,,,,,
558,770,686,557,770,685,,,1,0,1,,,,,,
558,771,710,558,771,710,,,0,0,0,,,,,,
559,771,735,559,771,734,,,0,0,1,,,,,,
560,772,759,560,772,759,,,0,0,0,,,,,,
560,772,784,560,772,783,,,0,0,1,,,,,,
563,794,217,563,794,217,,,0,0,0,,,,,,
563,794,217,563,794,217,,,0,0,0,,,,,,
563,794,220,563,794,220,,,0,0,0,,,,,,
563,794,225,563,794,226,,,0,0,-1,,,,,,
563,794,232,563,794,232,,,0,0,0,,,,,,
563,794,241,563,794,242,,,0,0,-1,,,,,,
563,794,252,563,794,252,,,0,0,0,,,,,,
563,795,265,563,794,266,,,0,1,-1,,,,,,
563,795,280,563,795,280,,,0,0,0,,,,,,
563,795,296,563,795,296,,,0,0,0,,,,,,
563,795,313,563,795,313,,,0,0,0,,,,,,
564,795,331,563,795,331,,,1,0,0,,,,,,
564,795,350,564,795,350,,,0,0,0,,,,,,
564,795,370,564,795,370,,,0,0,0,,,,,,
564,795,390,564,795,390,,,0,0,0,,,,,,
565,796,411,564,795,411,,,1,1,0,,,,,,
565,796,433,565,796,433,,,0,0,0,,,,,,
565,796,455,565,796,455,,,0,0,0,,,,,,
566,796,477,566,796,477,,,0,0,0,,,,,,
566,797,499,566,796,499,,,0,1,0,,,,,,
566,797,522,566,797,522,,,0,0,0,,,,,,
567,797,545,566,797,545,,,1,0,0,,,,,,
567,798,569,567,798,569,,,0,0,0,,,,,,
568,798,592,567,798,592,,,1,0,0,,,,,,
568,798,616,568,798,616,,,0,0,0,,,,,,
569,799,640,568,798,640,,,1,1,0,,,,,,
569,799,664,569,799,664,,,0,0,0,,,,,,
570,799,688,569,799,688,,,1,0,0,,,,,,
570,800,712,570,800,712,,,0,0,0,,,,,,
571,800,736,571,800,736,,,0,0,0,,,,,,
572,801,761,572,801,761,,,0,0,0,,,,,,
572,801,786,572,801,785,,,0,0,1,,,,,,
575,823,224,575,823,224,,,0,0,0,,,,,,
575,823,225,575,823,224,,,0,0,1,,,,,,
575,823,228,575,823,227,,,0,0,1,,,,,,
575,823,232,575,823,233,,,0,0,-1,,,,,,
575,824,239,575,823,239,,,0,1,0,,,,,,
575,824,248,575,823,248,,,0,1,0,,,,,,
575,824,259,575,823,258,,,0,1,1,,,,,,
576,824,272,575,823,272,,,1,1,0,,,,,,
576,824,286,575,824,286,,,1,0,0,,,,,,
576,824,301,575,824,302,,,1,0,-1,,,,,,
576,824,318,576,824,318,,,0,0,0,,,,,,
576,824,336,576,824,336,,,0,0,0,,,,,,
576,824,355,576,824,354,,,0,0,1,,,,,,
577,824,374,576,824,374,,,1,0,0,,,,,,
577,825,394,577,824,394,,,0,1,0,,,,,,
577,825,415,577,824,415,,,0,1,0,,,,,,
577,825,436,577,825,436,,,0,0,0,,,,,,
578,825,458,578,825,458,,,0,0,0,,,,,,
578,825,480,578,825,480,,,0,0,0,,,,,,
578,826,502,578,825,502,,,0,1,0,,,,,,
579,826,525,578,826,525,,,1,0,0,,,,,,
579,826,548,579,826,548,,,0,0,0,,,,,,
580,827,571,579,827,571,,,1,0,0,,,,,,
580,827,595,580,827,595,,,0,0,0,,,,,,
581,827,618,580,827,618,,,1,0,0,,,,,,
581,828,642,581,827,642,,,0,1,0,,,,,,
582,828,666,581,828,666,,,1,0,0,,,,,,
582,828,690,582,828,690,,,0,0,0,,,,,,
583,829,714,582,829,714,,,1,0,0,,,,,,
583,829,738,583,829,738,,,0,0,0,,,,,,
584,830,763,584,830,763,,,0,0,0,,,,,,
585,830,787,584,830,787,,,1,0,0,,,,,,
588,853,232,588,853,232,,,0,0,0,,,,,,
588,853,233,588,853,232,,,0,0,1,,,,,,
588,853,235,588,853,235,,,0,0,0,,,,,,
588,853,240,588,853,240,,,0,0,0,,,,,,
588,853,246,588,853,246,,,0,0,0,,,,,,
588,853,255,588,853,255,,,0,0,0,,,,,,
588,853,265,588,853,265,,,0,0,0,,,,,,
588,853,278,588,853,278,,,0,0,0,,,,,,
588,853,292,588,853,292,,,0,0,0,,,,,,
589,853,307,588,853,307,,,1,0,0,,,,,,
589,853,323,589,853,323,,,0,0,0,,,,,,
589,853,341,589,853,341,,,0,0,0,,,,,,
589,853,359,589,853,359,,,0,0,0,,,,,,
589,854,379,589,853,378,,,0,1,1,,,,,,
590,854,398,590,854,398,,,0,0,0,,,,,,
590,854,419,590,854,419,,,0,0,0,,,,,,
590,854,440,590,854,440,,,0,0,0,,,,,,
590,854,461,590,854,461,,,0,0,0,,,,,,
591,855,483,591,855,483,,,0,0,0,,,,,,
591,855,506,591,855,505,,,0,0,1,,,,,,
591,855,528,591,855,528,,,0,0,0,,,,,,
592,855,551,591,855,551,,,1,0,0,,,,,,
592,856,574,592,856,574,,,0,0,0,,,,,,
593,856,597,592,856,597,,,1,0,0,,,,,,
593,856,621,593,856,621,,,0,0,0,,,,,,
594,857,644,593,856,644,,,1,1,0,,,,,,
594,857,668,594,857,668,,,0,0,0,,,,,,
595,857,692,594,857,692,,,1,0,0,,,,,,
595,858,716,595,858,716,,,0,0,0,,,,,,
596,858,741,595,858,740,,,1,0,1,,,,,,
596,859,765,596,859,765,,,0,0,0,,,,,,
597,859,789,597,859,789,,,0,0,0,,,,,,
601,882,240,601,882,239,,,0,0,1,,,,,,
601,882,240,601,882,239,,,0,0,1,,,,,,
601,882,243,601,882,242,,,0,0,1,,,,,,
601,882,247,601,882,248,,,0,0,-1,,,,,,
601,882,253,601,882,253,,,0,0,0,,,,,,
601,882,262,601,882,262,,,0,0,0,,,,,,
601,882,272,601,882,272,,,0,0,0,,,,,,
601,882,284,601,882,285,,,0,0,-1,,,,,,
601,882,298,601,882,298,,,0,0,0,,,,,,
601,882,313,601,882,313,,,0,0,0,,,,,,
602,883,329,602,882,328,,,0,1,1,,,,,,
602,883,346,602,882,346,,,0,1,0,,,,,,
602,883,364,602,882,364,,,0,1,0,,,,,,
602,883,383,602,882,383,,,0,1,0,,,,,,
602,883,403,603,883,402,,,-1,0,1,,,,,,
603,883,423,603,883,423,,,0,0,0,,,,,,
603,883,444,603,883,444,,,0,0,0,,,,,,
603,884,465,603,883,465,,,0,1,0,,,,,,
604,884,487,604,884,486,,,0,0,1,,,,,,
604,884,509,604,884,508,,,0,0,1,,,,,,
604,884,531,604,884,531,,,0,0,0,,,,,,
605,885,554,604,884,554,,,1,1,0,,,,,,
605,885,577,605,885,577,,,0,0,0,,,,,,
606,885,600,605,885,600,,,1,0,0,,,,,,
606,886,623,606,885,623,,,0,1,0,,,,,,
606,886,647,606,885,647,,,0,1,0,,,,,,
607,886,671,607,886,670,,,0,0,1,,,,,,
608,887,694,607,886,694,,,1,1,0,,,,,,
608,887,719,608,887,718,,,0,0,1,,,,,,
609,887,743,608,887,742,,,1,0,1,,,,,,
609,888,767,609,888,767,,,0,0,0,,,,,,
610,888,791,609,888,791,,,1,0,0,,,,,,
395,109,60,394,109,60,,,1,0,0,,,,,,
395,109,63,394,109,60,,,1,0,3,,,,,,
395,109,73,394,109,72,,,1,0,1,,,,,,
395,110,88,394,109,89,,,1,1,-1,,,,,,
395,110,106,395,109,106,,,0,1,0,,,,,,
395,110,126,395,110,126,,,0,0,0,,,,,,
395,111,148,395,110,147,,,0,1,1,,,,,,
395,112,170,395,111,170,,,0,1,0,,,,,,
396,112,193,395,112,193,,,1,0,0,,,,,,
396,113,216,395,113,216,,,1,0,0,,,,,,
396,114,240,396,114,240,,,0,0,0,,,,,,
396,115,264,396,115,264,,,0,0,0,,,,,,
397,117,288,396,117,288,,,1,0,0,,,,,,
397,118,312,397,118,312,,,0,0,0,,,,,,
397,120,336,397,120,336,,,0,0,0,,,,,,
398,121,361,397,121,361,,,1,0,0,,,,,,
398,123,385,398,123,385,,,0,0,0,,,,,,
399,125,410,398,125,410,,,1,0,0,,,,,,
399,127,435,399,127,434,,,0,0,1,,,,,,
400,129,460,399,129,459,,,1,0,1,,,,,,
400,131,485,400,131,484,,,0,0,1,,,,,,
401,133,510,401,133,509,,,0,0,1,,,,,,
402,136,535,402,136,534,,,0,0,1,,,,,,
402,138,560,402,138,559,,,0,0,1,,,,,,
403,140,585,403,140,585,,,0,0,0,,,,,,
404,143,610,403,143,610,,,1,0,0,,,,,,
404,146,635,404,145,635,,,0,1,0,,,,,,
405,148,661,405,148,660,,,0,0,1,,,,,,
406,151,686,406,151,686,,,0,0,0,,,,,,
407,154,712,407,154,711,,,0,0,1,,,,,,
408,157,737,408,157,737,,,0,0,0,,,,,,
409,160,762,409,160,762,,,0,0,0,,,,,,
395,111,60,394,109,60,,,1,2,0,,,,,,
395,111,63,394,109,60,,,1,2,3,,,,,,
395,111,73,394,109,72,,,1,2,1,,,,,,
395,112,88,394,109,89,,,1,3,-1,,,,,,
395,112,106,395,109,106,,,0,3,0,,,,,,
395,112,126,395,110,126,,,0,2,0,,,,,,
395,113,148,395,110,147,,,0,3,1,,,,,,
395,114,170,395,111,170,,,0,3,0,,,,,,
396,114,193,395,112,193,,,1,2,0,,,,,,
396,115,216,395,113,216,,,1,2,0,,,,,,
396,116,240,396,114,240,,,0,2,0,,,,,,
396,117,264,396,115,264,,,0,2,0,,,,,,
397,119,288,396,117,288,,,1,2,0,,,,,,
397,120,312,397,118,312,,,0,2,0,,,,,,
397,122,336,397,120,336,,,0,2,0,,,,,,
398,123,361,397,121,361,,,1,2,0,,,,,,
398,125,386,398,123,385,,,0,2,1,,,,,,
399,127,410,398,125,410,,,1,2,0,,,,,,
399,129,435,399,127,434,,,0,2,1,,,,,,
400,131,460,399,129,459,,,1,2,1,,,,,,
400,133,485,400,131,484,,,0,2,1,,,,,,
401,135,510,401,133,509,,,0,2,1,,,,,,
402,137,535,402,136,534,,,0,1,1,,,,,,
402,140,560,402,138,559,,,0,2,1,,,,,,
403,142,585,403,140,585,,,0,2,0,,,,,,
404,145,610,403,143,610,,,1,2,0,,,,,,
405,147,635,404,145,635,,,1,2,0,,,,,,
405,150,661,405,148,660,,,0,2,1,,,,,,
406,153,686,406,151,686,,,0,2,0,,,,,,
407,155,712,407,154,711,,,0,1,1,,,,,,
408,158,737,408,157,737,,,0,1,0,,,,,,
409,161,762,409,160,762,,,0,1,0,,,,,,
395,119,61,395,119,61,,,0,0,0,,,,,,
395,119,64,395,119,61,,,0,0,3,,,,,,
395,119,73,395,119,73,,,0,0,0,,,,,,
396,119,88,395,119,90,,,1,0,-2,,,,,,
396,119,107,395,119,107,,,1,0,0,,,,,,
396,120,127,395,119,127,,,1,1,0,,,,,,
396,120,148,396,120,148,,,0,0,0,,,,,,
396,121,171,396,120,171,,,0,1,0,,,,,,
396,121,193,396,121,193,,,0,0,0,,,,,,
396,122,217,396,122,216,,,0,0,1,,,,,,
397,123,240,396,123,240,,,1,0,0,,,,,,
397,124,264,397,124,264,,,0,0,0,,,,,,
397,126,288,397,125,288,,,0,1,0,,,,,,
398,127,312,397,127,312,,,1,0,0,,,,,,
398,128,337,398,128,336,,,0,0,1,,,,,,
398,130,361,398,130,361,,,0,0,0,,,,,,
399,131,386,399,131,385,,,0,0,1,,,,,,
399,133,410,399,133,410,,,0,0,0,,,,,,
400,135,435,400,135,435,,,0,0,0,,,,,,
400,137,460,400,137,460,,,0,0,0,,,,,,
401,139,485,401,139,484,,,0,0,1,,,,,,
402,141,510,401,141,509,,,1,0,1,,,,,,
402,143,535,402,143,534,,,0,0,1,,,,,,
403,145,560,402,145,559,,,1,0,1,,,,,,
404,148,585,403,147,585,,,1,1,0,,,,,,
404,150,610,404,150,610,,,0,0,0,,,,,,
405,153,636,405,153,635,,,0,0,1,,,,,,
406,155,661,406,155,660,,,0,0,1,,,,,,
407,158,686,406,158,686,,,1,0,0,,,,,,
408,161,712,407,160,711,,,1,1,1,,,,,,
409,163,737,408,163,737,,,1,0,0,,,,,,
410,166,762,409,166,762,,,1,0,0,,,,,,
396,131,63,396,133,63,,,0,-2,0,,,,,,
396,131,65,396,133,63,,,0,-2,2,,,,,,
396,131,75,396,133,75,,,0,-2,0,,,,,,
397,131,90,396,133,91,,,1,-2,-1,,,,,,
397,132,108,396,133,108,,,1,-1,0,,,,,,
397,132,128,397,134,128,,,0,-2,0,,,,,,
397,132,149,397,134,149,,,0,-2,0,,,,,,
397,133,171,397,135,171,,,0,-2,0,,,,,,
397,134,194,397,135,194,,,0,-1,0,,,,,,
397,134,217,397,136,217,,,0,-2,0,,,,,,
398,135,241,397,137,240,,,1,-2,1,,,,,,
398,136,264,398,138,264,,,0,-2,0,,,,,,
398,137,288,398,139,288,,,0,-2,0,,,,,,
399,139,313,399,140,312,,,0,-1,1,,,,,,
399,140,337,399,142,337,,,0,-2,0,,,,,,
399,141,361,399,143,361,,,0,-2,0,,,,,,
400,143,386,400,144,386,,,0,-1,0,,,,,,
400,144,410,400,146,410,,,0,-2,0,,,,,,
401,146,435,401,148,435,,,0,-2,0,,,,,,
401,148,460,401,149,460,,,0,-1,0,,,,,,
402,149,485,402,151,485,,,0,-2,0,,,,,,
403,151,510,402,153,510,,,1,-2,0,,,,,,
403,153,535,403,155,535,,,0,-2,0,,,,,,
404,156,560,404,157,560,,,0,-1,0,,,,,,
405,158,585,405,159,585,,,0,-1,0,,,,,,
405,160,610,405,161,610,,,0,-1,0,,,,,,
406,162,636,406,164,635,,,0,-2,1,,,,,,
407,165,661,407,166,661,,,0,-1,0,,,,,,
408,167,686,408,169,686,,,0,-2,0,,,,,,
409,170,712,408,171,711,,,1,-1,1,,,,,,
410,172,737,409,174,737,,,1,-2,0,,,,,,
411,175,763,410,176,762,,,1,-1,1,,,,,,
398,148,65,398,147,65,,,0,1,0,,,,,,
398,148,68,398,147,65,,,0,1,3,,,,,,
398,148,77,398,147,77,,,0,1,0,,,,,,
398,148,91,398,148,93,,,0,0,-2,,,,,,
398,148,109,398,148,109,,,0,0,0,,,,,,
398,148,129,398,148,129,,,0,0,0,,,,,,
398,149,150,398,149,149,,,0,0,1,,,,,,
398,149,172,398,149,172,,,0,0,0,,,,,,
399,150,195,399,150,195,,,0,0,0,,,,,,
399,151,218,399,150,218,,,0,1,0,,,,,,
399,151,241,399,151,241,,,0,0,0,,,,,,
399,152,265,399,152,265,,,0,0,0,,,,,,
400,153,289,400,153,289,,,0,0,0,,,,,,
400,154,313,400,154,313,,,0,0,0,,,,,,
400,155,337,400,155,337,,,0,0,0,,,,,,
401,157,362,400,156,362,,,1,1,0,,,,,,
401,158,386,401,158,386,,,0,0,0,,,,,,
402,159,411,401,159,411,,,1,0,0,,,,,,
402,161,436,402,161,435,,,0,0,1,,,,,,
403,162,460,402,162,460,,,1,0,0,,,,,,
403,164,485,403,164,485,,,0,0,0,,,,,,
404,166,510,404,165,510,,,0,1,0,,,,,,
405,168,535,404,167,535,,,1,1,0,,,,,,
405,169,560,405,169,560,,,0,0,0,,,,,,
406,171,585,406,171,585,,,0,0,0,,,,,,
407,174,611,407,173,610,,,0,1,1,,,,,,
408,176,636,407,175,636,,,1,1,0,,,,,,
408,178,661,408,178,661,,,0,0,0,,,,,,
409,180,686,409,180,686,,,0,0,0,,,,,,
410,182,712,410,182,712,,,0,0,0,,,,,,
411,185,737,411,185,737,,,0,0,0,,,,,,
412,187,763,412,187,762,,,0,0,1,,,,,,
400,167,68,400,168,68,,,0,-1,0,,,,,,
400,167,71,400,168,68,,,0,-1,3,,,,,,
400,167,79,400,168,80,,,0,-1,-1,,,,,,
400,167,93,400,168,95,,,0,-1,-2,,,,,,
400,168,111,400,169,111,,,0,-1,0,,,,,,
400,168,130,400,169,131,,,0,-1,-1,,,,,,
400,168,151,400,169,151,,,0,-1,0,,,,,,
401,169,173,401,170,173,,,0,-1,0,,,,,,
401,169,196,401,170,196,,,0,-1,0,,,,,,
401,170,219,401,171,219,,,0,-1,0,,,,,,
401,171,242,401,171,242,,,0,0,0,,,,,,
401,171,266,401,172,265,,,0,-1,1,,,,,,
402,172,289,402,173,289,,,0,-1,0,,,,,,
402,173,314,402,174,313,,,0,-1,1,,,,,,
402,174,338,402,175,338,,,0,-1,0,,,,,,
403,175,362,403,176,362,,,0,-1,0,,,,,,
403,176,387,403,177,387,,,0,-1,0,,,,,,
404,177,411,403,178,411,,,1,-1,0,,,,,,
404,179,436,404,180,436,,,0,-1,0,,,,,,
405,180,461,405,181,460,,,0,-1,1,,,,,,
405,182,486,405,183,485,,,0,-1,1,,,,,,
406,183,510,406,184,510,,,0,-1,0,,,,,,
407,185,535,407,186,535,,,0,-1,0,,,,,,
407,187,561,407,187,560,,,0,0,1,,,,,,
408,188,586,408,189,585,,,0,-1,1,,,,,,
409,190,611,409,191,611,,,0,-1,0,,,,,,
410,192,636,409,193,636,,,1,-1,0,,,,,,
410,194,661,410,195,661,,,0,-1,0,,,,,,
411,196,687,411,197,686,,,0,-1,1,,,,,,
412,198,712,412,199,712,,,0,-1,0,,,,,,
413,201,737,413,201,737,,,0,0,0,,,,,,
414,203,763,414,204,763,,,0,-1,0,,,,,,
403,189,72,402,189,72,,,1,0,0,,,,,,
403,189,74,402,189,72,,,1,0,2,,,,,,
403,189,83,402,189,83,,,1,0,0,,,,,,
403,189,96,402,189,98,,,1,0,-2,,,,,,
403,189,113,403,189,113,,,0,0,0,,,,,,
403,190,132,403,189,132,,,0,1,0,,,,,,
403,190,153,403,190,152,,,0,0,1,,,,,,
403,190,174,403,190,174,,,0,0,0,,,,,,
403,191,197,403,191,197,,,0,0,0,,,,,,
403,191,220,403,191,220,,,0,0,0,,,,,,
404,192,243,404,192,243,,,0,0,0,,,,,,
404,193,266,404,192,266,,,0,1,0,,,,,,
404,193,290,404,193,290,,,0,0,0,,,,,,
405,194,314,404,194,314,,,1,0,0,,,,,,
405,195,338,405,195,338,,,0,0,0,,,,,,
405,196,363,405,196,363,,,0,0,0,,,,,,
406,197,387,406,197,387,,,0,0,0,,,,,,
406,198,412,406,198,412,,,0,0,0,,,,,,
407,199,436,406,199,436,,,1,0,0,,,,,,
407,200,461,407,200,461,,,0,0,0,,,,,,
408,202,486,408,202,486,,,0,0,0,,,,,,
408,203,511,408,203,511,,,0,0,0,,,,,,
409,205,536,409,204,536,,,0,1,0,,,,,,
410,206,561,410,206,561,,,0,0,0,,,,,,
411,208,586,410,208,586,,,1,0,0,,,,,,
411,209,611,411,209,611,,,0,0,0,,,,,,
412,211,636,412,211,636,,,0,0,0,,,,,,
413,213,662,413,213,661,,,0,0,1,,,,,,
414,215,687,414,214,687,,,0,1,0,,,,,,
415,217,712,415,216,712,,,0,1,0,,,,,,
415,219,738,416,218,738,,,-1,1,0,,,,,,
416,221,763,416,220,763,,,0,1,0,,,,,,
406,212,76,406,213,76,,,0,-1,0,,,,,,
406,212,79,406,213,76,,,0,-1,3,,,,,,
406,212,86,406,213,86,,,0,-1,0,,,,,,
406,213,99,406,213,101,,,0,0,-2,,,,,,
406,213,116,406,213,116,,,0,0,0,,,,,,
406,213,134,406,213,135,,,0,0,-1,,,,,,
406,213,155,406,213,154,,,0,0,1,,,,,,
406,213,176,406,214,176,,,0,-1,0,,,,,,
406,214,198,406,214,198,,,0,0,0,,,,,,
407,214,221,407,215,221,,,0,-1,0,,,,,,
407,215,244,407,215,244,,,0,0,0,,,,,,
407,215,267,407,216,267,,,0,-1,0,,,,,,
407,216,291,407,216,291,,,0,0,0,,,,,,
408,217,315,408,217,315,,,0,0,0,,,,,,
408,218,339,408,218,339,,,0,0,0,,,,,,
408,218,363,409,219,363,,,-1,-1,0,,,,,,
409,219,388,409,220,388,,,0,-1,0,,,,,,
409,220,412,409,221,412,,,0,-1,0,,,,,,
410,221,437,410,222,437,,,0,-1,0,,,,,,
410,222,462,410,223,461,,,0,-1,1,,,,,,
411,224,487,411,224,486,,,0,0,1,,,,,,
412,225,511,412,225,511,,,0,0,0,,,,,,
412,226,536,412,226,536,,,0,0,0,,,,,,
413,228,561,413,228,561,,,0,0,0,,,,,,
414,229,586,413,230,586,,,1,-1,0,,,,,,
414,230,612,414,231,611,,,0,-1,1,,,,,,
415,232,637,415,233,637,,,0,-1,0,,,,,,
416,234,662,416,234,662,,,0,0,0,,,,,,
417,235,687,417,236,687,,,0,-1,0,,,,,,
418,237,713,418,237,712,,,0,0,1,,,,,,
418,239,738,419,239,738,,,-1,0,0,,,,,,
419,241,764,420,241,763,,,-1,0,1,,,,,,
409,237,81,409,237,81,,,0,0,0,,,,,,
409,237,83,409,237,81,,,0,0,2,,,,,,
409,237,91,409,237,90,,,0,0,1,,,,,,
409,237,103,409,237,104,,,0,0,-1,,,,,,
409,237,119,409,237,119,,,0,0,0,,,,,,
410,237,137,409,237,138,,,1,0,-1,,,,,,
410,238,157,409,237,157,,,1,1,0,,,,,,
410,238,178,409,237,178,,,1,1,0,,,,,,
410,238,200,410,238,200,,,0,0,0,,,,,,
410,239,222,410,238,222,,,0,1,0,,,,,,
410,239,245,410,239,245,,,0,0,0,,,,,,
411,240,269,410,239,269,,,1,1,0,,,,,,
411,240,292,411,240,292,,,0,0,0,,,,,,
411,241,316,411,240,316,,,0,1,0,,,,,,
412,241,340,412,241,340,,,0,0,0,,,,,,
412,242,364,412,242,364,,,0,0,0,,,,,,
413,243,389,413,243,388,,,0,0,1,,,,,,
413,244,413,413,244,413,,,0,0,0,,,,,,
413,245,438,414,245,437,,,-1,0,1,,,,,,
414,246,462,414,246,462,,,0,0,0,,,,,,
415,247,487,415,247,487,,,0,0,0,,,,,,
415,248,512,415,248,512,,,0,0,0,,,,,,
416,249,537,416,249,537,,,0,0,0,,,,,,
416,250,562,416,250,562,,,0,0,0,,,,,,
417,252,587,417,252,587,,,0,0,0,,,,,,
418,253,612,417,253,612,,,1,0,0,,,,,,
419,254,637,418,254,637,,,1,0,0,,,,,,
419,256,663,419,256,662,,,0,0,1,,,,,,
420,257,688,420,257,688,,,0,0,0,,,,,,
421,259,713,421,259,713,,,0,0,0,,,,,,
422,261,739,422,261,738,,,0,0,1,,,,,,
423,262,764,423,262,764,,,0,0,0,,,,,,
413,262,86,414,262,86,,,-1,0,0,,,,,,
413,262,88,414,262,86,,,-1,0,2,,,,,,
414,262,95,414,262,95,,,0,0,0,,,,,,
414,262,107,414,262,109,,,0,0,-2,,,,,,
414,262,122,414,262,122,,,0,0,0,,,,,,
414,263,140,414,262,141,,,0,1,-1,,,,,,
414,263,160,414,263,159,,,0,0,1,,,,,,
414,263,180,414,263,180,,,0,0,0,,,,,,
414,263,202,414,263,202,,,0,0,0,,,,,,
414,264,224,414,264,224,,,0,0,0,,,,,,
415,264,247,415,264,247,,,0,0,0,,,,,,
415,265,270,415,264,270,,,0,1,0,,,,,,
415,265,294,415,265,293,,,0,0,1,,,,,,
416,266,317,415,265,317,,,1,1,0,,,,,,
416,266,341,416,266,341,,,0,0,0,,,,,,
416,267,365,416,267,365,,,0,0,0,,,,,,
417,268,390,417,268,389,,,0,0,1,,,,,,
417,268,414,417,269,414,,,0,-1,0,,,,,,
418,269,439,418,269,438,,,0,0,1,,,,,,
418,270,463,418,270,463,,,0,0,0,,,,,,
419,271,488,419,271,488,,,0,0,0,,,,,,
419,272,513,419,272,512,,,0,0,1,,,,,,
420,273,538,420,273,537,,,0,0,1,,,,,,
421,274,563,420,275,562,,,1,-1,1,,,,,,
421,275,588,421,276,587,,,0,-1,1,,,,,,
422,277,613,422,277,612,,,0,0,1,,,,,,
423,278,638,423,278,638,,,0,0,0,,,,,,
423,279,663,423,279,663,,,0,0,0,,,,,,
424,281,688,424,281,688,,,0,0,0,,,,,,
425,282,714,425,282,713,,,0,0,1,,,,,,
426,284,739,426,284,739,,,0,0,0,,,,,,
427,285,764,427,285,764,,,0,0,0,,,,,,
418,288,92,418,288,92,,,0,0,0,,,,,,
418,288,94,418,288,92,,,0,0,2,,,,,,
418,288,100,418,288,100,,,0,0,0,,,,,,
418,288,111,418,288,113,,,0,0,-2,,,,,,
418,288,126,418,288,126,,,0,0,0,,,,,,
418,288,143,418,288,144,,,0,0,-1,,,,,,
419,289,162,418,288,162,,,1,1,0,,,,,,
419,289,183,418,289,183,,,1,0,0,,,,,,
419,289,204,419,289,204,,,0,0,0,,,,,,
419,289,226,419,289,226,,,0,0,0,,,,,,
419,290,249,419,289,249,,,0,1,0,,,,,,
420,290,272,419,290,272,,,1,0,0,,,,,,
420,291,295,420,290,295,,,0,1,0,,,,,,
420,291,319,420,291,318,,,0,0,1,,,,,,
421,292,342,420,291,342,,,1,1,0,,,,,,
421,292,367,421,292,366,,,0,0,1,,,,,,
421,293,391,421,293,390,,,0,0,1,,,,,,
422,294,415,422,294,415,,,0,0,0,,,,,,
422,294,439,422,294,439,,,0,0,0,,,,,,
423,295,464,423,295,464,,,0,0,0,,,,,,
423,296,489,423,296,488,,,0,0,1,,,,,,
424,297,513,424,297,513,,,0,0,0,,,,,,
425,298,538,424,298,538,,,1,0,0,,,,,,
425,299,563,425,299,563,,,0,0,0,,,,,,
426,300,588,426,300,588,,,0,0,0,,,,,,
427,301,613,426,301,613,,,1,0,0,,,,,,
427,302,638,427,302,638,,,0,0,0,,,,,,
428,304,664,428,303,663,,,0,1,1,,,,,,
429,305,689,429,304,689,,,0,1,0,,,,,,
430,306,714,430,306,714,,,0,0,0,,,,,,
431,307,739,431,307,739,,,0,0,0,,,,,,
432,309,765,431,309,765,,,1,0,0,,,,,,
424,314,98,424,314,98,,,0,0,0,,,,,,
424,314,100,424,314,98,,,0,0,2,,,,,,
424,314,106,424,315,106,,,0,-1,0,,,,,,
424,315,116,424,315,118,,,0,0,-2,,,,,,
424,315,130,424,315,130,,,0,0,0,,,,,,
424,315,147,424,315,148,,,0,0,-1,,,,,,
424,315,166,424,315,165,,,0,0,1,,,,,,
424,315,186,424,315,186,,,0,0,0,,,,,,
424,315,207,424,315,206,,,0,0,1,,,,,,
424,316,228,424,316,228,,,0,0,0,,,,,,
425,316,251,425,316,251,,,0,0,0,,,,,,
425,316,274,425,316,273,,,0,0,1,,,,,,
425,317,297,425,317,296,,,0,0,1,,,,,,
425,317,320,425,317,320,,,0,0,0,,,,,,
426,318,344,426,318,344,,,0,0,0,,,,,,
426,318,368,426,318,368,,,0,0,0,,,,,,
427,319,392,427,319,392,,,0,0,0,,,,,,
427,320,416,427,320,416,,,0,0,0,,,,,,
428,320,441,428,320,440,,,0,0,1,,,,,,
428,321,465,428,321,465,,,0,0,0,,,,,,
429,322,490,429,322,489,,,0,0,1,,,,,,
429,323,514,429,323,514,,,0,0,0,,,,,,
430,324,539,430,324,539,,,0,0,0,,,,,,
430,324,564,430,325,564,,,0,-1,0,,,,,,
431,325,589,431,325,589,,,0,0,0,,,,,,
432,326,614,432,326,614,,,0,0,0,,,,,,
432,327,639,433,327,639,,,-1,0,0,,,,,,
433,329,664,433,328,664,,,0,1,0,,,,,,
434,330,690,434,329,689,,,0,1,1,,,,,,
435,331,715,435,331,715,,,0,0,0,,,,,,
436,332,740,436,332,740,,,0,0,0,,,,,,
437,333,765,437,334,765,,,0,-1,0,,,,,,
429,341,104,429,341,104,,,0,0,0,,,,,,
429,341,106,429,341,104,,,0,0,2,,,,,,
429,341,111,430,341,111,,,-1,0,0,,,,,,
429,341,121,430,341,123,,,-1,0,-2,,,,,,
429,341,135,430,341,135,,,-1,0,0,,,,,,
430,342,151,430,341,152,,,0,1,-1,,,,,,
430,342,169,430,342,169,,,0,0,0,,,,,,
430,342,189,430,342,189,,,0,0,0,,,,,,
430,342,209,430,342,209,,,0,0,0,,,,,,
430,342,231,430,342,231,,,0,0,0,,,,,,
430,343,253,431,343,253,,,-1,0,0,,,,,,
431,343,276,431,343,275,,,0,0,1,,,,,,
431,343,299,431,343,298,,,0,0,1,,,,,,
431,344,322,431,344,322,,,0,0,0,,,,,,
432,344,345,432,344,345,,,0,0,0,,,,,,
432,345,369,432,345,369,,,0,0,0,,,,,,
432,345,393,432,345,393,,,0,0,0,,,,,,
433,346,417,433,346,417,,,0,0,0,,,,,,
433,347,442,433,347,441,,,0,0,1,,,,,,
434,347,466,434,347,466,,,0,0,0,,,,,,
434,348,491,434,348,490,,,0,0,1,,,,,,
435,349,515,435,349,515,,,0,0,0,,,,,,
435,350,540,435,350,540,,,0,0,0,,,,,,
436,350,565,436,350,565,,,0,0,0,,,,,,
437,351,590,436,351,590,,,1,0,0,,,,,,
437,352,615,437,352,615,,,0,0,0,,,,,,
438,353,640,438,353,640,,,0,0,0,,,,,,
439,354,665,439,354,665,,,0,0,0,,,,,,
440,355,690,440,355,690,,,0,0,0,,,,,,
441,356,715,440,356,715,,,1,0,0,,,,,,
441,358,741,441,358,741,,,0,0,0,,,,,,
442,359,766,442,359,766,,,0,0,0,,,,,,
436,368,110,436,368,110,,,0,0,0,,,,,,
436,368,112,436,368,110,,,0,0,2,,,,,,
436,368,117,436,368,117,,,0,0,0,,,,,,
436,369,127,436,368,128,,,0,1,-1,,,,,,
436,369,140,436,368,139,,,0,1,1,,,,,,
436,369,155,436,369,156,,,0,0,-1,,,,,,
436,369,173,436,369,173,,,0,0,0,,,,,,
436,369,192,436,369,192,,,0,0,0,,,,,,
436,369,212,436,369,212,,,0,0,0,,,,,,
436,369,234,437,369,234,,,-1,0,0,,,,,,
437,370,255,437,370,255,,,0,0,0,,,,,,
437,370,278,437,370,278,,,0,0,0,,,,,,
437,370,301,437,370,300,,,0,0,1,,,,,,
438,371,324,438,371,323,,,0,0,1,,,,,,
438,371,347,438,371,347,,,0,0,0,,,,,,
438,372,371,438,372,371,,,0,0,0,,,,,,
439,372,395,439,372,395,,,0,0,0,,,,,,
439,373,419,439,373,419,,,0,0,0,,,,,,
440,373,443,440,373,443,,,0,0,0,,,,,,
440,374,467,440,374,467,,,0,0,0,,,,,,
441,375,492,441,374,492,,,0,1,0,,,,,,
441,375,516,441,375,516,,,0,0,0,,,,,,
442,376,541,442,376,541,,,0,0,0,,,,,,
442,377,566,442,377,566,,,0,0,0,,,,,,
443,378,591,443,377,591,,,0,1,0,,,,,,
444,379,616,444,378,615,,,0,1,1,,,,,,
444,379,641,445,379,640,,,-1,0,1,,,,,,
445,380,666,445,380,666,,,0,0,0,,,,,,
446,381,691,446,381,691,,,0,0,0,,,,,,
447,382,716,447,382,716,,,0,0,0,,,,,,
448,383,741,448,384,741,,,0,-1,0,,,,,,
448,384,767,449,385,767,,,-1,-1,0,,,,,,
442,396,117,443,396,117,,,-1,0,0,,,,,,
442,396,118,443,396,117,,,-1,0,1,,,,,,
442,396,123,443,396,123,,,-1,0,0,,,,,,
443,396,132,443,396,134,,,0,0,-2,,,,,,
443,396,145,443,396,144,,,0,0,1,,,,,,
443,396,160,443,396,160,,,0,0,0,,,,,,
443,396,177,443,396,177,,,0,0,0,,,,,,
443,396,196,443,396,196,,,0,0,0,,,,,,
443,397,216,443,396,216,,,0,1,0,,,,,,
443,397,236,443,396,237,,,0,1,-1,,,,,,
444,397,258,444,397,258,,,0,0,0,,,,,,
444,397,280,444,397,280,,,0,0,0,,,,,,
444,398,303,444,398,302,,,0,0,1,,,,,,
444,398,326,444,398,325,,,0,0,1,,,,,,
445,398,349,445,398,349,,,0,0,0,,,,,,
445,399,373,445,399,372,,,0,0,1,,,,,,
445,399,396,446,399,396,,,-1,0,0,,,,,,
446,400,420,446,400,420,,,0,0,0,,,,,,
446,400,444,446,400,444,,,0,0,0,,,,,,
447,401,469,447,401,469,,,0,0,0,,,,,,
447,402,493,447,401,493,,,0,1,0,,,,,,
448,402,518,448,402,518,,,0,0,0,,,,,,
448,403,542,448,403,542,,,0,0,0,,,,,,
449,404,567,449,403,567,,,0,1,0,,,,,,
450,404,592,450,404,592,,,0,0,0,,,,,,
450,405,617,450,405,616,,,0,0,1,,,,,,
451,406,642,451,406,641,,,0,0,1,,,,,,
452,407,667,452,407,666,,,0,0,1,,,,,,
453,408,692,452,408,692,,,1,0,0,,,,,,
453,409,717,453,409,717,,,0,0,0,,,,,,
454,410,742,454,410,742,,,0,0,0,,,,,,
455,411,768,455,411,767,,,0,0,1,,,,,,
450,423,123,450,423,123,,,0,0,0,,,,,,
450,424,125,450,423,123,,,0,1,2,,,,,,
450,424,130,450,423,129,,,0,1,1,,,,,,
450,424,138,450,423,139,,,0,1,-1,,,,,,
450,424,150,450,423,150,,,0,1,0,,,,,,
450,424,165,450,423,165,,,0,1,0,,,,,,
450,424,181,450,424,181,,,0,0,0,,,,,,
450,424,199,450,424,200,,,0,0,-1,,,,,,
450,424,219,450,424,219,,,0,0,0,,,,,,
451,424,240,451,424,240,,,0,0,0,,,,,,
451,425,261,451,424,261,,,0,1,0,,,,,,
451,425,283,451,425,283,,,0,0,0,,,,,,
451,425,305,451,425,305,,,0,0,0,,,,,,
452,426,328,452,425,328,,,0,1,0,,,,,,
452,426,351,452,426,351,,,0,0,0,,,,,,
452,426,374,453,426,374,,,-1,0,0,,,,,,
453,427,398,453,427,398,,,0,0,0,,,,,,
453,427,422,453,427,422,,,0,0,0,,,,,,
454,428,446,454,428,446,,,0,0,0,,,,,,
454,428,470,454,428,470,,,0,0,0,,,,,,
455,429,495,454,429,494,,,1,0,1,,,,,,
455,429,519,455,429,519,,,0,0,0,,,,,,
456,430,544,456,430,543,,,0,0,1,,,,,,
456,431,568,456,430,568,,,0,1,0,,,,,,
457,431,593,457,431,593,,,0,0,0,,,,,,
457,432,618,458,432,618,,,-1,0,0,,,,,,
458,433,643,458,433,642,,,0,0,1,,,,,,
459,434,668,459,434,667,,,0,0,1,,,,,,
460,435,693,460,434,693,,,0,1,0,,,,,,
460,435,718,460,435,718,,,0,0,0,,,,,,
461,436,743,461,436,743,,,0,0,0,,,,,,
462,437,768,462,437,768,,,0,0,0,,,,,,
458,451,130,458,451,130,,,0,0,0,,,,,,
458,451,132,458,451,130,,,0,0,2,,,,,,
458,451,136,458,451,136,,,0,0,0,,,,,,
458,451,144,458,451,145,,,0,0,-1,,,,,,
458,451,156,458,451,155,,,0,0,1,,,,,,
458,452,170,458,451,170,,,0,1,0,,,,,,
458,452,186,458,451,186,,,0,1,0,,,,,,
458,452,204,458,452,204,,,0,0,0,,,,,,
458,452,223,458,452,223,,,0,0,0,,,,,,
458,452,243,458,452,243,,,0,0,0,,,,,,
459,452,264,459,452,264,,,0,0,0,,,,,,
459,453,285,459,452,285,,,0,1,0,,,,,,
459,453,308,459,453,307,,,0,0,1,,,,,,
459,453,330,459,453,330,,,0,0,0,,,,,,
460,454,353,460,453,353,,,0,1,0,,,,,,
460,454,376,460,454,377,,,0,0,-1,,,,,,
460,454,400,461,454,400,,,-1,0,0,,,,,,
461,455,424,461,455,424,,,0,0,0,,,,,,
461,455,448,461,455,447,,,0,0,1,,,,,,
462,456,472,461,456,471,,,1,0,1,,,,,,
462,456,496,462,456,496,,,0,0,0,,,,,,
463,457,520,462,457,520,,,1,0,0,,,,,,
463,457,545,463,457,545,,,0,0,0,,,,,,
464,458,570,464,458,569,,,0,0,1,,,,,,
464,459,594,465,458,594,,,-1,1,0,,,,,,
465,459,619,465,459,619,,,0,0,0,,,,,,
466,460,644,466,460,644,,,0,0,0,,,,,,
466,461,669,466,461,669,,,0,0,0,,,,,,
467,462,694,467,461,694,,,0,1,0,,,,,,
468,463,719,468,462,719,,,0,1,0,,,,,,
469,463,744,469,463,744,,,0,0,0,,,,,,
470,464,769,469,464,769,,,1,0,0,,,,,,
466,479,137,466,479,137,,,0,0,0,,,,,,
466,479,138,466,479,137,,,0,0,1,,,,,,
466,479,143,466,479,142,,,0,0,1,,,,,,
466,479,150,466,479,152,,,0,0,-2,,,,,,
466,480,161,466,479,161,,,0,1,0,,,,,,
466,480,175,466,479,175,,,0,1,0,,,,,,
466,480,190,466,479,190,,,0,1,0,,,,,,
466,480,208,466,480,208,,,0,0,0,,,,,,
466,480,227,467,480,227,,,-1,0,0,,,,,,
467,480,246,467,480,247,,,0,0,-1,,,,,,
467,480,267,467,480,267,,,0,0,0,,,,,,
467,481,288,467,480,288,,,0,1,0,,,,,,
467,481,310,467,481,310,,,0,0,0,,,,,,
468,481,333,468,481,333,,,0,0,0,,,,,,
468,482,356,468,481,356,,,0,1,0,,,,,,
468,482,379,468,482,379,,,0,0,0,,,,,,
469,482,402,469,482,402,,,0,0,0,,,,,,
469,483,426,469,482,426,,,0,1,0,,,,,,
469,483,449,469,483,449,,,0,0,0,,,,,,
470,484,473,470,483,473,,,0,1,0,,,,,,
470,484,498,470,484,497,,,0,0,1,,,,,,
471,485,522,471,484,522,,,0,1,0,,,,,,
471,485,546,471,485,546,,,0,0,0,,,,,,
472,486,571,472,485,571,,,0,1,0,,,,,,
473,486,596,473,486,595,,,0,0,1,,,,,,
473,487,620,473,487,620,,,0,0,0,,,,,,
474,488,645,474,488,645,,,0,0,0,,,,,,
475,488,670,475,488,670,,,0,0,0,,,,,,
475,489,695,475,489,695,,,0,0,0,,,,,,
476,490,720,476,490,720,,,0,0,0,,,,,,
477,491,745,477,491,745,,,0,0,0,,,,,,
478,491,770,478,491,770,,,0,0,0,,,,,,
474,508,144,474,507,144,,,0,1,0,,,,,,
474,508,145,474,507,144,,,0,1,1,,,,,,
474,508,149,474,507,149,,,0,1,0,,,,,,
474,508,157,474,507,158,,,0,1,-1,,,,,,
474,508,167,474,507,167,,,0,1,0,,,,,,
475,508,180,474,507,181,,,1,1,-1,,,,,,
475,508,195,475,508,195,,,0,0,0,,,,,,
475,508,212,475,508,213,,,0,0,-1,,,,,,
475,508,231,475,508,231,,,0,0,0,,,,,,
475,508,250,475,508,250,,,0,0,0,,,,,,
475,509,270,475,508,270,,,0,1,0,,,,,,
476,509,292,475,508,292,,,1,1,0,,,,,,
476,509,313,476,509,313,,,0,0,0,,,,,,
476,509,335,476,509,336,,,0,0,-1,,,,,,
476,510,358,476,509,358,,,0,1,0,,,,,,
477,510,381,477,510,381,,,0,0,0,,,,,,
477,510,404,477,510,404,,,0,0,0,,,,,,
477,511,428,477,510,428,,,0,1,0,,,,,,
478,511,451,478,511,451,,,0,0,0,,,,,,
478,511,475,478,511,475,,,0,0,0,,,,,,
479,512,499,479,512,499,,,0,0,0,,,,,,
479,512,524,479,512,523,,,0,0,1,,,,,,
480,513,548,480,513,548,,,0,0,0,,,,,,
480,513,572,480,513,572,,,0,0,0,,,,,,
481,514,597,481,514,597,,,0,0,0,,,,,,
482,515,622,482,514,621,,,0,1,1,,,,,,
482,515,646,483,515,646,,,-1,0,0,,,,,,
483,516,671,483,516,671,,,0,0,0,,,,,,
484,517,696,484,516,696,,,0,1,0,,,,,,
484,517,721,484,517,721,,,0,0,0,,,,,,
485,518,746,485,518,746,,,0,0,0,,,,,,
486,519,771,486,519,771,,,0,0,0,,,,,,
483,536,151,484,536,151,,,-1,0,0,,,,,,
483,536,152,484,536,151,,,-1,0,1,,,,,,
483,536,156,484,536,156,,,-1,0,0,,,,,,
483,536,163,484,536,164,,,-1,0,-1,,,,,,
484,536,173,484,536,173,,,0,0,0,,,,,,
484,536,186,484,536,186,,,0,0,0,,,,,,
484,536,200,484,536,200,,,0,0,0,,,,,,
484,536,217,484,536,217,,,0,0,0,,,,,,
484,536,235,484,536,235,,,0,0,0,,,,,,
484,537,254,484,536,254,,,0,1,0,,,,,,
484,537,274,484,536,274,,,0,1,0,,,,,,
485,537,295,485,537,295,,,0,0,0,,,,,,
485,537,316,485,537,316,,,0,0,0,,,,,,
485,537,338,485,537,338,,,0,0,0,,,,,,
485,538,361,485,537,361,,,0,1,0,,,,,,
486,538,383,486,538,383,,,0,0,0,,,,,,
486,538,407,486,538,406,,,0,0,1,,,,,,
486,539,430,487,539,430,,,-1,0,0,,,,,,
487,539,453,487,539,453,,,0,0,0,,,,,,
487,540,477,487,539,477,,,0,1,0,,,,,,
488,540,501,488,540,501,,,0,0,0,,,,,,
488,540,525,488,540,525,,,0,0,0,,,,,,
489,541,550,489,541,549,,,0,0,1,,,,,,
489,541,574,489,541,574,,,0,0,0,,,,,,
490,542,598,490,542,598,,,0,0,0,,,,,,
491,543,623,491,542,623,,,0,1,0,,,,,,
491,543,648,492,543,647,,,-1,0,1,,,,,,
492,544,673,492,543,672,,,0,1,1,,,,,,
493,544,697,493,544,697,,,0,0,0,,,,,,
493,545,722,493,545,722,,,0,0,0,,,,,,
494,546,747,494,546,747,,,0,0,0,,,,,,
495,547,772,495,546,772,,,0,1,0,,,,,,
493,564,158,493,564,158,,,0,0,0,,,,,,
493,564,159,493,564,158,,,0,0,1,,,,,,
493,564,163,493,564,163,,,0,0,0,,,,,,
493,564,170,493,564,171,,,0,0,-1,,,,,,
493,564,179,493,564,179,,,0,0,0,,,,,,
493,564,191,493,564,192,,,0,0,-1,,,,,,
493,565,206,493,564,206,,,0,1,0,,,,,,
493,565,222,493,564,222,,,0,1,0,,,,,,
493,565,239,493,565,239,,,0,0,0,,,,,,
494,565,258,493,565,258,,,1,0,0,,,,,,
494,565,278,494,565,278,,,0,0,0,,,,,,
494,565,298,494,565,298,,,0,0,0,,,,,,
494,566,320,494,565,319,,,0,1,1,,,,,,
495,566,341,494,565,341,,,1,1,0,,,,,,
495,566,363,495,566,363,,,0,0,0,,,,,,
495,566,386,495,566,386,,,0,0,0,,,,,,
495,567,409,496,567,408,,,-1,0,1,,,,,,
496,567,432,496,567,432,,,0,0,0,,,,,,
496,567,456,496,567,455,,,0,0,1,,,,,,
497,568,479,497,567,479,,,0,1,0,,,,,,
497,568,503,497,568,503,,,0,0,0,,,,,,
498,569,527,498,568,527,,,0,1,0,,,,,,
498,569,551,498,569,551,,,0,0,0,,,,,,
499,570,576,499,569,575,,,0,1,1,,,,,,
499,570,600,499,570,600,,,0,0,0,,,,,,
500,571,625,500,570,624,,,0,1,1,,,,,,
500,571,649,501,571,649,,,-1,0,0,,,,,,
501,572,674,501,571,673,,,0,1,1,,,,,,
502,572,699,502,572,698,,,0,0,1,,,,,,
502,573,724,503,573,723,,,-1,0,1,,,,,,
503,574,749,504,574,748,,,-1,0,1,,,,,,
504,574,774,504,574,773,,,0,0,1,,,,,,
503,593,166,503,593,165,,,0,0,1,,,,,,
503,593,167,503,593,165,,,0,0,2,,,,,,
503,593,170,503,593,170,,,0,0,0,,,,,,
503,593,177,503,593,178,,,0,0,-1,,,,,,
503,593,186,503,593,185,,,0,0,1,,,,,,
503,593,197,503,593,198,,,0,0,-1,,,,,,
503,593,211,503,593,211,,,0,0,0,,,,,,
503,593,227,503,593,227,,,0,0,0,,,,,,
503,593,244,503,593,244,,,0,0,0,,,,,,
503,593,262,503,593,263,,,0,0,-1,,,,,,
504,594,282,504,593,282,,,0,1,0,,,,,,
504,594,302,504,593,302,,,0,1,0,,,,,,
504,594,323,504,594,323,,,0,0,0,,,,,,
504,594,344,504,594,344,,,0,0,0,,,,,,
505,595,366,505,594,366,,,0,1,0,,,,,,
505,595,389,505,595,389,,,0,0,0,,,,,,
505,595,412,505,595,411,,,0,0,1,,,,,,
506,595,435,506,595,434,,,0,0,1,,,,,,
506,596,458,506,595,458,,,0,1,0,,,,,,
506,596,481,507,596,481,,,-1,0,0,,,,,,
507,597,505,507,596,505,,,0,1,0,,,,,,
507,597,529,507,597,529,,,0,0,0,,,,,,
508,597,553,508,597,553,,,0,0,0,,,,,,
508,598,577,508,598,577,,,0,0,0,,,,,,
509,598,602,509,598,601,,,0,0,1,,,,,,
509,599,626,510,599,626,,,-1,0,0,,,,,,
510,599,651,510,599,650,,,0,0,1,,,,,,
511,600,675,511,600,675,,,0,0,0,,,,,,
511,601,700,512,600,700,,,-1,1,0,,,,,,
512,601,725,512,601,725,,,0,0,0,,,,,,
513,602,750,513,602,750,,,0,0,0,,,,,,
514,602,775,514,602,775,,,0,0,0,,,,,,
513,621,173,513,621,173,,,0,0,0,,,,,,
513,621,174,513,621,173,,,0,0,1,,,,,,
513,622,177,513,621,177,,,0,1,0,,,,,,
513,622,183,513,621,184,,,0,1,-1,,,,,,
513,622,192,513,622,192,,,0,0,0,,,,,,
513,622,203,513,622,204,,,0,0,-1,,,,,,
513,622,217,513,622,217,,,0,0,0,,,,,,
513,622,232,513,622,233,,,0,0,-1,,,,,,
513,622,249,513,622,249,,,0,0,0,,,,,,
513,622,267,513,622,267,,,0,0,0,,,,,,
514,622,286,514,622,286,,,0,0,0,,,,,,
514,622,306,514,622,306,,,0,0,0,,,,,,
514,623,326,514,623,326,,,0,0,0,,,,,,
514,623,348,514,623,348,,,0,0,0,,,,,,
515,623,369,515,623,369,,,0,0,0,,,,,,
515,623,392,515,623,392,,,0,0,0,,,,,,
515,624,414,515,624,414,,,0,0,0,,,,,,
516,624,437,516,624,437,,,0,0,0,,,,,,
516,624,460,516,624,460,,,0,0,0,,,,,,
516,625,484,517,624,484,,,-1,1,0,,,,,,
517,625,507,517,625,507,,,0,0,0,,,,,,
517,625,531,517,625,531,,,0,0,0,,,,,,
518,626,555,518,626,555,,,0,0,0,,,,,,
518,626,579,518,626,579,,,0,0,0,,,,,,
519,627,603,519,627,603,,,0,0,0,,,,,,
519,627,628,519,627,628,,,0,0,0,,,,,,
520,628,652,520,628,652,,,0,0,0,,,,,,
521,628,677,521,628,677,,,0,0,0,,,,,,
521,629,702,522,629,701,,,-1,0,1,,,,,,
522,629,726,522,629,726,,,0,0,0,,,,,,
523,630,751,523,630,751,,,0,0,0,,,,,,
523,631,776,524,630,776,,,-1,1,0,,,,,,
523,650,180,524,650,180,,,-1,0,0,,,,,,
523,650,181,524,650,180,,,-1,0,1,,,,,,
523,650,184,524,650,184,,,-1,0,0,,,,,,
523,650,190,524,650,191,,,-1,0,-1,,,,,,
523,650,199,524,650,198,,,-1,0,1,,,,,,
523,650,210,524,650,210,,,-1,0,0,,,,,,
524,650,223,524,650,222,,,0,0,1,,,,,,
524,651,237,524,650,238,,,0,1,-1,,,,,,
524,651,254,524,650,254,,,0,1,0,,,,,,
524,651,271,524,650,272,,,0,1,-1,,,,,,
524,651,290,524,651,290,,,0,0,0,,,,,,
524,651,310,524,651,310,,,0,0,0,,,,,,
525,651,330,525,651,330,,,0,0,0,,,,,,
525,652,351,525,651,351,,,0,1,0,,,,,,
525,652,373,525,652,373,,,0,0,0,,,,,,
525,652,395,525,652,395,,,0,0,0,,,,,,
526,652,417,526,652,417,,,0,0,0,,,,,,
526,653,440,526,652,440,,,0,1,0,,,,,,
526,653,463,527,653,463,,,-1,0,0,,,,,,
527,653,486,527,653,486,,,0,0,0,,,,,,
527,654,510,528,653,509,,,-1,1,1,,,,,,
528,654,533,528,654,533,,,0,0,0,,,,,,
528,654,557,528,654,557,,,0,0,0,,,,,,
529,655,581,529,655,581,,,0,0,0,,,,,,
529,655,605,529,655,605,,,0,0,0,,,,,,
530,656,630,530,656,629,,,0,0,1,,,,,,
530,656,654,531,656,654,,,-1,0,0,,,,,,
531,657,679,531,657,678,,,0,0,1,,,,,,
532,657,703,532,657,703,,,0,0,0,,,,,,
532,658,728,532,658,728,,,0,0,0,,,,,,
533,658,753,533,658,753,,,0,0,0,,,,,,
534,659,778,534,659,777,,,0,0,1,,,,,,
534,679,188,534,679,188,,,0,0,0,,,,,,
534,679,189,534,679,188,,,0,0,1,,,,,,
534,679,192,534,679,192,,,0,0,0,,,,,,
534,679,197,534,679,198,,,0,0,-1,,,,,,
534,679,205,534,679,205,,,0,0,0,,,,,,
534,679,216,534,679,217,,,0,0,-1,,,,,,
534,679,228,534,679,228,,,0,0,0,,,,,,
534,679,243,534,679,243,,,0,0,0,,,,,,
535,679,259,535,679,259,,,0,0,0,,,,,,
535,680,276,535,679,276,,,0,1,0,,,,,,
535,680,295,535,680,294,,,0,0,1,,,,,,
535,680,314,535,680,314,,,0,0,0,,,,,,
535,680,334,535,680,334,,,0,0,0,,,,,,
536,680,355,536,680,355,,,0,0,0,,,,,,
536,680,376,536,681,376,,,0,-1,0,,,,,,
536,681,398,536,681,398,,,0,0,0,,,,,,
536,681,420,536,681,420,,,0,0,0,,,,,,
537,681,443,537,681,443,,,0,0,0,,,,,,
537,682,465,537,682,465,,,0,0,0,,,,,,
538,682,489,538,682,488,,,0,0,1,,,,,,
538,682,512,538,682,512,,,0,0,0,,,,,,
538,683,535,539,682,535,,,-1,1,0,,,,,,
539,683,559,539,683,559,,,0,0,0,,,,,,
539,683,583,540,683,583,,,-1,0,0,,,,,,
540,684,607,540,684,607,,,0,0,0,,,,,,
540,684,632,541,684,631,,,-1,0,1,,,,,,
541,685,656,541,685,656,,,0,0,0,,,,,,
542,685,680,542,685,680,,,0,0,0,,,,,,
542,686,705,542,686,705,,,0,0,0,,,,,,
543,686,730,543,686,729,,,0,0,1,,,,,,
544,687,754,544,687,754,,,0,0,0,,,,,,
544,687,779,544,687,779,,,0,0,0,,,,,,
545,708,195,545,708,195,,,0,0,0,,,,,,
545,708,196,545,708,195,,,0,0,1,,,,,,
545,708,199,545,708,199,,,0,0,0,,,,,,
545,708,204,545,708,205,,,0,0,-1,,,,,,
545,708,212,545,708,212,,,0,0,0,,,,,,
545,708,222,545,708,223,,,0,0,-1,,,,,,
545,708,235,545,708,234,,,0,0,1,,,,,,
546,708,249,546,708,249,,,0,0,0,,,,,,
546,708,264,546,708,264,,,0,0,0,,,,,,
546,708,281,546,708,281,,,0,0,0,,,,,,
546,709,299,546,708,299,,,0,1,0,,,,,,
546,709,318,546,708,318,,,0,1,0,,,,,,
546,709,338,546,709,338,,,0,0,0,,,,,,
547,709,358,547,709,359,,,0,0,-1,,,,,,
547,709,380,547,709,380,,,0,0,0,,,,,,
547,710,401,547,709,401,,,0,1,0,,,,,,
547,710,423,548,710,423,,,-1,0,0,,,,,,
548,710,445,548,710,445,,,0,0,0,,,,,,
548,710,468,548,710,468,,,0,0,0,,,,,,
549,711,491,549,710,491,,,0,1,0,,,,,,
549,711,514,549,711,514,,,0,0,0,,,,,,
549,711,538,550,711,538,,,-1,0,0,,,,,,
550,712,562,550,711,561,,,0,1,1,,,,,,
550,712,585,551,712,585,,,-1,0,0,,,,,,
551,712,609,551,712,609,,,0,0,0,,,,,,
551,713,633,552,713,633,,,-1,0,0,,,,,,
552,713,658,552,713,657,,,0,0,1,,,,,,
553,714,682,553,714,682,,,0,0,0,,,,,,
553,714,707,553,714,706,,,0,0,1,,,,,,
554,715,731,554,715,731,,,0,0,0,,,,,,
554,715,756,555,715,756,,,-1,0,0,,,,,,
555,716,781,555,716,780,,,0,0,1,,,,,,
557,737,203,557,737,203,,,0,0,0,,,,,,
557,737,203,557,737,203,,,0,0,0,,,,,,
557,737,206,557,737,206,,,0,0,0,,,,,,
557,737,211,557,737,212,,,0,0,-1,,,,,,
557,737,219,557,737,219,,,0,0,0,,,,,,
557,737,229,557,737,230,,,0,0,-1,,,,,,
557,737,241,557,737,241,,,0,0,0,,,,,,
557,737,254,557,737,255,,,0,0,-1,,,,,,
557,737,270,557,737,269,,,0,0,1,,,,,,
557,737,286,557,737,286,,,0,0,0,,,,,,
557,738,304,557,737,304,,,0,1,0,,,,,,
558,738,323,557,737,323,,,1,1,0,,,,,,
558,738,342,558,738,342,,,0,0,0,,,,,,
558,738,362,558,738,362,,,0,0,0,,,,,,
558,738,383,558,738,383,,,0,0,0,,,,,,
559,738,405,559,738,405,,,0,0,0,,,,,,
559,739,426,559,739,426,,,0,0,0,,,,,,
559,739,449,559,739,448,,,0,0,1,,,,,,
559,739,471,559,739,471,,,0,0,0,,,,,,
560,739,494,560,739,494,,,0,0,0,,,,,,
560,740,517,560,740,517,,,0,0,0,,,,,,
561,740,540,561,740,540,,,0,0,0,,,,,,
561,740,564,561,740,564,,,0,0,0,,,,,,
562,741,588,562,740,587,,,0,1,1,,,,,,
562,741,611,562,741,611,,,0,0,0,,,,,,
563,742,636,563,741,635,,,0,1,1,,,,,,
563,742,660,563,742,659,,,0,0,1,,,,,,
564,742,684,564,742,684,,,0,0,0,,,,,,
564,743,708,564,743,708,,,0,0,0,,,,,,
565,743,733,565,743,733,,,0,0,0,,,,,,
566,744,758,566,744,757,,,0,0,1,,,,,,
566,744,782,566,744,782,,,0,0,0,,,,,,
568,766,210,568,766,210,,,0,0,0,,,,,,
568,766,211,568,766,210,,,0,0,1,,,,,,
568,766,214,568,766,213,,,0,0,1,,,,,,
568,766,219,568,766,219,,,0,0,0,,,,,,
568,766,226,568,766,226,,,0,0,0,,,,,,
568,766,235,568,766,236,,,0,0,-1,,,,,,
568,766,247,569,766,247,,,-1,0,0,,,,,,
569,766,260,569,766,261,,,0,0,-1,,,,,,
569,766,275,569,766,275,,,0,0,0,,,,,,
569,766,291,569,766,291,,,0,0,0,,,,,,
569,767,309,569,766,308,,,0,1,1,,,,,,
569,767,327,569,766,327,,,0,1,0,,,,,,
569,767,346,569,767,346,,,0,0,0,,,,,,
570,767,366,570,767,366,,,0,0,0,,,,,,
570,767,387,570,767,387,,,0,0,0,,,,,,
570,767,408,570,767,408,,,0,0,0,,,,,,
570,768,430,571,768,430,,,-1,0,0,,,,,,
571,768,452,571,768,452,,,0,0,0,,,,,,
571,768,474,571,768,474,,,0,0,0,,,,,,
571,768,497,571,768,497,,,0,0,0,,,,,,
572,769,520,572,769,519,,,0,0,1,,,,,,
572,769,543,572,769,543,,,0,0,0,,,,,,
573,769,566,573,769,566,,,0,0,0,,,,,,
573,770,590,573,769,590,,,0,1,0,,,,,,
574,770,614,574,770,613,,,0,0,1,,,,,,
574,770,638,574,770,637,,,0,0,1,,,,,,
575,771,662,575,771,661,,,0,0,1,,,,,,
575,771,686,575,771,686,,,0,0,0,,,,,,
576,772,710,576,771,710,,,0,1,0,,,,,,
576,772,735,577,772,734,,,-1,0,1,,,,,,
577,773,759,577,772,759,,,0,1,0,,,,,,
578,773,784,578,773,784,,,0,0,0,,,,,,
580,795,218,580,795,218,,,0,0,0,,,,,,
580,795,218,580,795,218,,,0,0,0,,,,,,
580,795,221,580,795,221,,,0,0,0,,,,,,
580,795,226,580,795,227,,,0,0,-1,,,,,,
580,795,233,580,795,233,,,0,0,0,,,,,,
580,795,242,580,795,243,,,0,0,-1,,,,,,
580,795,253,581,795,253,,,-1,0,0,,,,,,
580,795,266,581,795,266,,,-1,0,0,,,,,,
581,795,281,581,795,280,,,0,0,1,,,,,,
581,796,297,581,795,297,,,0,1,0,,,,,,
581,796,314,581,795,313,,,0,1,1,,,,,,
581,796,332,581,795,332,,,0,1,0,,,,,,
581,796,351,581,796,350,,,0,0,1,,,,,,
581,796,370,581,796,370,,,0,0,0,,,,,,
582,796,391,582,796,390,,,0,0,1,,,,,,
582,796,412,582,796,412,,,0,0,0,,,,,,
582,797,433,582,797,433,,,0,0,0,,,,,,
583,797,455,583,797,455,,,0,0,0,,,,,,
583,797,477,583,797,477,,,0,0,0,,,,,,
583,797,500,583,797,500,,,0,0,0,,,,,,
584,798,522,584,798,522,,,0,0,0,,,,,,
584,798,546,584,798,545,,,0,0,1,,,,,,
584,798,569,585,798,569,,,-1,0,0,,,,,,
585,799,592,585,798,592,,,0,1,0,,,,,,
585,799,616,585,799,616,,,0,0,0,,,,,,
586,799,640,586,799,640,,,0,0,0,,,,,,
586,800,664,586,800,664,,,0,0,0,,,,,,
587,800,688,587,800,688,,,0,0,0,,,,,,
588,801,712,588,800,712,,,0,1,0,,,,,,
588,801,737,588,801,736,,,0,0,1,,,,,,
589,802,761,589,801,761,,,0,1,0,,,,,,
589,802,786,590,802,785,,,-1,0,1,,,,,,
592,824,225,592,824,225,,,0,0,0,,,,,,
592,824,226,592,824,225,,,0,0,1,,,,,,
592,824,229,592,824,228,,,0,0,1,,,,,,
592,824,233,592,824,234,,,0,0,-1,,,,,,
592,824,240,592,824,240,,,0,0,0,,,,,,
592,824,249,592,824,249,,,0,0,0,,,,,,
592,824,260,593,824,259,,,-1,0,1,,,,,,
593,824,272,593,824,273,,,0,0,-1,,,,,,
593,825,286,593,824,286,,,0,1,0,,,,,,
593,825,302,593,824,302,,,0,1,0,,,,,,
593,825,319,593,824,318,,,0,1,1,,,,,,
593,825,337,593,824,336,,,0,1,1,,,,,,
593,825,355,593,825,355,,,0,0,0,,,,,,
594,825,375,594,825,374,,,0,0,1,,,,,,
594,825,395,594,825,394,,,0,0,1,,,,,,
594,826,415,594,825,415,,,0,1,0,,,,,,
594,826,437,594,826,437,,,0,0,0,,,,,,
595,826,458,595,826,458,,,0,0,0,,,,,,
595,826,480,595,826,480,,,0,0,0,,,,,,
595,826,503,595,826,503,,,0,0,0,,,,,,
596,827,525,596,827,525,,,0,0,0,,,,,,
596,827,548,596,827,548,,,0,0,0,,,,,,
596,827,571,597,827,571,,,-1,0,0,,,,,,
597,828,595,597,827,595,,,0,1,0,,,,,,
597,828,618,597,828,618,,,0,0,0,,,,,,
598,828,642,598,828,642,,,0,0,0,,,,,,
598,829,666,598,829,666,,,0,0,0,,,,,,
599,829,690,599,829,690,,,0,0,0,,,,,,
599,830,714,600,829,714,,,-1,1,0,,,,,,
600,830,739,600,830,738,,,0,0,1,,,,,,
601,830,763,601,830,763,,,0,0,0,,,,,,
601,831,788,601,831,787,,,0,0,1,,,,,,
605,853,233,605,853,233,,,0,0,0,,,,,,
605,853,234,605,853,233,,,0,0,1,,,,,,
605,853,236,605,853,236,,,0,0,0,,,,,,
605,853,241,605,853,241,,,0,0,0,,,,,,
605,853,247,605,853,247,,,0,0,0,,,,,,
605,854,256,605,853,256,,,0,1,0,,,,,,
605,854,266,605,853,266,,,0,1,0,,,,,,
605,854,278,605,853,279,,,0,1,-1,,,,,,
605,854,292,605,854,292,,,0,0,0,,,,,,
605,854,308,605,854,308,,,0,0,0,,,,,,
605,854,324,606,854,324,,,-1,0,0,,,,,,
605,854,341,606,854,341,,,-1,0,0,,,,,,
606,854,360,606,854,359,,,0,0,1,,,,,,
606,854,379,606,854,379,,,0,0,0,,,,,,
606,855,399,607,854,398,,,-1,1,1,,,,,,
606,855,419,607,854,419,,,-1,1,0,,,,,,
607,855,440,607,855,440,,,0,0,0,,,,,,
607,855,462,607,855,462,,,0,0,0,,,,,,
607,855,484,608,855,483,,,-1,0,1,,,,,,
608,856,506,608,855,506,,,0,1,0,,,,,,
608,856,528,608,856,528,,,0,0,0,,,,,,
608,856,551,608,856,551,,,0,0,0,,,,,,
609,856,574,609,856,574,,,0,0,0,,,,,,
609,857,598,609,856,597,,,0,1,1,,,,,,
610,857,621,610,857,621,,,0,0,0,,,,,,
610,857,645,610,857,644,,,0,0,1,,,,,,
611,858,668,611,858,668,,,0,0,0,,,,,,
611,858,692,611,858,692,,,0,0,0,,,,,,
612,859,717,612,858,716,,,0,1,1,,,,,,
612,859,741,612,859,740,,,0,0,1,,,,,,
613,859,765,613,859,765,,,0,0,0,,,,,,
613,860,790,613,860,789,,,0,0,1,,,,,,
617,883,241,617,882,240,,,0,1,1,,,,,,
617,883,241,617,882,240,,,0,1,1,,,,,,
617,883,244,617,882,243,,,0,1,1,,,,,,
617,883,248,617,882,248,,,0,1,0,,,,,,
617,883,254,617,882,254,,,0,1,0,,,,,,
617,883,263,617,882,263,,,0,1,0,,,,,,
617,883,273,617,882,272,,,0,1,1,,,,,,
617,883,285,617,883,285,,,0,0,0,,,,,,
618,883,298,617,883,298,,,1,0,0,,,,,,
618,883,313,618,883,313,,,0,0,0,,,,,,
618,883,329,618,883,329,,,0,0,0,,,,,,
618,883,346,618,883,346,,,0,0,0,,,,,,
618,883,365,618,883,364,,,0,0,1,,,,,,
618,884,384,619,883,383,,,-1,1,1,,,,,,
619,884,403,619,883,403,,,0,1,0,,,,,,
619,884,423,619,884,423,,,0,0,0,,,,,,
619,884,444,619,884,444,,,0,0,0,,,,,,
619,884,465,620,884,465,,,-1,0,0,,,,,,
620,885,487,620,884,487,,,0,1,0,,,,,,
620,885,509,620,885,509,,,0,0,0,,,,,,
620,885,532,620,885,531,,,0,0,1,,,,,,
621,885,554,621,885,554,,,0,0,0,,,,,,
621,886,577,621,885,577,,,0,1,0,,,,,,
622,886,600,622,886,600,,,0,0,0,,,,,,
622,886,624,622,886,623,,,0,0,1,,,,,,
623,887,647,623,886,647,,,0,1,0,,,,,,
623,887,671,623,887,671,,,0,0,0,,,,,,
624,887,695,624,887,694,,,0,0,1,,,,,,
624,888,719,624,887,718,,,0,1,1,,,,,,
625,888,743,625,888,743,,,0,0,0,,,,,,
625,888,767,625,888,767,,,0,0,0,,,,,,
626,889,792,626,889,791,,,0,0,1,,,,,,
422,117,64,422,117,64,,,0,0,0,,,,,,
422,117,67,422,117,64,,,0,0,3,,,,,,
422,117,76,422,117,76,,,0,0,0,,,,,,
422,117,90,422,117,92,,,0,0,-2,,,,,,
422,117,108,422,117,108,,,0,0,0,,,,,,
422,118,128,422,117,128,,,0,1,0,,,,,,
423,118,149,423,118,149,,,0,0,0,,,,,,
423,119,172,423,119,171,,,0,0,1,,,,,,
423,120,194,423,120,194,,,0,0,0,,,,,,
423,121,217,423,121,217,,,0,0,0,,,,,,
423,122,241,423,122,241,,,0,0,0,,,,,,
424,123,265,423,123,265,,,1,0,0,,,,,,
424,124,289,424,124,289,,,0,0,0,,,,,,
424,125,313,424,125,313,,,0,0,0,,,,,,
425,127,337,425,127,337,,,0,0,0,,,,,,
425,128,361,425,128,361,,,0,0,0,,,,,,
425,130,386,425,130,386,,,0,0,0,,,,,,
426,132,411,425,131,410,,,1,1,1,,,,,,
426,133,435,426,133,435,,,0,0,0,,,,,,
427,135,460,426,135,460,,,1,0,0,,,,,,
427,137,485,427,137,485,,,0,0,0,,,,,,
428,139,510,428,139,510,,,0,0,0,,,,,,
429,142,535,429,142,535,,,0,0,0,,,,,,
429,144,560,429,144,560,,,0,0,0,,,,,,
430,146,585,430,146,585,,,0,0,0,,,,,,
431,149,611,430,148,610,,,1,1,1,,,,,,
431,151,636,431,151,636,,,0,0,0,,,,,,
432,154,661,432,154,661,,,0,0,0,,,,,,
433,157,686,433,157,686,,,0,0,0,,,,,,
434,159,712,434,159,711,,,0,0,1,,,,,,
435,162,737,435,162,737,,,0,0,0,,,,,,
435,165,763,435,165,762,,,0,0,1,,,,,,
422,119,64,422,117,64,,,0,2,0,,,,,,
422,119,67,422,117,64,,,0,2,3,,,,,,
422,119,76,422,117,76,,,0,2,0,,,,,,
422,119,91,422,117,92,,,0,2,-1,,,,,,
423,119,108,422,117,108,,,1,2,0,,,,,,
423,120,128,422,117,128,,,1,3,0,,,,,,
423,120,150,423,118,149,,,0,2,1,,,,,,
423,121,172,423,119,171,,,0,2,1,,,,,,
423,122,194,423,120,194,,,0,2,0,,,,,,
423,122,218,423,121,217,,,0,1,1,,,,,,
423,123,241,423,122,241,,,0,1,0,,,,,,
424,124,265,423,123,265,,,1,1,0,,,,,,
424,126,289,424,124,289,,,0,2,0,,,,,,
424,127,313,424,125,313,,,0,2,0,,,,,,
425,128,337,425,127,337,,,0,1,0,,,,,,
425,130,362,425,128,361,,,0,2,1,,,,,,
425,131,386,425,130,386,,,0,1,0,,,,,,
426,133,411,425,131,410,,,1,2,1,,,,,,
426,135,435,426,133,435,,,0,2,0,,,,,,
427,137,460,426,135,460,,,1,2,0,,,,,,
427,139,485,427,137,485,,,0,2,0,,,,,,
428,141,510,428,139,510,,,0,2,0,,,,,,
429,143,535,429,142,535,,,0,1,0,,,,,,
429,145,560,429,144,560,,,0,1,0,,,,,,
430,148,585,430,146,585,,,0,2,0,,,,,,
431,150,611,430,148,610,,,1,2,1,,,,,,
431,153,636,431,151,636,,,0,2,0,,,,,,
432,155,661,432,154,661,,,0,1,0,,,,,,
433,158,686,433,157,686,,,0,1,0,,,,,,
434,161,712,434,159,711,,,0,2,1,,,,,,
435,163,737,435,162,737,,,0,1,0,,,,,,
436,166,763,435,165,762,,,1,1,1,,,,,,
423,126,65,423,126,65,,,0,0,0,,,,,,
423,126,68,423,126,65,,,0,0,3,,,,,,
423,126,77,423,126,77,,,0,0,0,,,,,,
423,126,91,423,126,93,,,0,0,-2,,,,,,
423,126,109,423,126,109,,,0,0,0,,,,,,
423,127,129,423,126,129,,,0,1,0,,,,,,
423,127,150,423,127,150,,,0,0,0,,,,,,
423,128,172,423,127,172,,,0,1,0,,,,,,
424,128,195,424,128,195,,,0,0,0,,,,,,
424,129,218,424,129,218,,,0,0,0,,,,,,
424,130,241,424,130,241,,,0,0,0,,,,,,
424,131,265,424,131,265,,,0,0,0,,,,,,
425,132,289,425,132,289,,,0,0,0,,,,,,
425,133,313,425,133,313,,,0,0,0,,,,,,
425,135,337,425,135,337,,,0,0,0,,,,,,
426,136,362,425,136,361,,,1,0,1,,,,,,
426,138,386,426,138,386,,,0,0,0,,,,,,
426,139,411,426,139,411,,,0,0,0,,,,,,
427,141,436,427,141,436,,,0,0,0,,,,,,
427,143,460,427,143,460,,,0,0,0,,,,,,
428,145,485,428,145,485,,,0,0,0,,,,,,
429,147,510,428,147,510,,,1,0,0,,,,,,
429,149,535,429,149,535,,,0,0,0,,,,,,
430,151,560,429,151,560,,,1,0,0,,,,,,
430,153,585,430,153,585,,,0,0,0,,,,,,
431,156,611,431,155,610,,,0,1,1,,,,,,
432,158,636,432,158,636,,,0,0,0,,,,,,
433,160,661,432,160,661,,,1,0,0,,,,,,
433,163,686,433,163,686,,,0,0,0,,,,,,
434,166,712,434,165,711,,,0,1,1,,,,,,
435,168,737,435,168,737,,,0,0,0,,,,,,
436,171,763,436,171,762,,,0,0,1,,,,,,
424,137,67,424,139,67,,,0,-2,0,,,,,,
424,137,69,424,139,67,,,0,-2,2,,,,,,
424,137,78,424,139,78,,,0,-2,0,,,,,,
424,138,92,424,139,94,,,0,-1,-2,,,,,,
424,138,110,424,140,110,,,0,-2,0,,,,,,
424,138,129,424,140,130,,,0,-2,-1,,,,,,
424,139,151,424,140,150,,,0,-1,1,,,,,,
424,139,172,424,141,173,,,0,-2,-1,,,,,,
424,140,195,425,141,195,,,-1,-1,0,,,,,,
425,141,218,425,142,218,,,0,-1,0,,,,,,
425,141,242,425,143,241,,,0,-2,1,,,,,,
425,142,265,425,144,265,,,0,-2,0,,,,,,
425,143,289,426,145,289,,,-1,-2,0,,,,,,
426,144,313,426,146,313,,,0,-2,0,,,,,,
426,146,337,426,148,337,,,0,-2,0,,,,,,
427,147,362,426,149,362,,,1,-2,0,,,,,,
427,148,386,427,150,386,,,0,-2,0,,,,,,
427,150,411,427,152,411,,,0,-2,0,,,,,,
428,151,436,428,153,436,,,0,-2,0,,,,,,
428,153,460,428,155,460,,,0,-2,0,,,,,,
429,155,485,429,157,485,,,0,-2,0,,,,,,
429,157,510,429,158,510,,,0,-1,0,,,,,,
430,159,535,430,160,535,,,0,-1,0,,,,,,
431,161,560,430,162,560,,,1,-1,0,,,,,,
431,163,586,431,164,585,,,0,-1,1,,,,,,
432,165,611,432,166,610,,,0,-1,1,,,,,,
433,167,636,433,169,636,,,0,-2,0,,,,,,
434,170,661,433,171,661,,,1,-1,0,,,,,,
434,172,687,434,174,686,,,0,-2,1,,,,,,
435,174,712,435,176,712,,,0,-2,0,,,,,,
436,177,737,436,178,737,,,0,-1,0,,,,,,
437,180,763,437,181,762,,,0,-1,1,,,,,,
425,153,69,425,153,69,,,0,0,0,,,,,,
425,153,71,425,153,69,,,0,0,2,,,,,,
425,153,80,425,153,80,,,0,0,0,,,,,,
425,153,94,425,153,95,,,0,0,-1,,,,,,
425,154,111,425,154,111,,,0,0,0,,,,,,
425,154,131,425,154,131,,,0,0,0,,,,,,
426,154,151,426,154,151,,,0,0,0,,,,,,
426,155,173,426,154,173,,,0,1,0,,,,,,
426,155,196,426,155,196,,,0,0,0,,,,,,
426,156,219,426,156,219,,,0,0,0,,,,,,
426,157,242,426,157,242,,,0,0,0,,,,,,
427,158,266,426,157,266,,,1,1,0,,,,,,
427,158,290,427,158,290,,,0,0,0,,,,,,
427,159,314,427,159,314,,,0,0,0,,,,,,
428,161,338,428,161,338,,,0,0,0,,,,,,
428,162,362,428,162,362,,,0,0,0,,,,,,
428,163,387,428,163,387,,,0,0,0,,,,,,
429,164,411,428,164,411,,,1,0,0,,,,,,
429,166,436,429,166,436,,,0,0,0,,,,,,
430,167,461,429,167,461,,,1,0,0,,,,,,
430,169,486,430,169,486,,,0,0,0,,,,,,
431,171,511,430,170,511,,,1,1,0,,,,,,
431,172,536,431,172,536,,,0,0,0,,,,,,
432,174,561,432,174,561,,,0,0,0,,,,,,
433,176,586,433,176,586,,,0,0,0,,,,,,
433,178,611,433,178,611,,,0,0,0,,,,,,
434,180,636,434,180,636,,,0,0,0,,,,,,
435,182,661,435,182,661,,,0,0,0,,,,,,
436,185,687,436,185,687,,,0,0,0,,,,,,
437,187,712,436,187,712,,,1,0,0,,,,,,
437,189,738,437,189,738,,,0,0,0,,,,,,
438,192,763,438,191,763,,,0,1,0,,,,,,
427,172,72,427,173,72,,,0,-1,0,,,,,,
427,172,74,427,173,72,,,0,-1,2,,,,,,
427,172,83,427,173,83,,,0,-1,0,,,,,,
427,172,96,427,173,98,,,0,-1,-2,,,,,,
427,173,113,427,174,113,,,0,-1,0,,,,,,
427,173,132,427,174,132,,,0,-1,0,,,,,,
427,173,153,428,174,152,,,-1,-1,1,,,,,,
428,174,174,428,174,174,,,0,0,0,,,,,,
428,174,197,428,175,197,,,0,-1,0,,,,,,
428,175,220,428,175,220,,,0,0,0,,,,,,
428,175,243,428,176,243,,,0,-1,0,,,,,,
428,176,266,428,177,266,,,0,-1,0,,,,,,
429,177,290,429,177,290,,,0,0,0,,,,,,
429,178,314,429,178,314,,,0,0,0,,,,,,
429,179,338,430,180,338,,,-1,-1,0,,,,,,
430,180,363,430,181,363,,,0,-1,0,,,,,,
430,181,387,430,182,387,,,0,-1,0,,,,,,
431,182,412,430,183,412,,,1,-1,0,,,,,,
431,183,436,431,184,436,,,0,-1,0,,,,,,
432,185,461,431,186,461,,,1,-1,0,,,,,,
432,186,486,432,187,486,,,0,-1,0,,,,,,
433,188,511,432,188,511,,,1,0,0,,,,,,
433,189,536,433,190,536,,,0,-1,0,,,,,,
434,191,561,434,192,561,,,0,-1,0,,,,,,
435,193,586,435,194,586,,,0,-1,0,,,,,,
435,194,611,435,195,611,,,0,-1,0,,,,,,
436,196,636,436,197,636,,,0,-1,0,,,,,,
437,198,662,437,199,661,,,0,-1,1,,,,,,
438,200,687,438,201,687,,,0,-1,0,,,,,,
438,202,712,438,203,712,,,0,-1,0,,,,,,
439,204,738,439,205,738,,,0,-1,0,,,,,,
440,207,763,440,207,763,,,0,0,0,,,,,,
429,193,75,429,193,75,,,0,0,0,,,,,,
429,193,78,429,193,75,,,0,0,3,,,,,,
429,193,86,429,193,86,,,0,0,0,,,,,,
430,193,99,429,193,100,,,1,0,-1,,,,,,
430,194,115,430,194,115,,,0,0,0,,,,,,
430,194,134,430,194,134,,,0,0,0,,,,,,
430,194,154,430,194,154,,,0,0,0,,,,,,
430,195,176,430,194,176,,,0,1,0,,,,,,
430,195,198,430,195,198,,,0,0,0,,,,,,
430,195,221,430,195,221,,,0,0,0,,,,,,
431,196,244,431,196,244,,,0,0,0,,,,,,
431,197,267,431,196,267,,,0,1,0,,,,,,
431,197,291,431,197,291,,,0,0,0,,,,,,
431,198,315,431,198,315,,,0,0,0,,,,,,
432,199,339,432,199,339,,,0,0,0,,,,,,
432,200,363,432,200,363,,,0,0,0,,,,,,
433,201,388,433,201,388,,,0,0,0,,,,,,
433,202,412,433,202,412,,,0,0,0,,,,,,
433,203,437,433,203,437,,,0,0,0,,,,,,
434,204,462,433,204,461,,,1,0,1,,,,,,
434,206,486,434,206,486,,,0,0,0,,,,,,
435,207,511,435,207,511,,,0,0,0,,,,,,
436,208,536,436,208,536,,,0,0,0,,,,,,
436,210,561,436,210,561,,,0,0,0,,,,,,
437,212,586,437,212,586,,,0,0,0,,,,,,
438,213,612,437,213,611,,,1,0,1,,,,,,
438,215,637,438,215,637,,,0,0,0,,,,,,
439,217,662,439,216,662,,,0,1,0,,,,,,
440,218,687,440,218,687,,,0,0,0,,,,,,
441,220,713,441,220,712,,,0,0,1,,,,,,
442,222,738,442,222,738,,,0,0,0,,,,,,
442,224,763,442,224,763,,,0,0,0,,,,,,
432,216,80,432,216,79,,,0,0,1,,,,,,
432,216,82,432,216,79,,,0,0,3,,,,,,
432,216,89,432,216,89,,,0,0,0,,,,,,
432,216,102,432,216,103,,,0,0,-1,,,,,,
432,216,118,433,217,118,,,-1,-1,0,,,,,,
433,217,136,433,217,137,,,0,0,-1,,,,,,
433,217,156,433,217,156,,,0,0,0,,,,,,
433,217,177,433,217,177,,,0,0,0,,,,,,
433,218,199,433,218,199,,,0,0,0,,,,,,
433,218,222,433,218,222,,,0,0,0,,,,,,
433,219,245,434,219,245,,,-1,0,0,,,,,,
434,219,268,434,219,268,,,0,0,0,,,,,,
434,220,292,434,220,292,,,0,0,0,,,,,,
434,220,316,434,221,316,,,0,-1,0,,,,,,
435,221,340,435,222,340,,,0,-1,0,,,,,,
435,222,364,435,222,364,,,0,0,0,,,,,,
435,223,388,436,223,388,,,-1,0,0,,,,,,
436,224,413,436,224,413,,,0,0,0,,,,,,
436,225,437,436,225,437,,,0,0,0,,,,,,
437,226,462,437,226,462,,,0,0,0,,,,,,
437,227,487,437,228,487,,,0,-1,0,,,,,,
438,228,512,438,229,511,,,0,-1,1,,,,,,
438,230,537,439,230,536,,,-1,0,1,,,,,,
439,231,562,439,231,561,,,0,0,1,,,,,,
440,232,587,440,233,586,,,0,-1,1,,,,,,
440,234,612,440,234,612,,,0,0,0,,,,,,
441,235,637,441,236,637,,,0,-1,0,,,,,,
442,237,662,442,237,662,,,0,0,0,,,,,,
443,239,688,443,239,687,,,0,0,1,,,,,,
443,240,713,444,241,713,,,-1,-1,0,,,,,,
444,242,738,445,243,738,,,-1,-1,0,,,,,,
445,244,764,445,244,764,,,0,0,0,,,,,,
436,240,84,436,240,84,,,0,0,0,,,,,,
436,240,86,436,240,84,,,0,0,2,,,,,,
436,240,93,436,240,93,,,0,0,0,,,,,,
436,240,105,436,240,107,,,0,0,-2,,,,,,
436,240,121,436,240,121,,,0,0,0,,,,,,
436,241,139,436,240,139,,,0,1,0,,,,,,
436,241,158,436,241,158,,,0,0,0,,,,,,
436,241,179,436,241,179,,,0,0,0,,,,,,
436,241,201,436,241,201,,,0,0,0,,,,,,
437,242,223,436,241,223,,,1,1,0,,,,,,
437,242,246,437,242,246,,,0,0,0,,,,,,
437,243,270,437,242,269,,,0,1,1,,,,,,
437,243,293,437,243,293,,,0,0,0,,,,,,
438,244,317,437,244,317,,,1,0,0,,,,,,
438,245,341,438,245,341,,,0,0,0,,,,,,
438,245,365,438,245,365,,,0,0,0,,,,,,
439,246,389,439,246,389,,,0,0,0,,,,,,
439,247,414,439,247,413,,,0,0,1,,,,,,
440,248,438,440,248,438,,,0,0,0,,,,,,
440,249,463,440,249,463,,,0,0,0,,,,,,
441,250,488,441,250,488,,,0,0,0,,,,,,
441,251,512,441,251,512,,,0,0,0,,,,,,
442,252,537,442,252,537,,,0,0,0,,,,,,
442,253,562,442,253,562,,,0,0,0,,,,,,
443,255,587,443,255,587,,,0,0,0,,,,,,
444,256,612,443,256,612,,,1,0,0,,,,,,
444,257,638,444,257,638,,,0,0,0,,,,,,
445,259,663,445,258,663,,,0,1,0,,,,,,
446,260,688,446,260,688,,,0,0,0,,,,,,
447,262,713,447,262,713,,,0,0,0,,,,,,
448,264,739,448,264,739,,,0,0,0,,,,,,
449,265,764,448,265,764,,,1,0,0,,,,,,
440,265,89,440,265,89,,,0,0,0,,,,,,
440,265,91,440,265,89,,,0,0,2,,,,,,
440,265,98,440,265,98,,,0,0,0,,,,,,
440,265,109,440,265,111,,,0,0,-2,,,,,,
440,265,124,440,265,124,,,0,0,0,,,,,,
440,265,142,440,265,142,,,0,0,0,,,,,,
440,266,161,440,266,161,,,0,0,0,,,,,,
440,266,182,440,266,182,,,0,0,0,,,,,,
440,266,203,440,266,203,,,0,0,0,,,,,,
441,267,225,440,266,225,,,1,1,0,,,,,,
441,267,248,441,267,248,,,0,0,0,,,,,,
441,267,271,441,267,271,,,0,0,0,,,,,,
441,268,294,441,268,294,,,0,0,0,,,,,,
442,269,318,441,268,318,,,1,1,0,,,,,,
442,269,342,442,269,342,,,0,0,0,,,,,,
442,270,366,442,270,366,,,0,0,0,,,,,,
443,271,390,443,271,390,,,0,0,0,,,,,,
443,271,415,443,271,414,,,0,0,1,,,,,,
444,272,439,444,272,439,,,0,0,0,,,,,,
444,273,464,444,273,463,,,0,0,1,,,,,,
445,274,488,445,274,488,,,0,0,0,,,,,,
445,275,513,445,275,513,,,0,0,0,,,,,,
446,276,538,446,276,538,,,0,0,0,,,,,,
446,277,563,446,277,563,,,0,0,0,,,,,,
447,278,588,447,279,588,,,0,-1,0,,,,,,
448,279,613,447,280,613,,,1,-1,0,,,,,,
448,281,638,448,281,638,,,0,0,0,,,,,,
449,282,663,449,282,663,,,0,0,0,,,,,,
450,283,689,450,283,688,,,0,0,1,,,,,,
451,285,714,451,285,714,,,0,0,0,,,,,,
451,286,739,452,287,739,,,-1,-1,0,,,,,,
452,288,765,452,288,765,,,0,0,0,,,,,,
444,291,95,444,291,95,,,0,0,0,,,,,,
444,291,96,444,291,95,,,0,0,1,,,,,,
444,291,103,444,291,103,,,0,0,0,,,,,,
444,291,114,444,291,115,,,0,0,-1,,,,,,
444,291,128,444,291,128,,,0,0,0,,,,,,
444,291,145,444,291,146,,,0,0,-1,,,,,,
444,291,164,444,291,164,,,0,0,0,,,,,,
445,291,184,444,291,184,,,1,0,0,,,,,,
445,292,205,445,292,205,,,0,0,0,,,,,,
445,292,227,445,292,227,,,0,0,0,,,,,,
445,292,250,445,292,250,,,0,0,0,,,,,,
445,293,273,445,292,273,,,0,1,0,,,,,,
446,293,296,446,293,296,,,0,0,0,,,,,,
446,294,319,446,293,319,,,0,1,0,,,,,,
446,294,343,446,294,343,,,0,0,0,,,,,,
447,295,367,446,295,367,,,1,0,0,,,,,,
447,296,391,447,296,391,,,0,0,0,,,,,,
447,296,416,447,296,415,,,0,0,1,,,,,,
448,297,440,448,297,440,,,0,0,0,,,,,,
448,298,464,448,298,464,,,0,0,0,,,,,,
449,299,489,449,299,489,,,0,0,0,,,,,,
449,300,514,449,300,514,,,0,0,0,,,,,,
450,301,539,450,301,539,,,0,0,0,,,,,,
451,302,564,450,302,564,,,1,0,0,,,,,,
451,303,589,451,303,589,,,0,0,0,,,,,,
452,304,614,452,304,614,,,0,0,0,,,,,,
453,305,639,453,305,639,,,0,0,0,,,,,,
453,306,664,453,306,664,,,0,0,0,,,,,,
454,307,689,454,307,689,,,0,0,0,,,,,,
455,309,714,455,308,714,,,0,1,0,,,,,,
456,310,740,456,310,740,,,0,0,0,,,,,,
457,311,765,456,311,765,,,1,0,0,,,,,,
449,317,100,449,317,100,,,0,0,0,,,,,,
449,317,102,449,317,100,,,0,0,2,,,,,,
449,317,108,449,317,108,,,0,0,0,,,,,,
449,317,118,449,317,120,,,0,0,-2,,,,,,
449,317,132,449,317,132,,,0,0,0,,,,,,
449,317,149,449,317,149,,,0,0,0,,,,,,
449,317,167,449,317,167,,,0,0,0,,,,,,
450,318,187,449,317,187,,,1,1,0,,,,,,
450,318,208,450,318,207,,,0,0,1,,,,,,
450,318,229,450,318,229,,,0,0,0,,,,,,
450,318,252,450,318,252,,,0,0,0,,,,,,
450,319,274,450,319,274,,,0,0,0,,,,,,
451,319,297,451,319,297,,,0,0,0,,,,,,
451,320,321,451,320,321,,,0,0,0,,,,,,
451,320,345,451,320,344,,,0,0,1,,,,,,
452,321,368,451,321,368,,,1,0,0,,,,,,
452,321,392,452,322,392,,,0,-1,0,,,,,,
452,322,417,452,322,416,,,0,0,1,,,,,,
453,323,441,453,323,441,,,0,0,0,,,,,,
453,323,465,453,323,465,,,0,0,0,,,,,,
454,324,490,454,324,490,,,0,0,0,,,,,,
454,325,515,454,325,515,,,0,0,0,,,,,,
455,326,540,455,326,540,,,0,0,0,,,,,,
455,327,564,455,327,564,,,0,0,0,,,,,,
456,328,589,456,328,589,,,0,0,0,,,,,,
457,329,614,457,329,614,,,0,0,0,,,,,,
457,330,639,458,330,639,,,-1,0,0,,,,,,
458,331,665,458,331,664,,,0,0,1,,,,,,
459,332,690,459,332,690,,,0,0,0,,,,,,
460,333,715,460,333,715,,,0,0,0,,,,,,
461,334,740,461,335,740,,,0,-1,0,,,,,,
461,336,766,461,336,766,,,0,0,0,,,,,,
454,343,106,454,343,106,,,0,0,0,,,,,,
455,343,108,454,343,106,,,1,0,2,,,,,,
455,344,114,455,344,114,,,0,0,0,,,,,,
455,344,123,455,344,125,,,0,0,-2,,,,,,
455,344,137,455,344,137,,,0,0,0,,,,,,
455,344,152,455,344,153,,,0,0,-1,,,,,,
455,344,170,455,344,170,,,0,0,0,,,,,,
455,344,190,455,344,190,,,0,0,0,,,,,,
455,344,210,455,344,210,,,0,0,0,,,,,,
455,345,232,455,344,232,,,0,1,0,,,,,,
456,345,254,456,345,254,,,0,0,0,,,,,,
456,345,276,456,345,276,,,0,0,0,,,,,,
456,346,299,456,346,299,,,0,0,0,,,,,,
456,346,323,456,346,322,,,0,0,1,,,,,,
457,347,346,457,347,346,,,0,0,0,,,,,,
457,347,370,457,347,370,,,0,0,0,,,,,,
457,348,394,457,348,394,,,0,0,0,,,,,,
458,348,418,457,348,418,,,1,0,0,,,,,,
458,349,442,458,349,442,,,0,0,0,,,,,,
459,349,467,458,349,466,,,1,0,1,,,,,,
459,350,491,459,350,491,,,0,0,0,,,,,,
460,351,516,459,351,516,,,1,0,0,,,,,,
460,352,541,460,352,541,,,0,0,0,,,,,,
461,353,565,460,352,565,,,1,1,0,,,,,,
461,353,590,461,353,590,,,0,0,0,,,,,,
462,354,615,462,354,615,,,0,0,0,,,,,,
463,355,640,463,355,640,,,0,0,0,,,,,,
464,356,665,463,356,665,,,1,0,0,,,,,,
464,357,691,464,357,691,,,0,0,0,,,,,,
465,358,716,465,358,716,,,0,0,0,,,,,,
466,360,741,466,360,741,,,0,0,0,,,,,,
467,361,766,467,361,766,,,0,0,0,,,,,,
460,370,112,460,370,112,,,0,0,0,,,,,,
460,370,114,460,370,112,,,0,0,2,,,,,,
460,370,119,461,371,119,,,-1,-1,0,,,,,,
461,371,129,461,371,130,,,0,0,-1,,,,,,
461,371,141,461,371,141,,,0,0,0,,,,,,
461,371,157,461,371,157,,,0,0,0,,,,,,
461,371,174,461,371,174,,,0,0,0,,,,,,
461,371,193,461,371,193,,,0,0,0,,,,,,
461,371,213,461,371,213,,,0,0,0,,,,,,
461,372,234,461,371,235,,,0,1,-1,,,,,,
461,372,256,462,372,256,,,-1,0,0,,,,,,
462,372,279,462,372,278,,,0,0,1,,,,,,
462,372,301,462,373,301,,,0,-1,0,,,,,,
462,373,324,462,373,324,,,0,0,0,,,,,,
463,373,348,463,373,348,,,0,0,0,,,,,,
463,374,371,463,374,371,,,0,0,0,,,,,,
463,374,395,463,374,395,,,0,0,0,,,,,,
464,375,419,463,375,419,,,1,0,0,,,,,,
464,375,443,464,375,443,,,0,0,0,,,,,,
465,376,468,464,376,468,,,1,0,0,,,,,,
465,377,492,465,376,492,,,0,1,0,,,,,,
466,377,517,465,377,517,,,1,0,0,,,,,,
466,378,542,466,378,542,,,0,0,0,,,,,,
467,379,566,466,379,566,,,1,0,0,,,,,,
467,380,591,467,379,591,,,0,1,0,,,,,,
468,380,616,468,380,616,,,0,0,0,,,,,,
469,381,641,469,381,641,,,0,0,0,,,,,,
469,382,666,469,382,666,,,0,0,0,,,,,,
470,383,691,470,383,691,,,0,0,0,,,,,,
471,384,717,471,384,716,,,0,0,1,,,,,,
472,385,742,472,386,742,,,0,-1,0,,,,,,
472,386,767,473,387,767,,,-1,-1,0,,,,,,
467,398,119,467,398,119,,,0,0,0,,,,,,
467,398,120,467,398,119,,,0,0,1,,,,,,
467,398,125,467,398,125,,,0,0,0,,,,,,
467,398,134,467,398,135,,,0,0,-1,,,,,,
467,398,146,467,398,146,,,0,0,0,,,,,,
467,398,161,467,398,162,,,0,0,-1,,,,,,
467,398,178,467,398,178,,,0,0,0,,,,,,
467,398,197,467,398,197,,,0,0,0,,,,,,
467,398,217,467,398,217,,,0,0,0,,,,,,
468,399,237,467,398,238,,,1,1,-1,,,,,,
468,399,259,468,399,259,,,0,0,0,,,,,,
468,399,281,468,399,281,,,0,0,0,,,,,,
468,400,303,468,400,303,,,0,0,0,,,,,,
469,400,326,468,400,326,,,1,0,0,,,,,,
469,400,350,469,400,350,,,0,0,0,,,,,,
469,401,373,469,400,373,,,0,1,0,,,,,,
470,401,397,470,401,397,,,0,0,0,,,,,,
470,402,421,470,401,421,,,0,1,0,,,,,,
470,402,445,470,402,445,,,0,0,0,,,,,,
471,403,469,470,402,469,,,1,1,0,,,,,,
471,403,494,471,403,494,,,0,0,0,,,,,,
472,404,518,471,404,518,,,1,0,0,,,,,,
472,405,543,472,405,543,,,0,0,0,,,,,,
473,405,567,473,405,567,,,0,0,0,,,,,,
474,406,592,474,406,592,,,0,0,0,,,,,,
474,407,617,474,407,617,,,0,0,0,,,,,,
475,408,642,475,408,642,,,0,0,0,,,,,,
476,409,667,475,409,667,,,1,0,0,,,,,,
476,410,692,476,410,692,,,0,0,0,,,,,,
477,411,717,477,411,717,,,0,0,0,,,,,,
478,412,743,478,412,743,,,0,0,0,,,,,,
479,413,768,479,413,768,,,0,0,0,,,,,,
474,425,125,474,425,125,,,0,0,0,,,,,,
474,425,127,474,425,125,,,0,0,2,,,,,,
474,425,131,474,425,131,,,0,0,0,,,,,,
474,425,140,474,425,141,,,0,0,-1,,,,,,
474,425,152,474,425,151,,,0,0,1,,,,,,
474,425,166,474,425,167,,,0,0,-1,,,,,,
474,426,182,474,425,182,,,0,1,0,,,,,,
474,426,201,474,425,201,,,0,1,0,,,,,,
474,426,220,474,426,220,,,0,0,0,,,,,,
475,426,240,474,426,241,,,1,0,-1,,,,,,
475,426,262,475,426,262,,,0,0,0,,,,,,
475,427,283,475,427,283,,,0,0,0,,,,,,
475,427,306,475,427,305,,,0,0,1,,,,,,
475,427,329,475,427,328,,,0,0,1,,,,,,
476,428,352,476,427,352,,,0,1,0,,,,,,
476,428,375,476,428,375,,,0,0,0,,,,,,
476,428,399,477,428,399,,,-1,0,0,,,,,,
477,429,422,477,429,422,,,0,0,0,,,,,,
477,429,446,477,429,446,,,0,0,0,,,,,,
478,430,471,477,430,470,,,1,0,1,,,,,,
478,431,495,478,430,495,,,0,1,0,,,,,,
479,431,519,478,431,519,,,1,0,0,,,,,,
479,432,544,479,432,544,,,0,0,0,,,,,,
480,432,569,480,432,568,,,0,0,1,,,,,,
480,433,593,481,433,593,,,-1,0,0,,,,,,
481,434,618,481,434,618,,,0,0,0,,,,,,
482,435,643,482,435,643,,,0,0,0,,,,,,
482,435,668,482,435,668,,,0,0,0,,,,,,
483,436,693,483,436,693,,,0,0,0,,,,,,
484,437,718,484,437,718,,,0,0,0,,,,,,
485,438,743,485,438,743,,,0,0,0,,,,,,
485,439,769,485,439,768,,,0,0,1,,,,,,
481,453,132,481,453,132,,,0,0,0,,,,,,
481,453,133,481,453,132,,,0,0,1,,,,,,
481,453,138,481,453,138,,,0,0,0,,,,,,
481,453,146,481,453,147,,,0,0,-1,,,,,,
481,453,157,481,453,157,,,0,0,0,,,,,,
481,453,171,481,453,172,,,0,0,-1,,,,,,
481,453,187,481,453,187,,,0,0,0,,,,,,
482,453,205,481,453,205,,,1,0,0,,,,,,
482,454,224,482,454,224,,,0,0,0,,,,,,
482,454,244,482,454,244,,,0,0,0,,,,,,
482,454,265,482,454,265,,,0,0,0,,,,,,
482,454,286,482,454,286,,,0,0,0,,,,,,
483,455,308,483,455,308,,,0,0,0,,,,,,
483,455,331,483,455,331,,,0,0,0,,,,,,
483,455,354,483,455,354,,,0,0,0,,,,,,
483,456,377,483,455,377,,,0,1,0,,,,,,
484,456,401,484,456,401,,,0,0,0,,,,,,
484,456,424,484,456,424,,,0,0,0,,,,,,
485,457,448,485,457,448,,,0,0,0,,,,,,
485,457,472,485,457,472,,,0,0,0,,,,,,
485,458,496,485,458,496,,,0,0,0,,,,,,
486,458,521,485,458,520,,,1,0,1,,,,,,
486,459,545,486,459,545,,,0,0,0,,,,,,
487,460,570,487,459,570,,,0,1,0,,,,,,
488,460,595,488,460,595,,,0,0,0,,,,,,
488,461,619,488,461,619,,,0,0,0,,,,,,
489,462,644,489,462,644,,,0,0,0,,,,,,
490,463,669,489,462,669,,,1,1,0,,,,,,
490,463,694,490,463,694,,,0,0,0,,,,,,
491,464,719,491,464,719,,,0,0,0,,,,,,
492,465,744,492,465,744,,,0,0,0,,,,,,
493,466,770,492,466,769,,,1,0,1,,,,,,
489,481,139,489,481,139,,,0,0,0,,,,,,
489,481,140,489,481,139,,,0,0,1,,,,,,
489,481,144,489,481,144,,,0,0,0,,,,,,
489,481,152,489,481,153,,,0,0,-1,,,,,,
489,481,163,489,481,162,,,0,0,1,,,,,,
489,481,176,489,481,177,,,0,0,-1,,,,,,
489,481,192,489,481,191,,,0,0,1,,,,,,
489,481,209,489,481,209,,,0,0,0,,,,,,
489,482,228,490,482,228,,,-1,0,0,,,,,,
490,482,247,490,482,248,,,0,0,-1,,,,,,
490,482,268,490,482,268,,,0,0,0,,,,,,
490,482,289,490,482,289,,,0,0,0,,,,,,
490,482,311,490,482,311,,,0,0,0,,,,,,
491,483,333,490,482,333,,,1,1,0,,,,,,
491,483,356,491,483,356,,,0,0,0,,,,,,
491,483,379,491,483,379,,,0,0,0,,,,,,
491,484,403,492,484,403,,,-1,0,0,,,,,,
492,484,426,492,484,426,,,0,0,0,,,,,,
492,485,450,492,484,450,,,0,1,0,,,,,,
493,485,474,492,485,474,,,1,0,0,,,,,,
493,486,498,493,485,498,,,0,1,0,,,,,,
494,486,522,493,486,522,,,1,0,0,,,,,,
494,487,547,494,486,546,,,0,1,1,,,,,,
495,487,571,494,487,571,,,1,0,0,,,,,,
495,488,596,495,487,596,,,0,1,0,,,,,,
496,488,621,496,488,620,,,0,0,1,,,,,,
497,489,645,497,489,645,,,0,0,0,,,,,,
497,490,670,497,490,670,,,0,0,0,,,,,,
498,491,695,498,490,695,,,0,1,0,,,,,,
499,491,720,498,491,720,,,1,0,0,,,,,,
499,492,745,499,492,745,,,0,0,0,,,,,,
500,493,771,500,493,770,,,0,0,1,,,,,,
497,509,146,497,509,146,,,0,0,0,,,,,,
497,509,147,497,509,146,,,0,0,1,,,,,,
497,509,151,497,509,151,,,0,0,0,,,,,,
497,509,158,497,509,159,,,0,0,-1,,,,,,
497,509,168,497,509,168,,,0,0,0,,,,,,
497,509,181,497,509,182,,,0,0,-1,,,,,,
497,509,196,497,509,196,,,0,0,0,,,,,,
497,509,213,497,509,214,,,0,0,-1,,,,,,
498,510,232,498,510,232,,,0,0,0,,,,,,
498,510,251,498,510,251,,,0,0,0,,,,,,
498,510,271,498,510,271,,,0,0,0,,,,,,
498,510,292,498,510,292,,,0,0,0,,,,,,
498,510,314,498,510,314,,,0,0,0,,,,,,
499,511,336,498,510,336,,,1,1,0,,,,,,
499,511,359,499,511,359,,,0,0,0,,,,,,
499,511,382,499,511,382,,,0,0,0,,,,,,
500,512,405,500,512,405,,,0,0,0,,,,,,
500,512,428,500,512,428,,,0,0,0,,,,,,
500,512,452,500,512,452,,,0,0,0,,,,,,
501,513,476,500,512,476,,,1,1,0,,,,,,
501,513,500,501,513,500,,,0,0,0,,,,,,
502,514,524,501,513,524,,,1,1,0,,,,,,
502,514,548,502,514,548,,,0,0,0,,,,,,
503,515,573,502,514,572,,,1,1,1,,,,,,
503,515,597,503,515,597,,,0,0,0,,,,,,
504,516,622,504,516,622,,,0,0,0,,,,,,
505,517,647,505,517,647,,,0,0,0,,,,,,
505,517,672,505,517,671,,,0,0,1,,,,,,
506,518,696,506,518,696,,,0,0,0,,,,,,
507,519,721,506,519,721,,,1,0,0,,,,,,
507,520,746,507,520,746,,,0,0,0,,,,,,
508,520,772,508,520,771,,,0,0,1,,,,,,
506,537,153,506,537,153,,,0,0,0,,,,,,
506,537,154,506,537,153,,,0,0,1,,,,,,
506,537,158,506,537,158,,,0,0,0,,,,,,
506,537,165,506,537,166,,,0,0,-1,,,,,,
506,537,175,506,537,174,,,0,0,1,,,,,,
506,537,187,506,537,188,,,0,0,-1,,,,,,
506,537,202,506,537,201,,,0,0,1,,,,,,
506,538,218,506,537,218,,,0,1,0,,,,,,
506,538,236,506,538,236,,,0,0,0,,,,,,
506,538,255,506,538,255,,,0,0,0,,,,,,
507,538,275,506,538,275,,,1,0,0,,,,,,
507,538,296,506,538,296,,,1,0,0,,,,,,
507,539,317,507,538,317,,,0,1,0,,,,,,
507,539,339,507,538,339,,,0,1,0,,,,,,
508,539,361,507,539,361,,,1,0,0,,,,,,
508,539,384,508,539,384,,,0,0,0,,,,,,
508,540,407,508,540,407,,,0,0,0,,,,,,
509,540,430,508,540,430,,,1,0,0,,,,,,
509,540,454,509,540,454,,,0,0,0,,,,,,
509,541,478,509,540,477,,,0,1,1,,,,,,
510,541,502,510,541,501,,,0,0,1,,,,,,
510,542,526,510,541,525,,,0,1,1,,,,,,
511,542,550,511,542,550,,,0,0,0,,,,,,
511,543,574,511,542,574,,,0,1,0,,,,,,
512,543,599,512,543,598,,,0,0,1,,,,,,
512,544,623,512,543,623,,,0,1,0,,,,,,
513,545,648,513,544,648,,,0,1,0,,,,,,
514,545,673,514,545,672,,,0,0,1,,,,,,
514,546,698,514,546,697,,,0,0,1,,,,,,
515,546,723,515,546,722,,,0,0,1,,,,,,
516,547,748,516,547,747,,,0,0,1,,,,,,
516,548,773,516,548,772,,,0,0,1,,,,,,
515,566,160,515,566,160,,,0,0,0,,,,,,
515,566,161,515,566,160,,,0,0,1,,,,,,
515,566,165,515,566,165,,,0,0,0,,,,,,
515,566,171,515,566,173,,,0,0,-2,,,,,,
515,566,181,515,566,181,,,0,0,0,,,,,,
515,566,193,515,566,194,,,0,0,-1,,,,,,
515,566,207,515,566,207,,,0,0,0,,,,,,
515,566,223,515,566,223,,,0,0,0,,,,,,
515,566,240,515,566,240,,,0,0,0,,,,,,
515,566,259,515,566,259,,,0,0,0,,,,,,
515,566,279,515,566,279,,,0,0,0,,,,,,
516,567,299,515,566,299,,,1,1,0,,,,,,
516,567,320,516,567,320,,,0,0,0,,,,,,
516,567,342,516,567,342,,,0,0,0,,,,,,
516,567,364,516,567,364,,,0,0,0,,,,,,
517,568,387,516,567,386,,,1,1,1,,,,,,
517,568,409,517,568,409,,,0,0,0,,,,,,
517,568,433,517,568,432,,,0,0,1,,,,,,
518,569,456,518,569,456,,,0,0,0,,,,,,
518,569,480,518,569,479,,,0,0,1,,,,,,
519,569,503,519,569,503,,,0,0,0,,,,,,
519,570,527,519,569,527,,,0,1,0,,,,,,
520,570,552,520,570,552,,,0,0,0,,,,,,
520,571,576,520,570,576,,,0,1,0,,,,,,
521,571,600,521,571,600,,,0,0,0,,,,,,
521,572,625,521,571,624,,,0,1,1,,,,,,
522,572,649,522,572,649,,,0,0,0,,,,,,
522,573,674,522,573,674,,,0,0,0,,,,,,
523,574,699,523,574,699,,,0,0,0,,,,,,
524,574,724,524,574,724,,,0,0,0,,,,,,
525,575,749,525,575,749,,,0,0,0,,,,,,
525,576,774,525,575,774,,,0,1,0,,,,,,
524,594,167,524,594,167,,,0,0,0,,,,,,
524,594,168,524,594,167,,,0,0,1,,,,,,
524,594,172,524,594,172,,,0,0,0,,,,,,
524,594,178,524,594,179,,,0,0,-1,,,,,,
524,594,187,524,594,187,,,0,0,0,,,,,,
524,594,199,524,594,199,,,0,0,0,,,,,,
524,594,212,524,594,212,,,0,0,0,,,,,,
524,594,228,524,594,228,,,0,0,0,,,,,,
524,595,245,524,594,245,,,0,1,0,,,,,,
525,595,263,524,594,264,,,1,1,-1,,,,,,
525,595,283,524,594,283,,,1,1,0,,,,,,
525,595,303,525,595,303,,,0,0,0,,,,,,
525,595,324,525,595,323,,,0,0,1,,,,,,
525,595,345,525,595,345,,,0,0,0,,,,,,
526,596,367,525,595,367,,,1,1,0,,,,,,
526,596,389,526,596,389,,,0,0,0,,,,,,
526,596,412,526,596,412,,,0,0,0,,,,,,
527,597,435,527,596,435,,,0,1,0,,,,,,
527,597,458,527,597,458,,,0,0,0,,,,,,
528,597,482,528,597,482,,,0,0,0,,,,,,
528,598,506,528,597,505,,,0,1,1,,,,,,
528,598,529,528,598,529,,,0,0,0,,,,,,
529,599,553,529,598,553,,,0,1,0,,,,,,
529,599,578,529,599,577,,,0,0,1,,,,,,
530,600,602,530,599,602,,,0,1,0,,,,,,
530,600,626,530,600,626,,,0,0,0,,,,,,
531,601,651,531,600,651,,,0,1,0,,,,,,
532,601,676,532,601,675,,,0,0,1,,,,,,
532,602,700,532,602,700,,,0,0,0,,,,,,
533,602,725,533,602,725,,,0,0,0,,,,,,
534,603,750,534,603,750,,,0,0,0,,,,,,
534,604,775,534,603,775,,,0,1,0,,,,,,
534,623,174,534,623,174,,,0,0,0,,,,,,
534,623,175,534,623,174,,,0,0,1,,,,,,
534,623,179,534,623,179,,,0,0,0,,,,,,
534,623,185,534,623,186,,,0,0,-1,,,,,,
534,623,193,534,623,193,,,0,0,0,,,,,,
534,623,205,534,623,205,,,0,0,0,,,,,,
534,623,218,534,623,218,,,0,0,0,,,,,,
534,623,233,534,623,234,,,0,0,-1,,,,,,
534,623,250,534,623,250,,,0,0,0,,,,,,
534,623,268,534,623,268,,,0,0,0,,,,,,
534,623,287,534,623,287,,,0,0,0,,,,,,
535,624,306,534,623,307,,,1,1,-1,,,,,,
535,624,327,535,624,327,,,0,0,0,,,,,,
535,624,348,535,624,348,,,0,0,0,,,,,,
535,624,370,535,624,370,,,0,0,0,,,,,,
536,624,392,535,624,392,,,1,0,0,,,,,,
536,625,415,536,625,415,,,0,0,0,,,,,,
536,625,438,536,625,438,,,0,0,0,,,,,,
537,625,461,537,625,461,,,0,0,0,,,,,,
537,626,484,537,625,484,,,0,1,0,,,,,,
538,626,508,538,626,508,,,0,0,0,,,,,,
538,627,531,538,626,531,,,0,1,0,,,,,,
538,627,555,538,627,555,,,0,0,0,,,,,,
539,627,580,538,627,579,,,1,0,1,,,,,,
539,628,604,539,628,604,,,0,0,0,,,,,,
540,628,628,540,628,628,,,0,0,0,,,,,,
541,629,653,541,629,653,,,0,0,0,,,,,,
541,629,677,541,629,677,,,0,0,0,,,,,,
542,630,702,542,630,702,,,0,0,0,,,,,,
542,630,727,542,630,727,,,0,0,0,,,,,,
543,631,752,543,631,752,,,0,0,0,,,,,,
544,632,777,544,631,777,,,0,1,0,,,,,,
544,651,182,544,651,181,,,0,0,1,,,,,,
544,651,182,544,651,181,,,0,0,1,,,,,,
544,651,186,544,651,186,,,0,0,0,,,,,,
544,651,191,544,651,193,,,0,0,-2,,,,,,
544,651,200,544,651,200,,,0,0,0,,,,,,
544,651,211,544,651,211,,,0,0,0,,,,,,
544,652,224,544,651,223,,,0,1,1,,,,,,
544,652,238,544,651,239,,,0,1,-1,,,,,,
544,652,255,544,651,255,,,0,1,0,,,,,,
544,652,272,544,651,273,,,0,1,-1,,,,,,
545,652,291,544,652,291,,,1,0,0,,,,,,
545,652,310,544,652,311,,,1,0,-1,,,,,,
545,652,331,545,652,331,,,0,0,0,,,,,,
545,653,352,545,652,352,,,0,1,0,,,,,,
545,653,373,545,653,373,,,0,0,0,,,,,,
546,653,395,545,653,395,,,1,0,0,,,,,,
546,653,418,546,653,418,,,0,0,0,,,,,,
546,654,440,546,653,440,,,0,1,0,,,,,,
547,654,463,547,654,463,,,0,0,0,,,,,,
547,654,486,547,654,486,,,0,0,0,,,,,,
548,655,510,548,654,510,,,0,1,0,,,,,,
548,655,534,548,655,533,,,0,0,1,,,,,,
548,655,557,548,655,557,,,0,0,0,,,,,,
549,656,581,549,656,581,,,0,0,0,,,,,,
549,656,606,549,656,606,,,0,0,0,,,,,,
550,657,630,550,657,630,,,0,0,0,,,,,,
550,657,654,551,657,654,,,-1,0,0,,,,,,
551,658,679,551,658,679,,,0,0,0,,,,,,
552,658,704,552,658,703,,,0,0,1,,,,,,
552,659,728,552,659,728,,,0,0,0,,,,,,
553,659,753,553,659,753,,,0,0,0,,,,,,
554,660,778,554,660,778,,,0,0,0,,,,,,
554,680,189,554,680,189,,,0,0,0,,,,,,
554,680,190,554,680,189,,,0,0,1,,,,,,
554,680,193,554,680,193,,,0,0,0,,,,,,
554,680,198,554,680,200,,,0,0,-2,,,,,,
554,680,207,554,680,207,,,0,0,0,,,,,,
554,680,217,554,680,218,,,0,0,-1,,,,,,
554,680,229,554,680,229,,,0,0,0,,,,,,
554,680,244,554,680,244,,,0,0,0,,,,,,
555,680,260,555,680,260,,,0,0,0,,,,,,
555,681,277,555,680,277,,,0,1,0,,,,,,
555,681,295,555,681,295,,,0,0,0,,,,,,
555,681,315,555,681,315,,,0,0,0,,,,,,
555,681,335,555,681,335,,,0,0,0,,,,,,
555,681,355,555,681,356,,,0,0,-1,,,,,,
556,682,377,556,682,377,,,0,0,0,,,,,,
556,682,398,556,682,399,,,0,0,-1,,,,,,
556,682,421,556,682,421,,,0,0,0,,,,,,
557,682,443,556,682,443,,,1,0,0,,,,,,
557,683,466,557,683,466,,,0,0,0,,,,,,
557,683,489,557,683,489,,,0,0,0,,,,,,
558,683,512,558,683,512,,,0,0,0,,,,,,
558,684,536,558,683,536,,,0,1,0,,,,,,
559,684,560,559,684,560,,,0,0,0,,,,,,
559,684,584,559,684,584,,,0,0,0,,,,,,
560,685,608,560,685,608,,,0,0,0,,,,,,
560,685,632,560,685,632,,,0,0,0,,,,,,
561,686,656,561,686,656,,,0,0,0,,,,,,
561,686,681,561,686,680,,,0,0,1,,,,,,
562,687,705,562,687,705,,,0,0,0,,,,,,
563,687,730,562,687,730,,,1,0,0,,,,,,
563,688,755,563,688,755,,,0,0,0,,,,,,
564,688,779,564,688,779,,,0,0,0,,,,,,
565,709,196,565,709,196,,,0,0,0,,,,,,
565,709,197,565,709,196,,,0,0,1,,,,,,
565,709,200,565,709,200,,,0,0,0,,,,,,
565,709,205,565,709,206,,,0,0,-1,,,,,,
565,709,213,565,709,213,,,0,0,0,,,,,,
565,709,223,565,709,224,,,0,0,-1,,,,,,
565,709,235,565,709,235,,,0,0,0,,,,,,
565,709,249,565,709,250,,,0,0,-1,,,,,,
565,709,265,565,709,265,,,0,0,0,,,,,,
565,709,282,565,709,282,,,0,0,0,,,,,,
565,710,300,565,709,300,,,0,1,0,,,,,,
566,710,319,565,709,319,,,1,1,0,,,,,,
566,710,339,566,710,339,,,0,0,0,,,,,,
566,710,359,566,710,359,,,0,0,0,,,,,,
566,710,380,566,710,380,,,0,0,0,,,,,,
567,711,402,566,710,402,,,1,1,0,,,,,,
567,711,424,567,711,424,,,0,0,0,,,,,,
567,711,446,567,711,446,,,0,0,0,,,,,,
568,711,469,567,711,468,,,1,0,1,,,,,,
568,712,492,568,711,491,,,0,1,1,,,,,,
568,712,515,568,712,514,,,0,0,1,,,,,,
569,712,538,569,712,538,,,0,0,0,,,,,,
569,713,562,569,712,562,,,0,1,0,,,,,,
570,713,586,570,713,586,,,0,0,0,,,,,,
570,713,610,570,713,610,,,0,0,0,,,,,,
571,714,634,571,714,634,,,0,0,0,,,,,,
571,714,658,571,714,658,,,0,0,0,,,,,,
572,715,682,572,715,682,,,0,0,0,,,,,,
572,715,707,572,715,707,,,0,0,0,,,,,,
573,716,732,573,716,731,,,0,0,1,,,,,,
574,716,756,573,716,756,,,1,0,0,,,,,,
574,717,781,574,717,781,,,0,0,0,,,,,,
576,738,204,576,738,204,,,0,0,0,,,,,,
576,738,205,576,738,204,,,0,0,1,,,,,,
576,738,207,576,738,207,,,0,0,0,,,,,,
576,738,213,576,738,213,,,0,0,0,,,,,,
576,738,220,576,738,220,,,0,0,0,,,,,,
576,738,230,576,738,231,,,0,0,-1,,,,,,
576,738,242,576,738,242,,,0,0,0,,,,,,
576,738,255,576,738,256,,,0,0,-1,,,,,,
576,738,270,576,738,270,,,0,0,0,,,,,,
576,738,287,576,738,287,,,0,0,0,,,,,,
576,738,305,576,738,305,,,0,0,0,,,,,,
577,739,323,576,738,324,,,1,1,-1,,,,,,
577,739,343,577,739,343,,,0,0,0,,,,,,
577,739,363,577,739,363,,,0,0,0,,,,,,
577,739,384,577,739,384,,,0,0,0,,,,,,
578,739,405,577,739,405,,,1,0,0,,,,,,
578,740,427,578,740,427,,,0,0,0,,,,,,
578,740,449,578,740,449,,,0,0,0,,,,,,
578,740,471,578,740,471,,,0,0,0,,,,,,
579,740,494,578,740,494,,,1,0,0,,,,,,
579,741,517,579,741,517,,,0,0,0,,,,,,
580,741,541,579,741,540,,,1,0,1,,,,,,
580,741,564,580,741,564,,,0,0,0,,,,,,
581,742,588,580,741,588,,,1,1,0,,,,,,
581,742,612,581,742,612,,,0,0,0,,,,,,
582,743,636,581,742,636,,,1,1,0,,,,,,
582,743,660,582,743,660,,,0,0,0,,,,,,
583,743,684,582,743,684,,,1,0,0,,,,,,
583,744,709,583,744,709,,,0,0,0,,,,,,
584,744,733,583,744,733,,,1,0,0,,,,,,
584,745,758,584,745,758,,,0,0,0,,,,,,
585,745,783,585,745,782,,,0,0,1,,,,,,
587,767,211,587,767,211,,,0,0,0,,,,,,
587,767,212,587,767,211,,,0,0,1,,,,,,
587,767,215,587,767,214,,,0,0,1,,,,,,
587,767,220,587,767,220,,,0,0,0,,,,,,
587,767,227,587,767,227,,,0,0,0,,,,,,
587,767,236,587,767,237,,,0,0,-1,,,,,,
587,767,248,587,767,248,,,0,0,0,,,,,,
587,767,261,587,767,261,,,0,0,0,,,,,,
587,767,276,587,767,275,,,0,0,1,,,,,,
587,767,292,587,767,292,,,0,0,0,,,,,,
588,767,309,587,767,309,,,1,0,0,,,,,,
588,768,328,587,767,328,,,1,1,0,,,,,,
588,768,347,588,768,347,,,0,0,0,,,,,,
588,768,367,588,768,367,,,0,0,0,,,,,,
588,768,387,588,768,387,,,0,0,0,,,,,,
589,768,409,588,768,409,,,1,0,0,,,,,,
589,769,430,589,769,430,,,0,0,0,,,,,,
589,769,452,589,769,452,,,0,0,0,,,,,,
590,769,474,589,769,474,,,1,0,0,,,,,,
590,769,497,590,769,497,,,0,0,0,,,,,,
590,770,520,590,770,520,,,0,0,0,,,,,,
591,770,543,591,770,543,,,0,0,0,,,,,,
591,770,567,591,770,566,,,0,0,1,,,,,,
592,771,590,591,770,590,,,1,1,0,,,,,,
592,771,614,592,771,614,,,0,0,0,,,,,,
593,771,638,592,771,638,,,1,0,0,,,,,,
593,772,662,593,772,662,,,0,0,0,,,,,,
594,772,686,593,772,686,,,1,0,0,,,,,,
594,773,711,594,772,711,,,0,1,0,,,,,,
595,773,735,595,773,735,,,0,0,0,,,,,,
595,774,760,595,773,759,,,0,1,1,,,,,,
596,774,784,596,774,784,,,0,0,0,,,,,,
598,796,219,598,796,219,,,0,0,0,,,,,,
598,796,219,598,796,219,,,0,0,0,,,,,,
598,796,222,598,796,222,,,0,0,0,,,,,,
598,796,227,598,796,228,,,0,0,-1,,,,,,
598,796,234,598,796,234,,,0,0,0,,,,,,
598,796,243,598,796,244,,,0,0,-1,,,,,,
599,796,254,599,796,254,,,0,0,0,,,,,,
599,796,267,599,796,267,,,0,0,0,,,,,,
599,796,281,599,796,281,,,0,0,0,,,,,,
599,796,297,599,796,297,,,0,0,0,,,,,,
599,796,314,599,796,314,,,0,0,0,,,,,,
599,797,332,599,796,332,,,0,1,0,,,,,,
599,797,351,599,797,351,,,0,0,0,,,,,,
600,797,371,599,797,371,,,1,0,0,,,,,,
600,797,391,600,797,391,,,0,0,0,,,,,,
600,797,412,600,797,412,,,0,0,0,,,,,,
600,798,434,600,798,434,,,0,0,0,,,,,,
601,798,455,600,798,456,,,1,0,-1,,,,,,
601,798,478,601,798,478,,,0,0,0,,,,,,
601,798,500,601,798,500,,,0,0,0,,,,,,
602,799,523,602,799,523,,,0,0,0,,,,,,
602,799,546,602,799,546,,,0,0,0,,,,,,
603,799,569,603,799,569,,,0,0,0,,,,,,
603,800,593,603,799,592,,,0,1,1,,,,,,
603,800,616,603,800,616,,,0,0,0,,,,,,
604,800,640,603,800,640,,,1,0,0,,,,,,
604,801,664,604,801,664,,,0,0,0,,,,,,
605,801,688,605,801,688,,,0,0,0,,,,,,
606,801,713,606,801,713,,,0,0,0,,,,,,
606,802,737,606,801,737,,,0,1,0,,,,,,
607,802,761,607,802,761,,,0,0,0,,,,,,
607,803,786,607,802,786,,,0,1,0,,,,,,
610,825,226,610,825,226,,,0,0,0,,,,,,
610,825,227,610,825,226,,,0,0,1,,,,,,
610,825,230,610,825,229,,,0,0,1,,,,,,
610,825,234,610,825,235,,,0,0,-1,,,,,,
610,825,241,610,825,241,,,0,0,0,,,,,,
610,825,250,610,825,250,,,0,0,0,,,,,,
610,825,261,610,825,260,,,0,0,1,,,,,,
610,825,273,610,825,273,,,0,0,0,,,,,,
611,825,287,610,825,287,,,1,0,0,,,,,,
611,825,303,610,825,303,,,1,0,0,,,,,,
611,826,319,611,825,319,,,0,1,0,,,,,,
611,826,337,611,825,337,,,0,1,0,,,,,,
611,826,356,611,826,355,,,0,0,1,,,,,,
611,826,375,611,826,375,,,0,0,0,,,,,,
612,826,395,612,826,395,,,0,0,0,,,,,,
612,826,416,612,826,416,,,0,0,0,,,,,,
612,827,437,612,827,437,,,0,0,0,,,,,,
612,827,459,612,827,459,,,0,0,0,,,,,,
613,827,481,613,827,481,,,0,0,0,,,,,,
613,827,503,613,827,503,,,0,0,0,,,,,,
613,828,526,613,828,526,,,0,0,0,,,,,,
614,828,549,614,828,549,,,0,0,0,,,,,,
614,828,572,614,828,572,,,0,0,0,,,,,,
615,829,595,614,828,595,,,1,1,0,,,,,,
615,829,619,615,829,618,,,0,0,1,,,,,,
616,829,643,615,829,642,,,1,0,1,,,,,,
616,830,666,616,830,666,,,0,0,0,,,,,,
617,830,690,616,830,690,,,1,0,0,,,,,,
617,830,715,617,830,715,,,0,0,0,,,,,,
618,831,739,618,830,739,,,0,1,0,,,,,,
618,831,763,618,831,763,,,0,0,0,,,,,,
619,832,788,619,831,787,,,0,1,1,,,,,,
622,854,234,622,854,234,,,0,0,0,,,,,,
622,854,235,622,854,234,,,0,0,1,,,,,,
622,854,237,622,854,237,,,0,0,0,,,,,,
622,854,241,622,854,242,,,0,0,-1,,,,,,
622,854,248,622,854,248,,,0,0,0,,,,,,
622,854,257,622,854,257,,,0,0,0,,,,,,
622,854,267,622,854,267,,,0,0,0,,,,,,
622,854,279,622,854,280,,,0,0,-1,,,,,,
622,855,293,622,855,293,,,0,0,0,,,,,,
623,855,308,622,855,309,,,1,0,-1,,,,,,
623,855,325,623,855,325,,,0,0,0,,,,,,
623,855,342,623,855,342,,,0,0,0,,,,,,
623,855,360,623,855,360,,,0,0,0,,,,,,
623,855,380,623,855,379,,,0,0,1,,,,,,
624,855,399,624,855,399,,,0,0,0,,,,,,
624,856,420,624,855,420,,,0,1,0,,,,,,
624,856,441,624,856,441,,,0,0,0,,,,,,
624,856,462,624,856,462,,,0,0,0,,,,,,
625,856,484,625,856,484,,,0,0,0,,,,,,
625,856,506,625,856,506,,,0,0,0,,,,,,
625,857,529,625,857,529,,,0,0,0,,,,,,
626,857,552,625,857,552,,,1,0,0,,,,,,
626,857,575,626,857,575,,,0,0,0,,,,,,
627,858,598,626,857,598,,,1,1,0,,,,,,
627,858,621,627,858,621,,,0,0,0,,,,,,
627,858,645,627,858,645,,,0,0,0,,,,,,
628,859,669,628,859,669,,,0,0,0,,,,,,
628,859,693,628,859,693,,,0,0,0,,,,,,
629,859,717,629,859,717,,,0,0,0,,,,,,
629,860,741,629,859,741,,,0,1,0,,,,,,
630,860,765,630,860,765,,,0,0,0,,,,,,
631,861,790,630,860,789,,,1,1,1,,,,,,
634,883,241,634,883,241,,,0,0,0,,,,,,
634,883,242,634,883,241,,,0,0,1,,,,,,
634,883,244,634,883,244,,,0,0,0,,,,,,
634,883,249,634,883,249,,,0,0,0,,,,,,
634,884,255,634,883,255,,,0,1,0,,,,,,
634,884,263,634,883,264,,,0,1,-1,,,,,,
634,884,274,634,883,273,,,0,1,1,,,,,,
635,884,286,634,883,286,,,1,1,0,,,,,,
635,884,299,634,884,299,,,1,0,0,,,,,,
635,884,314,634,884,314,,,1,0,0,,,,,,
635,884,330,635,884,330,,,0,0,0,,,,,,
635,884,347,635,884,347,,,0,0,0,,,,,,
635,884,365,635,884,365,,,0,0,0,,,,,,
635,884,384,635,884,384,,,0,0,0,,,,,,
636,885,404,636,884,403,,,0,1,1,,,,,,
636,885,424,636,884,424,,,0,1,0,,,,,,
636,885,445,636,885,445,,,0,0,0,,,,,,
636,885,466,636,885,466,,,0,0,0,,,,,,
637,885,488,637,885,487,,,0,0,1,,,,,,
637,886,510,637,885,509,,,0,1,1,,,,,,
637,886,532,637,886,532,,,0,0,0,,,,,,
638,886,555,638,886,554,,,0,0,1,,,,,,
638,886,577,638,886,577,,,0,0,0,,,,,,
639,887,601,638,886,600,,,1,1,1,,,,,,
639,887,624,639,887,624,,,0,0,0,,,,,,
639,887,647,639,887,647,,,0,0,0,,,,,,
640,888,671,640,888,671,,,0,0,0,,,,,,
640,888,695,640,888,695,,,0,0,0,,,,,,
641,888,719,641,888,719,,,0,0,0,,,,,,
642,889,743,641,888,743,,,1,1,0,,,,,,
642,889,767,642,889,767,,,0,0,0,,,,,,
643,890,792,642,889,791,,,1,1,1,,,,,,
450,124,68,449,124,68,,,1,0,0,,,,,,
450,124,71,449,124,68,,,1,0,3,,,,,,
450,125,79,449,124,79,,,1,1,0,,,,,,
450,125,93,449,124,95,,,1,1,-2,,,,,,
450,125,111,450,125,110,,,0,0,1,,,,,,
450,125,130,450,125,130,,,0,0,0,,,,,,
450,126,151,450,125,151,,,0,1,0,,,,,,
450,126,173,450,126,173,,,0,0,0,,,,,,
450,127,196,450,127,195,,,0,0,1,,,,,,
451,128,219,450,128,218,,,1,0,1,,,,,,
451,129,242,450,129,242,,,1,0,0,,,,,,
451,130,266,451,130,265,,,0,0,1,,,,,,
451,131,289,451,131,289,,,0,0,0,,,,,,
452,132,314,451,132,313,,,1,0,1,,,,,,
452,134,338,452,134,337,,,0,0,1,,,,,,
452,135,362,452,135,362,,,0,0,0,,,,,,
453,137,387,452,137,386,,,1,0,1,,,,,,
453,138,411,453,138,411,,,0,0,0,,,,,,
454,140,436,453,140,435,,,1,0,1,,,,,,
454,142,461,454,141,460,,,0,1,1,,,,,,
455,144,486,454,143,485,,,1,1,1,,,,,,
455,146,510,455,145,510,,,0,1,0,,,,,,
456,148,535,456,148,535,,,0,0,0,,,,,,
456,150,561,456,150,560,,,0,0,1,,,,,,
457,152,586,457,152,585,,,0,0,1,,,,,,
458,155,611,457,154,610,,,1,1,1,,,,,,
458,157,636,458,157,636,,,0,0,0,,,,,,
459,160,661,459,159,661,,,0,1,0,,,,,,
460,162,687,460,162,686,,,0,0,1,,,,,,
460,165,712,460,165,712,,,0,0,0,,,,,,
461,167,737,461,167,737,,,0,0,0,,,,,,
462,170,763,462,170,763,,,0,0,0,,,,,,
450,126,68,449,124,68,,,1,2,0,,,,,,
450,126,71,449,124,68,,,1,2,3,,,,,,
450,126,80,449,124,79,,,1,2,1,,,,,,
450,126,93,449,124,95,,,1,2,-2,,,,,,
450,127,111,450,125,110,,,0,2,1,,,,,,
450,127,130,450,125,130,,,0,2,0,,,,,,
450,128,151,450,125,151,,,0,3,0,,,,,,
450,128,173,450,126,173,,,0,2,0,,,,,,
451,129,196,450,127,195,,,1,2,1,,,,,,
451,130,219,450,128,218,,,1,2,1,,,,,,
451,131,242,450,129,242,,,1,2,0,,,,,,
451,132,266,451,130,265,,,0,2,1,,,,,,
451,133,289,451,131,289,,,0,2,0,,,,,,
452,134,314,451,132,313,,,1,2,1,,,,,,
452,135,338,452,134,337,,,0,1,1,,,,,,
452,137,362,452,135,362,,,0,2,0,,,,,,
453,138,387,452,137,386,,,1,1,1,,,,,,
453,140,411,453,138,411,,,0,2,0,,,,,,
454,142,436,453,140,435,,,1,2,1,,,,,,
454,143,461,454,141,460,,,0,2,1,,,,,,
455,145,486,454,143,485,,,1,2,1,,,,,,
455,147,510,455,145,510,,,0,2,0,,,,,,
456,149,536,456,148,535,,,0,1,1,,,,,,
456,151,561,456,150,560,,,0,1,1,,,,,,
457,154,586,457,152,585,,,0,2,1,,,,,,
458,156,611,457,154,610,,,1,2,1,,,,,,
458,158,636,458,157,636,,,0,1,0,,,,,,
459,161,661,459,159,661,,,0,2,0,,,,,,
460,163,687,460,162,686,,,0,1,1,,,,,,
461,166,712,460,165,712,,,1,1,0,,,,,,
461,169,738,461,167,737,,,0,2,1,,,,,,
462,171,763,462,170,763,,,0,1,0,,,,,,
450,133,69,450,133,69,,,0,0,0,,,,,,
450,133,72,450,133,69,,,0,0,3,,,,,,
450,133,80,450,133,80,,,0,0,0,,,,,,
450,133,94,450,133,96,,,0,0,-2,,,,,,
451,133,111,450,133,111,,,1,0,0,,,,,,
451,134,131,450,133,131,,,1,1,0,,,,,,
451,134,152,450,134,151,,,1,0,1,,,,,,
451,135,173,451,134,173,,,0,1,0,,,,,,
451,135,196,451,135,196,,,0,0,0,,,,,,
451,136,219,451,136,219,,,0,0,0,,,,,,
451,137,242,451,137,242,,,0,0,0,,,,,,
452,138,266,451,138,266,,,1,0,0,,,,,,
452,139,290,452,139,290,,,0,0,0,,,,,,
452,140,314,452,140,314,,,0,0,0,,,,,,
453,141,338,452,141,338,,,1,0,0,,,,,,
453,143,362,453,143,362,,,0,0,0,,,,,,
453,144,387,453,144,386,,,0,0,1,,,,,,
454,146,411,453,146,411,,,1,0,0,,,,,,
454,147,436,454,147,436,,,0,0,0,,,,,,
455,149,461,454,149,461,,,1,0,0,,,,,,
455,151,486,455,151,485,,,0,0,1,,,,,,
456,153,511,455,153,510,,,1,0,1,,,,,,
456,155,536,456,155,535,,,0,0,1,,,,,,
457,157,561,456,157,560,,,1,0,1,,,,,,
457,159,586,457,159,585,,,0,0,1,,,,,,
458,161,611,458,161,611,,,0,0,0,,,,,,
459,164,636,459,163,636,,,0,1,0,,,,,,
459,166,661,459,166,661,,,0,0,0,,,,,,
460,168,687,460,168,686,,,0,0,1,,,,,,
461,171,712,461,171,712,,,0,0,0,,,,,,
462,173,738,462,173,737,,,0,0,1,,,,,,
463,176,763,462,176,763,,,1,0,0,,,,,,
451,144,71,451,146,71,,,0,-2,0,,,,,,
451,144,73,451,146,71,,,0,-2,2,,,,,,
451,144,82,451,146,82,,,0,-2,0,,,,,,
451,144,95,451,146,97,,,0,-2,-2,,,,,,
451,144,112,451,146,112,,,0,-2,0,,,,,,
451,145,131,451,146,132,,,0,-1,-1,,,,,,
452,145,152,451,147,152,,,1,-2,0,,,,,,
452,146,174,452,147,174,,,0,-1,0,,,,,,
452,146,196,452,148,196,,,0,-2,0,,,,,,
452,147,219,452,148,219,,,0,-1,0,,,,,,
452,148,243,452,149,242,,,0,-1,1,,,,,,
453,148,266,452,150,266,,,1,-2,0,,,,,,
453,149,290,453,151,290,,,0,-2,0,,,,,,
453,151,314,453,152,314,,,0,-1,0,,,,,,
453,152,338,453,154,338,,,0,-2,0,,,,,,
454,153,362,454,155,362,,,0,-2,0,,,,,,
454,154,387,454,156,387,,,0,-2,0,,,,,,
455,156,412,454,158,411,,,1,-2,1,,,,,,
455,157,436,455,159,436,,,0,-2,0,,,,,,
455,159,461,455,161,461,,,0,-2,0,,,,,,
456,161,486,456,162,486,,,0,-1,0,,,,,,
457,162,511,456,164,510,,,1,-2,1,,,,,,
457,164,536,457,166,535,,,0,-2,1,,,,,,
458,166,561,457,168,560,,,1,-2,1,,,,,,
458,168,586,458,170,585,,,0,-2,1,,,,,,
459,170,611,459,172,611,,,0,-2,0,,,,,,
460,172,636,460,174,636,,,0,-2,0,,,,,,
460,175,662,460,176,661,,,0,-1,1,,,,,,
461,177,687,461,179,686,,,0,-2,1,,,,,,
462,179,712,462,181,712,,,0,-2,0,,,,,,
463,182,738,463,183,737,,,0,-1,1,,,,,,
464,184,763,463,186,763,,,1,-2,0,,,,,,
453,159,73,452,159,73,,,1,0,0,,,,,,
453,159,75,452,159,73,,,1,0,2,,,,,,
453,159,83,452,159,83,,,1,0,0,,,,,,
453,159,97,452,159,98,,,1,0,-1,,,,,,
453,159,113,452,159,113,,,1,0,0,,,,,,
453,160,133,452,159,133,,,1,1,0,,,,,,
453,160,153,453,160,153,,,0,0,0,,,,,,
453,160,175,453,160,175,,,0,0,0,,,,,,
453,161,197,453,161,197,,,0,0,0,,,,,,
453,162,220,453,161,220,,,0,1,0,,,,,,
454,162,243,453,162,243,,,1,0,0,,,,,,
454,163,267,453,163,266,,,1,0,1,,,,,,
454,164,290,454,164,290,,,0,0,0,,,,,,
454,165,314,454,165,314,,,0,0,0,,,,,,
455,166,339,455,166,338,,,0,0,1,,,,,,
455,167,363,455,167,363,,,0,0,0,,,,,,
455,168,387,455,168,387,,,0,0,0,,,,,,
456,170,412,455,170,412,,,1,0,0,,,,,,
456,171,436,456,171,436,,,0,0,0,,,,,,
457,173,461,456,172,461,,,1,1,0,,,,,,
457,174,486,457,174,486,,,0,0,0,,,,,,
458,176,511,457,175,511,,,1,1,0,,,,,,
458,177,536,458,177,536,,,0,0,0,,,,,,
459,179,561,459,179,561,,,0,0,0,,,,,,
460,181,586,460,181,586,,,0,0,0,,,,,,
460,183,611,460,183,611,,,0,0,0,,,,,,
461,185,636,461,185,636,,,0,0,0,,,,,,
462,187,662,461,187,661,,,1,0,1,,,,,,
462,189,687,462,189,687,,,0,0,0,,,,,,
463,191,712,463,191,712,,,0,0,0,,,,,,
464,194,738,464,193,738,,,0,1,0,,,,,,
465,196,763,464,196,763,,,1,0,0,,,,,,
454,177,76,454,178,75,,,0,-1,1,,,,,,
454,177,78,454,178,75,,,0,-1,3,,,,,,
454,177,86,454,178,86,,,0,-1,0,,,,,,
454,177,99,454,178,100,,,0,-1,-1,,,,,,
454,178,115,454,179,115,,,0,-1,0,,,,,,
455,178,134,454,179,135,,,1,-1,-1,,,,,,
455,178,154,455,179,154,,,0,-1,0,,,,,,
455,179,176,455,179,176,,,0,0,0,,,,,,
455,179,198,455,180,198,,,0,-1,0,,,,,,
455,180,221,455,180,221,,,0,0,0,,,,,,
455,180,244,455,181,244,,,0,-1,0,,,,,,
456,181,267,455,182,267,,,1,-1,0,,,,,,
456,182,291,456,182,291,,,0,0,0,,,,,,
456,183,315,456,183,315,,,0,0,0,,,,,,
456,183,339,457,185,339,,,-1,-2,0,,,,,,
457,184,363,457,186,363,,,0,-2,0,,,,,,
457,186,388,457,187,388,,,0,-1,0,,,,,,
458,187,412,457,188,412,,,1,-1,0,,,,,,
458,188,437,458,189,437,,,0,-1,0,,,,,,
458,189,462,458,190,461,,,0,-1,1,,,,,,
459,191,486,459,192,486,,,0,-1,0,,,,,,
460,192,511,459,193,511,,,1,-1,0,,,,,,
460,194,536,460,195,536,,,0,-1,0,,,,,,
461,195,561,461,196,561,,,0,-1,0,,,,,,
461,197,586,461,198,586,,,0,-1,0,,,,,,
462,199,612,462,200,611,,,0,-1,1,,,,,,
463,201,637,462,202,636,,,1,-1,1,,,,,,
463,203,662,463,203,662,,,0,0,0,,,,,,
464,205,687,464,205,687,,,0,0,0,,,,,,
465,207,713,465,207,712,,,0,0,1,,,,,,
466,209,738,466,209,738,,,0,0,0,,,,,,
466,211,763,466,212,763,,,0,-1,0,,,,,,
457,198,79,456,197,78,,,1,1,1,,,,,,
457,198,81,456,197,78,,,1,1,3,,,,,,
457,198,89,456,197,89,,,1,1,0,,,,,,
457,198,101,456,198,103,,,1,0,-2,,,,,,
457,198,117,457,198,117,,,0,0,0,,,,,,
457,198,136,457,198,136,,,0,0,0,,,,,,
457,199,156,457,198,156,,,0,1,0,,,,,,
457,199,177,457,199,177,,,0,0,0,,,,,,
457,199,199,457,199,199,,,0,0,0,,,,,,
457,200,222,457,200,222,,,0,0,0,,,,,,
458,200,245,458,200,245,,,0,0,0,,,,,,
458,201,268,458,201,268,,,0,0,0,,,,,,
458,202,292,458,201,292,,,0,1,0,,,,,,
458,203,316,458,202,315,,,0,1,1,,,,,,
459,203,340,459,203,339,,,0,0,1,,,,,,
459,204,364,459,204,364,,,0,0,0,,,,,,
459,205,388,459,205,388,,,0,0,0,,,,,,
460,206,413,459,206,413,,,1,0,0,,,,,,
460,207,437,460,207,437,,,0,0,0,,,,,,
461,209,462,460,208,462,,,1,1,0,,,,,,
461,210,487,461,210,486,,,0,0,1,,,,,,
462,211,512,461,211,511,,,1,0,1,,,,,,
462,213,537,462,212,536,,,0,1,1,,,,,,
463,214,562,463,214,561,,,0,0,1,,,,,,
463,216,587,463,216,586,,,0,0,1,,,,,,
464,217,612,464,217,611,,,0,0,1,,,,,,
465,219,637,464,219,637,,,1,0,0,,,,,,
466,221,662,465,220,662,,,1,1,0,,,,,,
466,222,688,466,222,687,,,0,0,1,,,,,,
467,224,713,467,224,713,,,0,0,0,,,,,,
468,226,738,468,226,738,,,0,0,0,,,,,,
469,228,764,468,228,763,,,1,0,1,,,,,,
459,220,83,459,220,82,,,0,0,1,,,,,,
459,220,85,459,220,82,,,0,0,3,,,,,,
459,220,92,459,220,92,,,0,0,0,,,,,,
459,220,104,459,220,106,,,0,0,-2,,,,,,
459,220,120,459,221,120,,,0,-1,0,,,,,,
459,221,138,459,221,139,,,0,0,-1,,,,,,
460,221,158,460,221,158,,,0,0,0,,,,,,
460,221,179,460,221,179,,,0,0,0,,,,,,
460,221,201,460,222,200,,,0,-1,1,,,,,,
460,222,223,460,222,223,,,0,0,0,,,,,,
460,222,246,460,223,246,,,0,-1,0,,,,,,
460,223,269,460,223,269,,,0,0,0,,,,,,
461,224,293,461,224,293,,,0,0,0,,,,,,
461,224,317,461,225,316,,,0,-1,1,,,,,,
461,225,340,461,226,340,,,0,-1,0,,,,,,
462,226,365,462,226,364,,,0,0,1,,,,,,
462,227,389,462,227,389,,,0,0,0,,,,,,
462,228,413,462,228,413,,,0,0,0,,,,,,
463,229,438,463,229,438,,,0,0,0,,,,,,
463,230,463,463,230,462,,,0,0,1,,,,,,
464,231,487,464,231,487,,,0,0,0,,,,,,
464,232,512,464,232,512,,,0,0,0,,,,,,
465,233,537,465,234,537,,,0,-1,0,,,,,,
466,235,562,466,235,562,,,0,0,0,,,,,,
466,236,587,466,237,587,,,0,-1,0,,,,,,
467,237,612,467,238,612,,,0,-1,0,,,,,,
467,239,637,467,239,637,,,0,0,0,,,,,,
468,241,663,468,241,662,,,0,0,1,,,,,,
469,242,688,469,242,688,,,0,0,0,,,,,,
470,244,713,470,244,713,,,0,0,0,,,,,,
470,246,739,471,246,738,,,-1,0,1,,,,,,
471,247,764,471,248,764,,,0,-1,0,,,,,,
462,244,87,462,243,87,,,0,1,0,,,,,,
462,244,89,462,243,87,,,0,1,2,,,,,,
462,244,96,462,243,96,,,0,1,0,,,,,,
462,244,108,462,243,109,,,0,1,-1,,,,,,
463,244,123,462,244,123,,,1,0,0,,,,,,
463,244,141,462,244,141,,,1,0,0,,,,,,
463,244,160,463,244,160,,,0,0,0,,,,,,
463,245,181,463,244,181,,,0,1,0,,,,,,
463,245,202,463,245,202,,,0,0,0,,,,,,
463,245,225,463,245,224,,,0,0,1,,,,,,
463,246,247,463,245,247,,,0,1,0,,,,,,
464,246,270,463,246,270,,,1,0,0,,,,,,
464,247,294,464,246,294,,,0,1,0,,,,,,
464,247,318,464,247,317,,,0,0,1,,,,,,
465,248,341,464,248,341,,,1,0,0,,,,,,
465,249,366,465,249,365,,,0,0,1,,,,,,
465,250,390,465,249,389,,,0,1,1,,,,,,
466,250,414,466,250,414,,,0,0,0,,,,,,
466,251,439,466,251,438,,,0,0,1,,,,,,
467,252,463,467,252,463,,,0,0,0,,,,,,
467,253,488,467,253,488,,,0,0,0,,,,,,
468,254,513,468,254,513,,,0,0,0,,,,,,
468,256,538,468,255,537,,,0,1,1,,,,,,
469,257,563,469,256,562,,,0,1,1,,,,,,
469,258,588,469,258,587,,,0,0,1,,,,,,
470,259,613,470,259,612,,,0,0,1,,,,,,
471,261,638,470,260,638,,,1,1,0,,,,,,
471,262,663,471,262,663,,,0,0,0,,,,,,
472,264,688,472,263,688,,,0,1,0,,,,,,
473,265,714,473,265,713,,,0,0,1,,,,,,
474,267,739,474,267,739,,,0,0,0,,,,,,
474,268,764,474,268,764,,,0,0,0,,,,,,
466,268,92,466,268,92,,,0,0,0,,,,,,
466,268,94,466,268,92,,,0,0,2,,,,,,
466,268,101,466,268,100,,,0,0,1,,,,,,
466,268,112,466,268,113,,,0,0,-1,,,,,,
466,268,126,466,269,126,,,0,-1,0,,,,,,
466,269,143,466,269,144,,,0,0,-1,,,,,,
466,269,163,466,269,162,,,0,0,1,,,,,,
467,269,183,466,269,183,,,1,0,0,,,,,,
467,269,204,467,270,204,,,0,-1,0,,,,,,
467,270,226,467,270,226,,,0,0,0,,,,,,
467,270,249,467,270,249,,,0,0,0,,,,,,
467,271,272,467,270,272,,,0,1,0,,,,,,
468,271,295,468,271,295,,,0,0,0,,,,,,
468,272,319,468,272,318,,,0,0,1,,,,,,
468,272,343,468,272,342,,,0,0,1,,,,,,
468,273,367,468,273,366,,,0,0,1,,,,,,
469,274,391,469,274,390,,,0,0,1,,,,,,
469,274,415,469,274,415,,,0,0,0,,,,,,
470,275,440,470,275,439,,,0,0,1,,,,,,
470,276,464,470,276,464,,,0,0,0,,,,,,
471,277,489,471,277,489,,,0,0,0,,,,,,
471,278,514,471,278,513,,,0,0,1,,,,,,
472,279,538,472,279,538,,,0,0,0,,,,,,
472,280,563,472,280,563,,,0,0,0,,,,,,
473,281,588,473,281,588,,,0,0,0,,,,,,
473,282,613,473,282,613,,,0,0,0,,,,,,
474,284,638,474,284,638,,,0,0,0,,,,,,
475,285,664,475,285,663,,,0,0,1,,,,,,
476,286,689,475,286,689,,,1,0,0,,,,,,
476,288,714,476,288,714,,,0,0,0,,,,,,
477,289,740,477,289,739,,,0,0,1,,,,,,
478,291,765,478,291,765,,,0,0,0,,,,,,
470,294,97,470,294,97,,,0,0,0,,,,,,
470,294,99,470,294,97,,,0,0,2,,,,,,
470,294,105,470,294,105,,,0,0,0,,,,,,
470,294,116,470,294,117,,,0,0,-1,,,,,,
470,294,130,470,294,130,,,0,0,0,,,,,,
470,294,147,470,294,147,,,0,0,0,,,,,,
471,294,165,470,294,165,,,1,0,0,,,,,,
471,294,185,470,294,186,,,1,0,-1,,,,,,
471,295,206,471,295,206,,,0,0,0,,,,,,
471,295,228,471,295,228,,,0,0,0,,,,,,
471,295,251,471,295,251,,,0,0,0,,,,,,
471,296,273,471,295,273,,,0,1,0,,,,,,
472,296,297,472,296,296,,,0,0,1,,,,,,
472,297,320,472,296,320,,,0,1,0,,,,,,
472,297,344,472,297,343,,,0,0,1,,,,,,
473,298,368,472,297,367,,,1,1,1,,,,,,
473,298,392,473,298,391,,,0,0,1,,,,,,
473,299,416,473,299,416,,,0,0,0,,,,,,
474,300,440,474,300,440,,,0,0,0,,,,,,
474,301,465,474,300,465,,,0,1,0,,,,,,
475,301,490,475,301,489,,,0,0,1,,,,,,
475,302,514,475,302,514,,,0,0,0,,,,,,
476,303,539,476,303,539,,,0,0,0,,,,,,
476,304,564,476,304,564,,,0,0,0,,,,,,
477,305,589,477,305,589,,,0,0,0,,,,,,
478,306,614,477,306,614,,,1,0,0,,,,,,
478,308,639,478,307,639,,,0,1,0,,,,,,
479,309,664,479,308,664,,,0,1,0,,,,,,
480,310,689,479,310,689,,,1,0,0,,,,,,
480,311,715,480,311,714,,,0,0,1,,,,,,
481,313,740,481,312,740,,,0,1,0,,,,,,
482,314,765,482,314,765,,,0,0,0,,,,,,
475,319,103,475,319,103,,,0,0,0,,,,,,
475,319,105,475,319,103,,,0,0,2,,,,,,
475,319,110,475,320,110,,,0,-1,0,,,,,,
475,320,120,475,320,122,,,0,0,-2,,,,,,
475,320,134,475,320,134,,,0,0,0,,,,,,
475,320,150,475,320,151,,,0,0,-1,,,,,,
475,320,168,475,320,168,,,0,0,0,,,,,,
475,320,188,475,320,188,,,0,0,0,,,,,,
475,320,209,475,320,209,,,0,0,0,,,,,,
476,321,230,476,321,231,,,0,0,-1,,,,,,
476,321,253,476,321,253,,,0,0,0,,,,,,
476,321,275,476,321,275,,,0,0,0,,,,,,
476,322,298,476,322,298,,,0,0,0,,,,,,
477,322,322,477,322,321,,,0,0,1,,,,,,
477,323,345,477,323,345,,,0,0,0,,,,,,
477,323,369,477,323,369,,,0,0,0,,,,,,
478,324,393,477,324,393,,,1,0,0,,,,,,
478,325,417,478,325,417,,,0,0,0,,,,,,
478,325,442,478,325,441,,,0,0,1,,,,,,
479,326,466,479,326,466,,,0,0,0,,,,,,
479,327,491,479,327,490,,,0,0,1,,,,,,
480,328,515,480,327,515,,,0,1,0,,,,,,
480,328,540,480,328,540,,,0,0,0,,,,,,
481,329,565,481,329,565,,,0,0,0,,,,,,
482,330,590,481,330,589,,,1,0,1,,,,,,
482,331,615,482,331,614,,,0,0,1,,,,,,
483,332,640,483,332,639,,,0,0,1,,,,,,
483,333,665,483,333,665,,,0,0,0,,,,,,
484,334,690,484,334,690,,,0,0,0,,,,,,
485,336,715,485,336,715,,,0,0,0,,,,,,
486,337,741,486,337,740,,,0,0,1,,,,,,
486,338,766,486,338,766,,,0,0,0,,,,,,
480,346,109,480,345,108,,,0,1,1,,,,,,
480,346,110,480,345,108,,,0,1,2,,,,,,
480,346,116,480,346,116,,,0,0,0,,,,,,
480,346,125,480,346,127,,,0,0,-2,,,,,,
480,346,138,480,346,138,,,0,0,0,,,,,,
480,346,154,480,346,155,,,0,0,-1,,,,,,
480,346,172,480,346,171,,,0,0,1,,,,,,
480,346,191,480,346,191,,,0,0,0,,,,,,
481,347,212,480,346,211,,,1,1,1,,,,,,
481,347,233,481,347,233,,,0,0,0,,,,,,
481,347,255,481,347,255,,,0,0,0,,,,,,
481,348,277,481,348,277,,,0,0,0,,,,,,
481,348,300,481,348,300,,,0,0,0,,,,,,
482,348,323,482,348,323,,,0,0,0,,,,,,
482,349,347,482,349,346,,,0,0,1,,,,,,
482,349,370,482,349,370,,,0,0,0,,,,,,
483,350,394,482,350,394,,,1,0,0,,,,,,
483,351,418,483,350,418,,,0,1,0,,,,,,
484,351,443,483,351,442,,,1,0,1,,,,,,
484,352,467,484,352,467,,,0,0,0,,,,,,
484,352,492,484,352,491,,,0,0,1,,,,,,
485,353,516,485,353,516,,,0,0,0,,,,,,
485,354,541,485,354,541,,,0,0,0,,,,,,
486,355,566,486,354,565,,,0,1,1,,,,,,
487,356,591,486,355,590,,,1,1,1,,,,,,
487,357,616,487,356,615,,,0,1,1,,,,,,
488,358,641,488,357,640,,,0,1,1,,,,,,
489,359,666,488,358,665,,,1,1,1,,,,,,
489,360,691,489,359,691,,,0,1,0,,,,,,
490,361,716,490,360,716,,,0,1,0,,,,,,
491,362,741,491,362,741,,,0,0,0,,,,,,
491,363,767,491,363,766,,,0,0,1,,,,,,
486,373,115,486,372,114,,,0,1,1,,,,,,
486,373,116,486,372,114,,,0,1,2,,,,,,
486,373,121,486,373,121,,,0,0,0,,,,,,
486,373,131,486,373,132,,,0,0,-1,,,,,,
486,373,143,486,373,143,,,0,0,0,,,,,,
486,373,158,486,373,159,,,0,0,-1,,,,,,
486,373,176,486,373,175,,,0,0,1,,,,,,
486,373,194,486,373,195,,,0,0,-1,,,,,,
486,373,215,486,373,214,,,0,0,1,,,,,,
486,374,235,486,373,236,,,0,1,-1,,,,,,
487,374,257,487,374,257,,,0,0,0,,,,,,
487,374,279,487,374,279,,,0,0,0,,,,,,
487,375,302,487,375,302,,,0,0,0,,,,,,
487,375,325,487,375,325,,,0,0,0,,,,,,
488,375,348,488,375,348,,,0,0,0,,,,,,
488,376,372,488,376,372,,,0,0,0,,,,,,
488,376,396,488,376,396,,,0,0,0,,,,,,
489,377,420,488,377,420,,,1,0,0,,,,,,
489,377,444,489,377,444,,,0,0,0,,,,,,
489,378,468,489,378,468,,,0,0,0,,,,,,
490,379,493,490,379,492,,,0,0,1,,,,,,
490,379,517,490,379,517,,,0,0,0,,,,,,
491,380,542,491,380,542,,,0,0,0,,,,,,
492,381,567,491,381,566,,,1,0,1,,,,,,
492,382,592,492,381,591,,,0,1,1,,,,,,
493,383,616,493,382,616,,,0,1,0,,,,,,
493,383,641,493,383,641,,,0,0,0,,,,,,
494,384,666,494,384,666,,,0,0,0,,,,,,
495,385,692,494,385,691,,,1,0,1,,,,,,
495,386,717,495,386,717,,,0,0,0,,,,,,
496,387,742,496,388,742,,,0,-1,0,,,,,,
497,389,767,497,389,767,,,0,0,0,,,,,,
492,400,121,492,400,121,,,0,0,0,,,,,,
492,400,122,492,400,121,,,0,0,1,,,,,,
492,400,127,492,400,127,,,0,0,0,,,,,,
492,400,136,492,400,137,,,0,0,-1,,,,,,
492,400,148,492,400,148,,,0,0,0,,,,,,
492,400,163,492,400,163,,,0,0,0,,,,,,
492,400,180,492,400,179,,,0,0,1,,,,,,
492,400,198,492,400,198,,,0,0,0,,,,,,
492,400,218,492,400,218,,,0,0,0,,,,,,
492,401,238,492,400,239,,,0,1,-1,,,,,,
493,401,260,493,401,260,,,0,0,0,,,,,,
493,401,282,493,401,282,,,0,0,0,,,,,,
493,402,304,493,402,304,,,0,0,0,,,,,,
493,402,327,493,402,327,,,0,0,0,,,,,,
494,402,350,494,402,350,,,0,0,0,,,,,,
494,403,374,494,402,374,,,0,1,0,,,,,,
494,403,397,494,403,397,,,0,0,0,,,,,,
495,404,421,494,403,421,,,1,1,0,,,,,,
495,404,445,495,404,445,,,0,0,0,,,,,,
495,405,470,495,404,469,,,0,1,1,,,,,,
496,405,494,496,405,494,,,0,0,0,,,,,,
496,406,518,496,406,518,,,0,0,0,,,,,,
497,407,543,497,407,543,,,0,0,0,,,,,,
497,407,568,497,407,568,,,0,0,0,,,,,,
498,408,593,498,408,592,,,0,0,1,,,,,,
499,409,617,499,409,617,,,0,0,0,,,,,,
499,410,642,499,410,642,,,0,0,0,,,,,,
500,411,667,500,411,667,,,0,0,0,,,,,,
501,412,692,500,412,692,,,1,0,0,,,,,,
501,412,718,501,413,717,,,0,-1,1,,,,,,
502,413,743,502,414,743,,,0,-1,0,,,,,,
503,414,768,503,415,768,,,0,-1,0,,,,,,
498,427,127,498,427,127,,,0,0,0,,,,,,
498,427,129,498,427,127,,,0,0,2,,,,,,
498,427,133,498,427,133,,,0,0,0,,,,,,
498,427,142,498,427,143,,,0,0,-1,,,,,,
498,427,153,498,427,153,,,0,0,0,,,,,,
498,427,167,498,427,168,,,0,0,-1,,,,,,
498,427,184,498,427,184,,,0,0,0,,,,,,
499,428,202,498,427,202,,,1,1,0,,,,,,
499,428,221,499,428,221,,,0,0,0,,,,,,
499,428,241,499,428,242,,,0,0,-1,,,,,,
499,428,263,499,428,263,,,0,0,0,,,,,,
499,429,284,499,428,284,,,0,1,0,,,,,,
500,429,307,500,429,306,,,0,0,1,,,,,,
500,429,329,500,429,329,,,0,0,0,,,,,,
500,430,352,500,429,352,,,0,1,0,,,,,,
500,430,376,500,430,376,,,0,0,0,,,,,,
501,430,399,501,430,399,,,0,0,0,,,,,,
501,431,423,501,430,423,,,0,1,0,,,,,,
502,431,447,502,431,447,,,0,0,0,,,,,,
502,432,471,502,431,471,,,0,1,0,,,,,,
502,432,495,502,432,495,,,0,0,0,,,,,,
503,433,520,503,433,519,,,0,0,1,,,,,,
503,434,544,503,434,544,,,0,0,0,,,,,,
504,434,569,504,434,569,,,0,0,0,,,,,,
504,435,594,505,435,593,,,-1,0,1,,,,,,
505,436,619,505,435,618,,,0,1,1,,,,,,
506,436,643,506,436,643,,,0,0,0,,,,,,
506,437,668,506,437,668,,,0,0,0,,,,,,
507,438,693,507,438,693,,,0,0,0,,,,,,
508,439,719,508,439,718,,,0,0,1,,,,,,
508,440,744,509,440,743,,,-1,0,1,,,,,,
509,441,769,509,441,769,,,0,0,0,,,,,,
505,455,134,505,455,134,,,0,0,0,,,,,,
505,455,135,505,455,134,,,0,0,1,,,,,,
505,455,140,505,455,140,,,0,0,0,,,,,,
505,455,148,505,455,149,,,0,0,-1,,,,,,
505,455,159,505,455,158,,,0,0,1,,,,,,
505,455,172,505,455,173,,,0,0,-1,,,,,,
505,455,188,505,455,188,,,0,0,0,,,,,,
506,455,206,505,455,206,,,1,0,0,,,,,,
506,455,225,506,455,225,,,0,0,0,,,,,,
506,456,245,506,455,245,,,0,1,0,,,,,,
506,456,266,506,456,266,,,0,0,0,,,,,,
506,456,287,506,456,287,,,0,0,0,,,,,,
506,456,309,507,456,309,,,-1,0,0,,,,,,
507,457,332,507,456,331,,,0,1,1,,,,,,
507,457,354,507,457,354,,,0,0,0,,,,,,
507,457,378,507,457,378,,,0,0,0,,,,,,
508,458,401,508,458,401,,,0,0,0,,,,,,
508,458,425,508,458,425,,,0,0,0,,,,,,
508,459,449,509,458,448,,,-1,1,1,,,,,,
509,459,473,509,459,472,,,0,0,1,,,,,,
509,460,497,509,459,496,,,0,1,1,,,,,,
510,460,521,509,460,521,,,1,0,0,,,,,,
510,461,546,510,461,545,,,0,0,1,,,,,,
511,461,570,510,461,570,,,1,0,0,,,,,,
511,462,595,511,462,595,,,0,0,0,,,,,,
512,463,620,512,462,619,,,0,1,1,,,,,,
512,463,645,513,463,644,,,-1,0,1,,,,,,
513,464,669,513,464,669,,,0,0,0,,,,,,
514,465,694,514,465,694,,,0,0,0,,,,,,
514,466,720,514,465,719,,,0,1,1,,,,,,
515,467,745,515,466,744,,,0,1,1,,,,,,
516,468,770,516,467,769,,,0,1,1,,,,,,
512,483,141,513,482,140,,,-1,1,1,,,,,,
512,483,142,513,482,140,,,-1,1,2,,,,,,
512,483,146,513,482,146,,,-1,1,0,,,,,,
513,483,154,513,482,155,,,0,1,-1,,,,,,
513,483,164,513,482,164,,,0,1,0,,,,,,
513,483,177,513,482,178,,,0,1,-1,,,,,,
513,483,193,513,482,193,,,0,1,0,,,,,,
513,483,210,513,483,211,,,0,0,-1,,,,,,
513,483,229,513,483,229,,,0,0,0,,,,,,
513,483,248,513,483,249,,,0,0,-1,,,,,,
513,484,269,513,483,269,,,0,1,0,,,,,,
514,484,290,514,484,290,,,0,0,0,,,,,,
514,484,312,514,484,311,,,0,0,1,,,,,,
514,484,334,514,484,334,,,0,0,0,,,,,,
514,485,357,514,484,357,,,0,1,0,,,,,,
515,485,380,515,485,380,,,0,0,0,,,,,,
515,485,403,515,485,403,,,0,0,0,,,,,,
515,486,427,515,486,427,,,0,0,0,,,,,,
516,486,450,516,486,450,,,0,0,0,,,,,,
516,487,474,516,486,474,,,0,1,0,,,,,,
517,487,498,516,487,498,,,1,0,0,,,,,,
517,488,523,517,487,522,,,0,1,1,,,,,,
518,488,547,517,488,547,,,1,0,0,,,,,,
518,489,572,518,488,571,,,0,1,1,,,,,,
519,489,596,519,489,596,,,0,0,0,,,,,,
519,490,621,519,490,621,,,0,0,0,,,,,,
520,491,646,520,491,645,,,0,0,1,,,,,,
520,491,671,521,491,670,,,-1,0,1,,,,,,
521,492,696,521,492,695,,,0,0,1,,,,,,
522,493,721,522,493,720,,,0,0,1,,,,,,
522,494,746,522,494,745,,,0,0,1,,,,,,
523,495,771,523,494,770,,,0,1,1,,,,,,
520,511,147,520,510,147,,,0,1,0,,,,,,
520,511,149,520,510,147,,,0,1,2,,,,,,
520,511,153,520,510,152,,,0,1,1,,,,,,
520,511,160,520,510,161,,,0,1,-1,,,,,,
520,511,170,520,510,170,,,0,1,0,,,,,,
520,511,183,520,510,183,,,0,1,0,,,,,,
521,511,198,520,510,197,,,1,1,1,,,,,,
521,511,214,520,511,215,,,1,0,-1,,,,,,
521,511,233,521,511,233,,,0,0,0,,,,,,
521,511,252,521,511,252,,,0,0,0,,,,,,
521,511,272,521,511,272,,,0,0,0,,,,,,
521,512,293,521,511,293,,,0,1,0,,,,,,
522,512,315,521,512,314,,,1,0,1,,,,,,
522,512,337,522,512,337,,,0,0,0,,,,,,
522,512,359,522,512,359,,,0,0,0,,,,,,
522,513,382,522,513,382,,,0,0,0,,,,,,
523,513,405,523,513,405,,,0,0,0,,,,,,
523,514,429,523,513,429,,,0,1,0,,,,,,
523,514,452,523,514,452,,,0,0,0,,,,,,
524,514,476,524,514,476,,,0,0,0,,,,,,
524,515,500,524,514,500,,,0,1,0,,,,,,
525,515,524,525,515,524,,,0,0,0,,,,,,
525,516,549,525,515,548,,,0,1,1,,,,,,
526,516,573,526,516,573,,,0,0,0,,,,,,
526,517,598,526,517,597,,,0,0,1,,,,,,
527,518,622,527,517,622,,,0,1,0,,,,,,
527,518,647,528,518,647,,,-1,0,0,,,,,,
528,519,672,528,519,671,,,0,0,1,,,,,,
529,520,697,529,519,696,,,0,1,1,,,,,,
529,520,722,529,520,721,,,0,0,1,,,,,,
530,521,747,530,521,746,,,0,0,1,,,,,,
531,522,772,531,522,771,,,0,0,1,,,,,,
528,539,154,529,538,154,,,-1,1,0,,,,,,
528,539,155,529,538,154,,,-1,1,1,,,,,,
528,539,159,529,538,159,,,-1,1,0,,,,,,
528,539,166,529,538,167,,,-1,1,-1,,,,,,
529,539,176,529,538,176,,,0,1,0,,,,,,
529,539,188,529,538,189,,,0,1,-1,,,,,,
529,539,203,529,539,202,,,0,0,1,,,,,,
529,539,219,529,539,219,,,0,0,0,,,,,,
529,539,237,529,539,237,,,0,0,0,,,,,,
529,539,256,529,539,256,,,0,0,0,,,,,,
529,540,276,529,539,275,,,0,1,1,,,,,,
529,540,296,529,539,296,,,0,1,0,,,,,,
530,540,318,530,540,317,,,0,0,1,,,,,,
530,540,340,530,540,339,,,0,0,1,,,,,,
530,541,362,530,540,362,,,0,1,0,,,,,,
531,541,385,531,541,384,,,0,0,1,,,,,,
531,541,408,531,541,407,,,0,0,1,,,,,,
531,542,431,531,541,431,,,0,1,0,,,,,,
532,542,454,532,542,454,,,0,0,0,,,,,,
532,542,478,532,542,478,,,0,0,0,,,,,,
532,543,502,533,542,502,,,-1,1,0,,,,,,
533,543,526,533,543,526,,,0,0,0,,,,,,
533,544,550,533,543,550,,,0,1,0,,,,,,
534,544,575,534,544,574,,,0,0,1,,,,,,
534,545,599,534,544,599,,,0,1,0,,,,,,
535,545,624,535,545,623,,,0,0,1,,,,,,
535,546,648,536,546,648,,,-1,0,0,,,,,,
536,547,673,536,546,673,,,0,1,0,,,,,,
537,547,698,537,547,698,,,0,0,0,,,,,,
537,548,723,537,548,722,,,0,0,1,,,,,,
538,549,748,538,549,747,,,0,0,1,,,,,,
539,549,773,539,549,773,,,0,0,0,,,,,,
537,567,161,537,567,161,,,0,0,0,,,,,,
537,567,162,537,567,161,,,0,0,1,,,,,,
537,567,166,537,567,166,,,0,0,0,,,,,,
537,567,173,537,567,174,,,0,0,-1,,,,,,
537,567,182,537,567,182,,,0,0,0,,,,,,
537,567,194,537,567,195,,,0,0,-1,,,,,,
537,567,208,537,567,208,,,0,0,0,,,,,,
537,567,224,537,567,224,,,0,0,0,,,,,,
537,567,241,537,567,241,,,0,0,0,,,,,,
538,568,260,537,567,260,,,1,1,0,,,,,,
538,568,279,538,567,279,,,0,1,0,,,,,,
538,568,300,538,568,300,,,0,0,0,,,,,,
538,568,321,538,568,321,,,0,0,0,,,,,,
538,568,343,538,568,342,,,0,0,1,,,,,,
539,569,365,539,568,364,,,0,1,1,,,,,,
539,569,387,539,569,387,,,0,0,0,,,,,,
539,569,410,539,569,410,,,0,0,0,,,,,,
540,570,433,540,569,433,,,0,1,0,,,,,,
540,570,457,540,570,456,,,0,0,1,,,,,,
540,570,480,541,570,480,,,-1,0,0,,,,,,
541,571,504,541,570,503,,,0,1,1,,,,,,
541,571,528,541,571,527,,,0,0,1,,,,,,
542,572,552,542,571,552,,,0,1,0,,,,,,
542,572,576,542,572,576,,,0,0,0,,,,,,
543,573,601,543,572,600,,,0,1,1,,,,,,
543,573,625,543,573,625,,,0,0,0,,,,,,
544,574,650,544,573,649,,,0,1,1,,,,,,
544,574,675,544,574,674,,,0,0,1,,,,,,
545,575,699,545,575,699,,,0,0,0,,,,,,
546,576,724,546,575,724,,,0,1,0,,,,,,
546,576,749,547,576,749,,,-1,0,0,,,,,,
547,577,774,547,577,774,,,0,0,0,,,,,,
546,595,169,546,595,168,,,0,0,1,,,,,,
546,595,169,546,595,168,,,0,0,1,,,,,,
546,595,173,546,595,173,,,0,0,0,,,,,,
546,595,179,546,595,180,,,0,0,-1,,,,,,
546,595,188,546,595,188,,,0,0,0,,,,,,
546,596,200,546,595,200,,,0,1,0,,,,,,
546,596,213,546,595,213,,,0,1,0,,,,,,
546,596,229,546,595,229,,,0,1,0,,,,,,
546,596,246,546,596,246,,,0,0,0,,,,,,
547,596,264,546,596,264,,,1,0,0,,,,,,
547,596,283,547,596,283,,,0,0,0,,,,,,
547,596,303,547,596,304,,,0,0,-1,,,,,,
547,597,324,547,596,324,,,0,1,0,,,,,,
547,597,346,547,596,346,,,0,1,0,,,,,,
548,597,368,548,597,367,,,0,0,1,,,,,,
548,597,390,548,597,390,,,0,0,0,,,,,,
548,598,413,548,597,412,,,0,1,1,,,,,,
549,598,436,549,598,435,,,0,0,1,,,,,,
549,598,459,549,598,459,,,0,0,0,,,,,,
549,599,482,550,598,482,,,-1,1,0,,,,,,
550,599,506,550,599,506,,,0,0,0,,,,,,
550,599,530,550,599,529,,,0,0,1,,,,,,
551,600,554,551,599,553,,,0,1,1,,,,,,
551,600,578,551,600,578,,,0,0,0,,,,,,
552,601,602,552,600,602,,,0,1,0,,,,,,
552,601,627,552,601,626,,,0,0,1,,,,,,
553,602,651,553,601,651,,,0,1,0,,,,,,
553,602,676,553,602,676,,,0,0,0,,,,,,
554,603,701,554,603,701,,,0,0,0,,,,,,
555,604,726,555,603,725,,,0,1,1,,,,,,
555,604,750,555,604,750,,,0,0,0,,,,,,
556,605,775,556,605,775,,,0,0,0,,,,,,
555,624,176,555,624,175,,,0,0,1,,,,,,
555,624,177,555,624,175,,,0,0,2,,,,,,
555,624,180,555,624,180,,,0,0,0,,,,,,
555,624,186,555,624,187,,,0,0,-1,,,,,,
555,624,195,555,624,194,,,0,0,1,,,,,,
555,624,206,555,624,206,,,0,0,0,,,,,,
555,624,219,555,624,219,,,0,0,0,,,,,,
556,624,234,555,624,235,,,1,0,-1,,,,,,
556,624,251,556,624,251,,,0,0,0,,,,,,
556,624,268,556,624,269,,,0,0,-1,,,,,,
556,625,287,556,624,287,,,0,1,0,,,,,,
556,625,307,556,624,307,,,0,1,0,,,,,,
556,625,328,556,625,328,,,0,0,0,,,,,,
557,625,349,556,625,349,,,1,0,0,,,,,,
557,625,371,557,625,370,,,0,0,1,,,,,,
557,626,393,557,625,393,,,0,1,0,,,,,,
557,626,415,557,626,415,,,0,0,0,,,,,,
558,626,438,558,626,438,,,0,0,0,,,,,,
558,627,461,558,626,461,,,0,1,0,,,,,,
559,627,485,559,627,485,,,0,0,0,,,,,,
559,627,508,559,627,508,,,0,0,0,,,,,,
559,628,532,559,627,532,,,0,1,0,,,,,,
560,628,556,560,628,555,,,0,0,1,,,,,,
560,629,580,560,628,580,,,0,1,0,,,,,,
561,629,604,561,629,604,,,0,0,0,,,,,,
561,630,628,561,629,628,,,0,1,0,,,,,,
562,630,653,562,630,653,,,0,0,0,,,,,,
562,631,678,563,630,677,,,-1,1,1,,,,,,
563,631,702,563,631,702,,,0,0,0,,,,,,
564,632,727,564,631,727,,,0,1,0,,,,,,
564,632,752,564,632,752,,,0,0,0,,,,,,
565,633,777,565,633,777,,,0,0,0,,,,,,
565,652,183,565,652,183,,,0,0,0,,,,,,
565,652,184,565,652,183,,,0,0,1,,,,,,
565,652,187,565,652,187,,,0,0,0,,,,,,
565,653,193,565,652,194,,,0,1,-1,,,,,,
565,653,201,565,652,201,,,0,1,0,,,,,,
565,653,212,565,652,213,,,0,1,-1,,,,,,
565,653,225,565,652,224,,,0,1,1,,,,,,
565,653,239,565,652,240,,,0,1,-1,,,,,,
565,653,256,565,653,256,,,0,0,0,,,,,,
565,653,273,565,653,273,,,0,0,0,,,,,,
566,653,292,566,653,291,,,0,0,1,,,,,,
566,653,311,566,653,311,,,0,0,0,,,,,,
566,654,331,566,653,331,,,0,1,0,,,,,,
566,654,352,566,653,352,,,0,1,0,,,,,,
566,654,374,567,654,374,,,-1,0,0,,,,,,
567,654,396,567,654,396,,,0,0,0,,,,,,
567,654,418,567,654,418,,,0,0,0,,,,,,
567,655,441,567,654,441,,,0,1,0,,,,,,
568,655,464,568,655,464,,,0,0,0,,,,,,
568,655,487,568,655,487,,,0,0,0,,,,,,
568,656,510,569,656,510,,,-1,0,0,,,,,,
569,656,534,569,656,534,,,0,0,0,,,,,,
569,657,558,569,656,557,,,0,1,1,,,,,,
570,657,582,570,657,582,,,0,0,0,,,,,,
570,657,606,570,657,606,,,0,0,0,,,,,,
571,658,630,571,658,630,,,0,0,0,,,,,,
571,658,655,572,658,654,,,-1,0,1,,,,,,
572,659,679,572,659,679,,,0,0,0,,,,,,
572,659,704,573,659,704,,,-1,0,0,,,,,,
573,660,729,573,660,728,,,0,0,1,,,,,,
574,661,753,574,660,753,,,0,1,0,,,,,,
574,661,778,574,661,778,,,0,0,0,,,,,,
575,681,190,575,681,190,,,0,0,0,,,,,,
575,681,191,575,681,190,,,0,0,1,,,,,,
575,681,194,575,681,194,,,0,0,0,,,,,,
575,681,200,575,681,201,,,0,0,-1,,,,,,
575,681,208,575,681,208,,,0,0,0,,,,,,
575,681,218,575,681,219,,,0,0,-1,,,,,,
575,681,230,575,681,230,,,0,0,0,,,,,,
575,681,245,575,681,245,,,0,0,0,,,,,,
575,682,261,575,681,261,,,0,1,0,,,,,,
575,682,278,575,681,278,,,0,1,0,,,,,,
575,682,296,576,682,296,,,-1,0,0,,,,,,
576,682,315,576,682,315,,,0,0,0,,,,,,
576,682,335,576,682,335,,,0,0,0,,,,,,
576,682,356,576,682,356,,,0,0,0,,,,,,
576,683,377,577,683,377,,,-1,0,0,,,,,,
577,683,399,577,683,399,,,0,0,0,,,,,,
577,683,421,577,683,421,,,0,0,0,,,,,,
577,683,444,577,683,444,,,0,0,0,,,,,,
578,684,466,578,684,466,,,0,0,0,,,,,,
578,684,489,578,684,489,,,0,0,0,,,,,,
578,684,513,578,684,512,,,0,0,1,,,,,,
579,685,536,579,684,536,,,0,1,0,,,,,,
579,685,560,579,685,560,,,0,0,0,,,,,,
580,685,584,580,685,584,,,0,0,0,,,,,,
580,686,608,580,686,608,,,0,0,0,,,,,,
581,686,632,581,686,632,,,0,0,0,,,,,,
581,687,656,581,687,656,,,0,0,0,,,,,,
582,687,681,582,687,681,,,0,0,0,,,,,,
582,688,705,582,688,705,,,0,0,0,,,,,,
583,688,730,583,688,730,,,0,0,0,,,,,,
583,689,755,583,689,755,,,0,0,0,,,,,,
584,689,780,584,689,779,,,0,0,1,,,,,,
585,710,198,585,710,197,,,0,0,1,,,,,,
585,710,198,585,710,197,,,0,0,1,,,,,,
585,710,201,585,710,201,,,0,0,0,,,,,,
585,710,207,585,710,207,,,0,0,0,,,,,,
585,710,214,585,710,214,,,0,0,0,,,,,,
585,710,224,585,710,225,,,0,0,-1,,,,,,
585,710,236,585,710,236,,,0,0,0,,,,,,
585,710,250,585,710,251,,,0,0,-1,,,,,,
585,710,266,585,710,266,,,0,0,0,,,,,,
586,710,283,586,710,283,,,0,0,0,,,,,,
586,711,301,586,710,300,,,0,1,1,,,,,,
586,711,320,586,710,320,,,0,1,0,,,,,,
586,711,339,586,711,339,,,0,0,0,,,,,,
586,711,360,586,711,360,,,0,0,0,,,,,,
587,711,381,587,711,381,,,0,0,0,,,,,,
587,712,402,587,711,402,,,0,1,0,,,,,,
587,712,424,587,712,424,,,0,0,0,,,,,,
587,712,446,587,712,446,,,0,0,0,,,,,,
588,712,469,588,712,469,,,0,0,0,,,,,,
588,713,492,588,712,492,,,0,1,0,,,,,,
588,713,515,588,713,515,,,0,0,0,,,,,,
589,713,539,589,713,538,,,0,0,1,,,,,,
589,714,562,589,713,562,,,0,1,0,,,,,,
590,714,586,590,714,586,,,0,0,0,,,,,,
590,714,610,590,714,610,,,0,0,0,,,,,,
591,715,634,591,715,634,,,0,0,0,,,,,,
591,715,658,591,715,658,,,0,0,0,,,,,,
592,716,683,592,716,682,,,0,0,1,,,,,,
592,716,707,592,716,707,,,0,0,0,,,,,,
593,717,732,593,717,731,,,0,0,1,,,,,,
594,717,756,593,717,756,,,1,0,0,,,,,,
594,718,781,594,718,781,,,0,0,0,,,,,,
595,739,205,596,739,205,,,-1,0,0,,,,,,
595,739,206,596,739,205,,,-1,0,1,,,,,,
595,739,209,596,739,208,,,-1,0,1,,,,,,
596,739,214,596,739,214,,,0,0,0,,,,,,
596,739,221,596,739,221,,,0,0,0,,,,,,
596,739,231,596,739,232,,,0,0,-1,,,,,,
596,739,243,596,739,243,,,0,0,0,,,,,,
596,739,256,596,739,257,,,0,0,-1,,,,,,
596,739,271,596,739,271,,,0,0,0,,,,,,
596,739,288,596,739,288,,,0,0,0,,,,,,
596,739,305,596,739,305,,,0,0,0,,,,,,
596,740,324,596,739,324,,,0,1,0,,,,,,
597,740,343,597,740,343,,,0,0,0,,,,,,
597,740,364,597,740,364,,,0,0,0,,,,,,
597,740,384,597,740,384,,,0,0,0,,,,,,
597,740,406,597,740,406,,,0,0,0,,,,,,
598,741,427,598,741,427,,,0,0,0,,,,,,
598,741,449,598,741,449,,,0,0,0,,,,,,
598,741,472,598,741,471,,,0,0,1,,,,,,
599,741,495,598,741,494,,,1,0,1,,,,,,
599,742,518,599,742,517,,,0,0,1,,,,,,
599,742,541,599,742,541,,,0,0,0,,,,,,
600,742,565,600,742,564,,,0,0,1,,,,,,
600,743,588,600,742,588,,,0,1,0,,,,,,
601,743,612,601,743,612,,,0,0,0,,,,,,
601,744,636,601,743,636,,,0,1,0,,,,,,
602,744,660,602,744,660,,,0,0,0,,,,,,
602,744,685,602,744,684,,,0,0,1,,,,,,
603,745,709,603,745,709,,,0,0,0,,,,,,
603,745,734,603,745,733,,,0,0,1,,,,,,
604,746,758,604,746,758,,,0,0,0,,,,,,
605,746,783,604,746,782,,,1,0,1,,,,,,
606,768,212,606,768,212,,,0,0,0,,,,,,
606,768,213,606,768,212,,,0,0,1,,,,,,
606,768,216,606,768,215,,,0,0,1,,,,,,
606,768,221,606,768,221,,,0,0,0,,,,,,
606,768,228,606,768,228,,,0,0,0,,,,,,
606,768,237,606,768,238,,,0,0,-1,,,,,,
607,768,249,607,768,249,,,0,0,0,,,,,,
607,768,262,607,768,262,,,0,0,0,,,,,,
607,768,277,607,768,276,,,0,0,1,,,,,,
607,768,293,607,768,293,,,0,0,0,,,,,,
607,768,310,607,768,310,,,0,0,0,,,,,,
607,769,328,607,768,329,,,0,1,-1,,,,,,
607,769,348,607,769,347,,,0,0,1,,,,,,
608,769,367,608,769,368,,,0,0,-1,,,,,,
608,769,388,608,769,388,,,0,0,0,,,,,,
608,769,409,608,769,409,,,0,0,0,,,,,,
608,770,431,608,769,431,,,0,1,0,,,,,,
609,770,453,609,769,453,,,0,1,0,,,,,,
609,770,475,609,770,475,,,0,0,0,,,,,,
609,770,498,609,770,497,,,0,0,1,,,,,,
610,771,520,610,770,520,,,0,1,0,,,,,,
610,771,544,610,770,543,,,0,1,1,,,,,,
610,771,567,611,771,567,,,-1,0,0,,,,,,
611,772,591,611,771,590,,,0,1,1,,,,,,
611,772,614,611,772,614,,,0,0,0,,,,,,
612,772,638,612,772,638,,,0,0,0,,,,,,
612,773,662,612,773,662,,,0,0,0,,,,,,
613,773,687,613,773,686,,,0,0,1,,,,,,
613,774,711,614,773,711,,,-1,1,0,,,,,,
614,774,735,614,774,735,,,0,0,0,,,,,,
615,775,760,615,774,759,,,0,1,1,,,,,,
615,775,785,615,775,784,,,0,0,1,,,,,,
617,797,220,617,797,220,,,0,0,0,,,,,,
617,797,221,617,797,220,,,0,0,1,,,,,,
617,797,223,617,797,223,,,0,0,0,,,,,,
617,797,228,617,797,229,,,0,0,-1,,,,,,
617,797,235,617,797,235,,,0,0,0,,,,,,
618,797,244,617,797,245,,,1,0,-1,,,,,,
618,797,255,618,797,255,,,0,0,0,,,,,,
618,797,268,618,797,268,,,0,0,0,,,,,,
618,797,282,618,797,282,,,0,0,0,,,,,,
618,797,298,618,797,298,,,0,0,0,,,,,,
618,797,315,618,797,315,,,0,0,0,,,,,,
618,798,333,618,797,333,,,0,1,0,,,,,,
618,798,352,618,798,352,,,0,0,0,,,,,,
619,798,372,619,798,372,,,0,0,0,,,,,,
619,798,392,619,798,392,,,0,0,0,,,,,,
619,798,413,619,798,413,,,0,0,0,,,,,,
619,798,434,619,798,434,,,0,0,0,,,,,,
620,799,456,620,798,456,,,0,1,0,,,,,,
620,799,478,620,799,478,,,0,0,0,,,,,,
620,799,501,620,799,501,,,0,0,0,,,,,,
621,799,523,621,799,523,,,0,0,0,,,,,,
621,800,546,621,799,546,,,0,1,0,,,,,,
621,800,570,622,800,569,,,-1,0,1,,,,,,
622,800,593,622,800,593,,,0,0,0,,,,,,
622,801,617,622,801,616,,,0,0,1,,,,,,
623,801,641,623,801,640,,,0,0,1,,,,,,
623,802,665,623,802,664,,,0,0,1,,,,,,
624,802,689,624,802,688,,,0,0,1,,,,,,
624,802,713,625,802,713,,,-1,0,0,,,,,,
625,803,737,625,802,737,,,0,1,0,,,,,,
625,803,762,626,803,761,,,-1,0,1,,,,,,
626,804,786,626,803,786,,,0,1,0,,,,,,
629,826,227,629,826,227,,,0,0,0,,,,,,
629,826,228,629,826,227,,,0,0,1,,,,,,
629,826,231,629,826,230,,,0,0,1,,,,,,
629,826,235,629,826,236,,,0,0,-1,,,,,,
629,826,242,629,826,242,,,0,0,0,,,,,,
629,826,251,629,826,251,,,0,0,0,,,,,,
629,826,261,629,826,261,,,0,0,0,,,,,,
629,826,274,629,826,274,,,0,0,0,,,,,,
629,826,288,629,826,288,,,0,0,0,,,,,,
629,826,303,629,826,304,,,0,0,-1,,,,,,
629,826,320,630,826,320,,,-1,0,0,,,,,,
630,827,338,630,826,338,,,0,1,0,,,,,,
630,827,356,630,827,356,,,0,0,0,,,,,,
630,827,376,630,827,376,,,0,0,0,,,,,,
630,827,396,631,827,396,,,-1,0,0,,,,,,
630,827,417,631,827,417,,,-1,0,0,,,,,,
631,827,438,631,827,438,,,0,0,0,,,,,,
631,828,459,631,827,459,,,0,1,0,,,,,,
631,828,481,632,828,481,,,-1,0,0,,,,,,
632,828,504,632,828,504,,,0,0,0,,,,,,
632,828,526,632,828,526,,,0,0,0,,,,,,
632,829,549,632,828,549,,,0,1,0,,,,,,
633,829,572,633,829,572,,,0,0,0,,,,,,
633,829,596,633,829,595,,,0,0,1,,,,,,
634,830,619,634,830,619,,,0,0,0,,,,,,
634,830,643,634,830,642,,,0,0,1,,,,,,
634,830,667,635,830,666,,,-1,0,1,,,,,,
635,831,691,635,830,690,,,0,1,1,,,,,,
636,831,715,636,831,715,,,0,0,0,,,,,,
636,832,739,636,831,739,,,0,1,0,,,,,,
637,832,764,637,832,763,,,0,0,1,,,,,,
637,833,788,637,832,788,,,0,1,0,,,,,,
640,855,235,640,855,235,,,0,0,0,,,,,,
640,855,236,640,855,235,,,0,0,1,,,,,,
640,855,238,640,855,238,,,0,0,0,,,,,,
640,855,242,640,855,243,,,0,0,-1,,,,,,
640,855,249,640,855,249,,,0,0,0,,,,,,
640,855,257,640,855,258,,,0,0,-1,,,,,,
640,855,268,640,855,268,,,0,0,0,,,,,,
641,855,280,640,855,281,,,1,0,-1,,,,,,
641,855,294,641,855,294,,,0,0,0,,,,,,
641,856,309,641,855,309,,,0,1,0,,,,,,
641,856,325,641,856,325,,,0,0,0,,,,,,
641,856,343,641,856,343,,,0,0,0,,,,,,
641,856,361,641,856,361,,,0,0,0,,,,,,
641,856,380,642,856,380,,,-1,0,0,,,,,,
642,856,400,642,856,400,,,0,0,0,,,,,,
642,856,420,642,856,420,,,0,0,0,,,,,,
642,857,441,642,856,441,,,0,1,0,,,,,,
642,857,463,643,856,463,,,-1,1,0,,,,,,
643,857,485,643,857,484,,,0,0,1,,,,,,
643,857,507,643,857,507,,,0,0,0,,,,,,
643,858,529,643,857,529,,,0,1,0,,,,,,
644,858,552,644,857,552,,,0,1,0,,,,,,
644,858,575,644,858,575,,,0,0,0,,,,,,
645,858,598,645,858,598,,,0,0,0,,,,,,
645,859,622,645,859,621,,,0,0,1,,,,,,
645,859,645,646,859,645,,,-1,0,0,,,,,,
646,859,669,646,859,669,,,0,0,0,,,,,,
646,860,693,647,859,693,,,-1,1,0,,,,,,
647,860,717,647,860,717,,,0,0,0,,,,,,
647,861,741,648,860,741,,,-1,1,0,,,,,,
648,861,766,648,861,765,,,0,0,1,,,,,,
649,861,790,649,861,790,,,0,0,0,,,,,,
652,884,242,652,884,242,,,0,0,0,,,,,,
652,884,243,652,884,242,,,0,0,1,,,,,,
652,884,245,652,884,245,,,0,0,0,,,,,,
652,884,250,652,884,250,,,0,0,0,,,,,,
652,884,256,652,884,256,,,0,0,0,,,,,,
652,884,264,652,884,265,,,0,0,-1,,,,,,
652,884,274,652,884,274,,,0,0,0,,,,,,
652,885,286,652,884,287,,,0,1,-1,,,,,,
652,885,300,653,884,300,,,-1,1,0,,,,,,
653,885,315,653,884,315,,,0,1,0,,,,,,
653,885,331,653,885,330,,,0,0,1,,,,,,
653,885,348,653,885,348,,,0,0,0,,,,,,
653,885,366,653,885,365,,,0,0,1,,,,,,
653,885,385,653,885,385,,,0,0,0,,,,,,
653,885,404,654,885,404,,,-1,0,0,,,,,,
654,886,424,654,885,424,,,0,1,0,,,,,,
654,886,445,654,885,445,,,0,1,0,,,,,,
654,886,466,654,886,466,,,0,0,0,,,,,,
655,886,488,655,886,488,,,0,0,0,,,,,,
655,886,510,655,886,510,,,0,0,0,,,,,,
655,887,532,655,886,532,,,0,1,0,,,,,,
656,887,555,656,887,555,,,0,0,0,,,,,,
656,887,578,656,887,577,,,0,0,1,,,,,,
656,888,601,656,887,601,,,0,1,0,,,,,,
657,888,624,657,888,624,,,0,0,0,,,,,,
657,888,648,657,888,647,,,0,0,1,,,,,,
658,888,671,658,888,671,,,0,0,0,,,,,,
658,889,695,658,888,695,,,0,1,0,,,,,,
659,889,719,659,889,719,,,0,0,0,,,,,,
659,890,743,659,889,743,,,0,1,0,,,,,,
660,890,768,660,890,767,,,0,0,1,,,,,,
660,890,792,660,890,792,,,0,0,0,,,,,,
477,132,72,477,132,72,,,0,0,0,,,,,,
477,132,75,477,132,72,,,0,0,3,,,,,,
477,132,83,477,132,83,,,0,0,0,,,,,,
477,132,96,477,132,98,,,0,0,-2,,,,,,
478,133,113,478,133,113,,,0,0,0,,,,,,
478,133,132,478,133,133,,,0,0,-1,,,,,,
478,133,153,478,133,153,,,0,0,0,,,,,,
478,134,175,478,134,175,,,0,0,0,,,,,,
478,135,197,478,135,197,,,0,0,0,,,,,,
478,135,220,478,135,220,,,0,0,0,,,,,,
478,136,243,478,136,243,,,0,0,0,,,,,,
479,137,267,478,137,266,,,1,0,1,,,,,,
479,138,290,479,138,290,,,0,0,0,,,,,,
479,139,314,479,139,314,,,0,0,0,,,,,,
479,141,338,479,141,338,,,0,0,0,,,,,,
480,142,363,479,142,362,,,1,0,1,,,,,,
480,144,387,480,144,387,,,0,0,0,,,,,,
481,145,412,480,145,411,,,1,0,1,,,,,,
481,147,436,481,147,436,,,0,0,0,,,,,,
481,148,461,481,148,461,,,0,0,0,,,,,,
482,150,486,482,150,486,,,0,0,0,,,,,,
482,152,511,482,152,511,,,0,0,0,,,,,,
483,154,536,483,154,536,,,0,0,0,,,,,,
483,156,561,483,156,561,,,0,0,0,,,,,,
484,158,586,484,158,586,,,0,0,0,,,,,,
485,161,611,484,160,611,,,1,1,0,,,,,,
485,163,636,485,163,636,,,0,0,0,,,,,,
486,165,662,486,165,661,,,0,0,1,,,,,,
487,168,687,487,168,687,,,0,0,0,,,,,,
487,170,712,487,170,712,,,0,0,0,,,,,,
488,173,738,488,173,738,,,0,0,0,,,,,,
489,176,763,489,175,763,,,0,1,0,,,,,,
478,134,73,477,132,72,,,1,2,1,,,,,,
478,134,75,477,132,72,,,1,2,3,,,,,,
478,134,83,477,132,83,,,1,2,0,,,,,,
478,134,96,477,132,98,,,1,2,-2,,,,,,
478,134,113,478,133,113,,,0,1,0,,,,,,
478,135,132,478,133,133,,,0,2,-1,,,,,,
478,135,153,478,133,153,,,0,2,0,,,,,,
478,136,175,478,134,175,,,0,2,0,,,,,,
478,136,197,478,135,197,,,0,1,0,,,,,,
478,137,220,478,135,220,,,0,2,0,,,,,,
478,138,243,478,136,243,,,0,2,0,,,,,,
479,139,267,478,137,266,,,1,2,1,,,,,,
479,140,290,479,138,290,,,0,2,0,,,,,,
479,141,314,479,139,314,,,0,2,0,,,,,,
480,142,338,479,141,338,,,1,1,0,,,,,,
480,144,363,479,142,362,,,1,2,1,,,,,,
480,145,387,480,144,387,,,0,1,0,,,,,,
481,147,412,480,145,411,,,1,2,1,,,,,,
481,148,436,481,147,436,,,0,1,0,,,,,,
481,150,461,481,148,461,,,0,2,0,,,,,,
482,152,486,482,150,486,,,0,2,0,,,,,,
482,154,511,482,152,511,,,0,2,0,,,,,,
483,156,536,483,154,536,,,0,2,0,,,,,,
484,158,561,483,156,561,,,1,2,0,,,,,,
484,160,586,484,158,586,,,0,2,0,,,,,,
485,162,611,484,160,611,,,1,2,0,,,,,,
485,164,636,485,163,636,,,0,1,0,,,,,,
486,167,662,486,165,661,,,0,2,1,,,,,,
487,169,687,487,168,687,,,0,1,0,,,,,,
488,172,712,487,170,712,,,1,2,0,,,,,,
488,174,738,488,173,738,,,0,1,0,,,,,,
489,177,763,489,175,763,,,0,2,0,,,,,,
478,140,73,478,140,73,,,0,0,0,,,,,,
478,140,76,478,140,73,,,0,0,3,,,,,,
478,140,84,478,140,84,,,0,0,0,,,,,,
478,140,97,478,140,99,,,0,0,-2,,,,,,
478,140,114,478,140,114,,,0,0,0,,,,,,
478,141,133,478,140,133,,,0,1,0,,,,,,
478,141,153,478,141,153,,,0,0,0,,,,,,
478,142,175,478,141,175,,,0,1,0,,,,,,
479,142,197,479,142,197,,,0,0,0,,,,,,
479,143,220,479,143,220,,,0,0,0,,,,,,
479,144,243,479,144,243,,,0,0,0,,,,,,
479,145,267,479,145,267,,,0,0,0,,,,,,
479,146,291,479,146,291,,,0,0,0,,,,,,
480,147,314,479,147,315,,,1,0,-1,,,,,,
480,148,339,480,148,339,,,0,0,0,,,,,,
480,149,363,480,149,363,,,0,0,0,,,,,,
481,151,387,481,151,387,,,0,0,0,,,,,,
481,152,412,481,152,412,,,0,0,0,,,,,,
481,154,437,481,154,437,,,0,0,0,,,,,,
482,155,461,481,155,461,,,1,0,0,,,,,,
482,157,486,482,157,486,,,0,0,0,,,,,,
483,159,511,482,159,511,,,1,0,0,,,,,,
483,161,536,483,161,536,,,0,0,0,,,,,,
484,163,561,484,163,561,,,0,0,0,,,,,,
485,165,586,485,165,586,,,0,0,0,,,,,,
485,167,611,485,167,611,,,0,0,0,,,,,,
486,169,637,486,169,637,,,0,0,0,,,,,,
487,172,662,486,171,662,,,1,1,0,,,,,,
487,174,687,487,174,687,,,0,0,0,,,,,,
488,176,712,488,176,712,,,0,0,0,,,,,,
489,179,738,489,179,738,,,0,0,0,,,,,,
489,181,763,489,181,763,,,0,0,0,,,,,,
479,150,75,479,152,75,,,0,-2,0,,,,,,
479,150,77,479,152,75,,,0,-2,2,,,,,,
479,150,85,479,152,85,,,0,-2,0,,,,,,
479,151,98,479,152,100,,,0,-1,-2,,,,,,
479,151,115,479,152,115,,,0,-1,0,,,,,,
479,151,133,479,153,134,,,0,-2,-1,,,,,,
479,152,154,479,153,154,,,0,-1,0,,,,,,
479,152,175,479,154,175,,,0,-2,0,,,,,,
479,153,198,480,154,197,,,-1,-1,1,,,,,,
480,153,220,480,155,220,,,0,-2,0,,,,,,
480,154,244,480,156,243,,,0,-2,1,,,,,,
480,155,267,480,157,267,,,0,-2,0,,,,,,
480,156,291,480,158,291,,,0,-2,0,,,,,,
480,157,315,480,159,315,,,0,-2,0,,,,,,
481,158,339,481,160,339,,,0,-2,0,,,,,,
481,159,363,481,161,363,,,0,-2,0,,,,,,
481,160,388,482,162,387,,,-1,-2,1,,,,,,
482,162,412,482,164,412,,,0,-2,0,,,,,,
482,163,437,482,165,437,,,0,-2,0,,,,,,
483,165,461,482,166,461,,,1,-1,0,,,,,,
483,166,486,483,168,486,,,0,-2,0,,,,,,
484,168,511,483,170,511,,,1,-2,0,,,,,,
484,170,536,484,172,536,,,0,-2,0,,,,,,
485,172,561,485,173,561,,,0,-1,0,,,,,,
485,174,586,486,175,586,,,-1,-1,0,,,,,,
486,176,611,486,177,611,,,0,-1,0,,,,,,
487,178,637,487,179,637,,,0,-1,0,,,,,,
487,180,662,487,181,662,,,0,-1,0,,,,,,
488,182,687,488,184,687,,,0,-2,0,,,,,,
489,185,713,489,186,712,,,0,-1,1,,,,,,
489,187,738,490,188,738,,,-1,-1,0,,,,,,
490,189,763,490,191,763,,,0,-2,0,,,,,,
480,165,77,480,165,77,,,0,0,0,,,,,,
480,165,79,480,165,77,,,0,0,2,,,,,,
480,165,87,480,165,87,,,0,0,0,,,,,,
480,165,100,480,165,101,,,0,0,-1,,,,,,
480,165,116,480,165,116,,,0,0,0,,,,,,
480,166,135,480,165,135,,,0,1,0,,,,,,
480,166,155,480,166,155,,,0,0,0,,,,,,
480,166,176,480,166,176,,,0,0,0,,,,,,
481,167,198,481,167,198,,,0,0,0,,,,,,
481,167,221,481,167,221,,,0,0,0,,,,,,
481,168,244,481,168,244,,,0,0,0,,,,,,
481,169,268,481,169,267,,,0,0,1,,,,,,
481,170,291,481,170,291,,,0,0,0,,,,,,
482,171,315,481,171,315,,,1,0,0,,,,,,
482,172,339,482,172,339,,,0,0,0,,,,,,
482,173,364,482,173,363,,,0,0,1,,,,,,
483,174,388,483,174,388,,,0,0,0,,,,,,
483,175,412,483,175,412,,,0,0,0,,,,,,
483,177,437,483,177,437,,,0,0,0,,,,,,
484,178,462,483,178,462,,,1,0,0,,,,,,
484,179,487,484,179,487,,,0,0,0,,,,,,
485,181,511,484,181,511,,,1,0,0,,,,,,
485,183,536,485,183,536,,,0,0,0,,,,,,
486,184,561,486,184,561,,,0,0,0,,,,,,
487,186,586,487,186,586,,,0,0,0,,,,,,
487,188,612,487,188,611,,,0,0,1,,,,,,
488,190,637,488,190,637,,,0,0,0,,,,,,
488,192,662,488,192,662,,,0,0,0,,,,,,
489,194,687,489,194,687,,,0,0,0,,,,,,
490,196,713,490,196,712,,,0,0,1,,,,,,
491,198,738,491,198,738,,,0,0,0,,,,,,
491,201,764,491,200,763,,,0,1,1,,,,,,
482,182,79,482,183,79,,,0,-1,0,,,,,,
482,182,81,482,183,79,,,0,-1,2,,,,,,
482,182,89,482,183,89,,,0,-1,0,,,,,,
482,183,101,482,183,103,,,0,0,-2,,,,,,
482,183,118,482,184,118,,,0,-1,0,,,,,,
482,183,136,482,184,137,,,0,-1,-1,,,,,,
482,183,156,482,184,156,,,0,-1,0,,,,,,
482,184,177,482,185,177,,,0,-1,0,,,,,,
482,184,199,482,185,199,,,0,-1,0,,,,,,
482,185,222,482,186,222,,,0,-1,0,,,,,,
483,185,245,483,186,245,,,0,-1,0,,,,,,
483,186,268,483,187,268,,,0,-1,0,,,,,,
483,187,292,483,188,292,,,0,-1,0,,,,,,
483,188,316,483,189,315,,,0,-1,1,,,,,,
484,189,340,484,190,339,,,0,-1,1,,,,,,
484,190,364,484,191,364,,,0,-1,0,,,,,,
484,191,388,484,192,388,,,0,-1,0,,,,,,
485,192,413,484,193,413,,,1,-1,0,,,,,,
485,193,437,485,194,437,,,0,-1,0,,,,,,
486,194,462,485,195,462,,,1,-1,0,,,,,,
486,196,487,486,196,487,,,0,0,0,,,,,,
487,197,512,486,198,511,,,1,-1,1,,,,,,
487,199,537,487,200,536,,,0,-1,1,,,,,,
488,200,562,487,201,561,,,1,-1,1,,,,,,
488,202,587,488,203,586,,,0,-1,1,,,,,,
489,203,612,489,204,611,,,0,-1,1,,,,,,
489,205,637,489,206,637,,,0,-1,0,,,,,,
490,207,662,490,208,662,,,0,-1,0,,,,,,
491,209,688,491,210,687,,,0,-1,1,,,,,,
492,211,713,491,212,713,,,1,-1,0,,,,,,
492,213,738,492,214,738,,,0,-1,0,,,,,,
493,215,764,493,216,763,,,0,-1,1,,,,,,
484,202,82,484,202,82,,,0,0,0,,,,,,
484,202,85,484,202,82,,,0,0,3,,,,,,
484,202,92,484,202,92,,,0,0,0,,,,,,
484,203,104,484,202,106,,,0,1,-2,,,,,,
484,203,120,484,203,120,,,0,0,0,,,,,,
484,203,138,484,203,139,,,0,0,-1,,,,,,
484,203,158,484,203,158,,,0,0,0,,,,,,
484,204,179,484,203,179,,,0,1,0,,,,,,
484,204,200,484,204,200,,,0,0,0,,,,,,
484,204,223,484,204,223,,,0,0,0,,,,,,
485,205,246,485,205,246,,,0,0,0,,,,,,
485,206,269,485,205,269,,,0,1,0,,,,,,
485,206,293,485,206,293,,,0,0,0,,,,,,
485,207,316,485,207,316,,,0,0,0,,,,,,
486,208,340,486,208,340,,,0,0,0,,,,,,
486,209,365,486,209,364,,,0,0,1,,,,,,
486,210,389,486,210,389,,,0,0,0,,,,,,
487,211,413,486,211,413,,,1,0,0,,,,,,
487,212,438,487,212,438,,,0,0,0,,,,,,
488,213,463,487,213,462,,,1,0,1,,,,,,
488,214,487,488,214,487,,,0,0,0,,,,,,
489,216,512,488,215,512,,,1,1,0,,,,,,
489,217,537,489,217,537,,,0,0,0,,,,,,
490,218,562,489,218,562,,,1,0,0,,,,,,
490,220,587,490,220,587,,,0,0,0,,,,,,
491,221,612,490,221,612,,,1,0,0,,,,,,
491,223,637,491,223,637,,,0,0,0,,,,,,
492,225,663,492,224,662,,,0,1,1,,,,,,
493,226,688,493,226,688,,,0,0,0,,,,,,
494,228,713,493,228,713,,,1,0,0,,,,,,
494,230,739,494,230,739,,,0,0,0,,,,,,
495,232,764,495,232,764,,,0,0,0,,,,,,
486,224,86,486,224,86,,,0,0,0,,,,,,
486,224,88,486,224,86,,,0,0,2,,,,,,
486,224,95,486,224,95,,,0,0,0,,,,,,
486,224,107,486,225,109,,,0,-1,-2,,,,,,
486,224,122,486,225,122,,,0,-1,0,,,,,,
486,225,140,486,225,141,,,0,0,-1,,,,,,
487,225,159,487,225,160,,,0,0,-1,,,,,,
487,225,180,487,226,181,,,0,-1,-1,,,,,,
487,226,202,487,226,202,,,0,0,0,,,,,,
487,226,224,487,226,224,,,0,0,0,,,,,,
487,227,247,487,227,247,,,0,0,0,,,,,,
487,227,270,487,227,270,,,0,0,0,,,,,,
488,228,294,488,228,294,,,0,0,0,,,,,,
488,228,317,488,229,317,,,0,-1,0,,,,,,
488,229,341,488,230,341,,,0,-1,0,,,,,,
489,230,365,488,230,365,,,1,0,0,,,,,,
489,231,390,489,231,389,,,0,0,1,,,,,,
489,232,414,489,232,414,,,0,0,0,,,,,,
490,233,439,490,233,438,,,0,0,1,,,,,,
490,234,463,490,234,463,,,0,0,0,,,,,,
491,235,488,491,235,488,,,0,0,0,,,,,,
491,236,513,491,236,512,,,0,0,1,,,,,,
492,237,538,492,238,537,,,0,-1,1,,,,,,
492,238,563,492,239,562,,,0,-1,1,,,,,,
493,240,588,493,240,587,,,0,0,1,,,,,,
493,241,613,493,242,612,,,0,-1,1,,,,,,
494,243,638,494,243,637,,,0,0,1,,,,,,
495,244,663,494,245,663,,,1,-1,0,,,,,,
495,246,688,495,246,688,,,0,0,0,,,,,,
496,248,714,496,248,713,,,0,0,1,,,,,,
497,249,739,497,250,739,,,0,-1,0,,,,,,
498,251,764,497,251,764,,,1,0,0,,,,,,
489,247,90,489,247,90,,,0,0,0,,,,,,
489,247,92,489,247,90,,,0,0,2,,,,,,
489,247,99,489,247,99,,,0,0,0,,,,,,
489,247,110,489,247,112,,,0,0,-2,,,,,,
489,248,125,489,248,125,,,0,0,0,,,,,,
489,248,142,489,248,143,,,0,0,-1,,,,,,
490,248,162,490,248,162,,,0,0,0,,,,,,
490,248,182,490,248,183,,,0,0,-1,,,,,,
490,249,204,490,249,204,,,0,0,0,,,,,,
490,249,226,490,249,226,,,0,0,0,,,,,,
490,249,248,490,249,248,,,0,0,0,,,,,,
490,250,271,490,249,271,,,0,1,0,,,,,,
491,250,295,491,250,295,,,0,0,0,,,,,,
491,251,318,491,251,318,,,0,0,0,,,,,,
491,252,342,491,252,342,,,0,0,0,,,,,,
492,252,366,491,252,366,,,1,0,0,,,,,,
492,253,390,492,253,390,,,0,0,0,,,,,,
492,254,415,492,254,414,,,0,0,1,,,,,,
493,255,439,493,255,439,,,0,0,0,,,,,,
493,256,464,493,256,464,,,0,0,0,,,,,,
494,257,489,494,257,489,,,0,0,0,,,,,,
494,258,513,494,258,513,,,0,0,0,,,,,,
495,259,538,495,259,538,,,0,0,0,,,,,,
495,260,563,495,260,563,,,0,0,0,,,,,,
496,261,588,496,261,588,,,0,0,0,,,,,,
496,263,613,496,262,613,,,0,1,0,,,,,,
497,264,638,497,264,638,,,0,0,0,,,,,,
498,266,663,497,265,663,,,1,1,0,,,,,,
498,267,689,498,267,689,,,0,0,0,,,,,,
499,268,714,499,268,714,,,0,0,0,,,,,,
500,270,739,500,270,739,,,0,0,0,,,,,,
500,272,765,500,271,764,,,0,1,1,,,,,,
493,272,95,493,272,95,,,0,0,0,,,,,,
493,272,97,493,272,95,,,0,0,2,,,,,,
493,272,103,493,272,103,,,0,0,0,,,,,,
493,272,114,493,272,116,,,0,0,-2,,,,,,
493,272,128,493,272,128,,,0,0,0,,,,,,
493,272,145,493,272,146,,,0,0,-1,,,,,,
493,272,164,493,272,164,,,0,0,0,,,,,,
493,272,184,493,273,185,,,0,-1,-1,,,,,,
493,273,205,493,273,206,,,0,0,-1,,,,,,
493,273,227,493,273,228,,,0,0,-1,,,,,,
494,273,250,494,273,250,,,0,0,0,,,,,,
494,274,273,494,274,273,,,0,0,0,,,,,,
494,274,296,494,274,296,,,0,0,0,,,,,,
494,275,319,494,275,319,,,0,0,0,,,,,,
495,276,343,495,276,343,,,0,0,0,,,,,,
495,276,367,495,276,367,,,0,0,0,,,,,,
495,277,391,495,277,391,,,0,0,0,,,,,,
496,278,416,496,278,415,,,0,0,1,,,,,,
496,278,440,496,279,440,,,0,-1,0,,,,,,
497,279,465,497,279,464,,,0,0,1,,,,,,
497,280,489,497,280,489,,,0,0,0,,,,,,
497,281,514,498,281,514,,,-1,0,0,,,,,,
498,282,539,498,282,539,,,0,0,0,,,,,,
498,283,564,499,283,563,,,-1,0,1,,,,,,
499,284,589,499,284,588,,,0,0,1,,,,,,
500,286,614,500,285,613,,,0,1,1,,,,,,
500,287,639,500,287,638,,,0,0,1,,,,,,
501,288,664,501,288,664,,,0,0,0,,,,,,
502,289,689,501,290,689,,,1,-1,0,,,,,,
502,291,714,502,291,714,,,0,0,0,,,,,,
503,292,740,503,292,739,,,0,0,1,,,,,,
504,294,765,504,294,765,,,0,0,0,,,,,,
497,297,100,497,297,100,,,0,0,0,,,,,,
497,297,102,497,297,100,,,0,0,2,,,,,,
497,297,108,497,297,108,,,0,0,0,,,,,,
497,297,118,497,297,120,,,0,0,-2,,,,,,
497,297,132,497,297,132,,,0,0,0,,,,,,
497,297,149,497,297,149,,,0,0,0,,,,,,
497,297,167,497,297,167,,,0,0,0,,,,,,
497,297,187,497,297,187,,,0,0,0,,,,,,
497,298,208,497,298,208,,,0,0,0,,,,,,
497,298,229,497,298,230,,,0,0,-1,,,,,,
498,298,252,498,298,252,,,0,0,0,,,,,,
498,299,274,498,298,274,,,0,1,0,,,,,,
498,299,297,498,299,297,,,0,0,0,,,,,,
498,300,321,498,299,320,,,0,1,1,,,,,,
499,300,344,499,300,344,,,0,0,0,,,,,,
499,301,368,499,300,368,,,0,1,0,,,,,,
499,301,392,499,301,392,,,0,0,0,,,,,,
500,302,417,499,302,416,,,1,0,1,,,,,,
500,303,441,500,303,441,,,0,0,0,,,,,,
500,304,465,500,303,465,,,0,1,0,,,,,,
501,304,490,501,304,490,,,0,0,0,,,,,,
501,305,515,501,305,515,,,0,0,0,,,,,,
502,306,540,502,306,540,,,0,0,0,,,,,,
502,307,564,502,307,564,,,0,0,0,,,,,,
503,308,589,503,308,589,,,0,0,0,,,,,,
504,309,614,503,309,614,,,1,0,0,,,,,,
504,310,639,504,310,639,,,0,0,0,,,,,,
505,312,665,504,311,664,,,1,1,1,,,,,,
505,313,690,505,313,690,,,0,0,0,,,,,,
506,314,715,506,314,715,,,0,0,0,,,,,,
507,315,740,507,315,740,,,0,0,0,,,,,,
508,317,766,507,316,765,,,1,1,1,,,,,,
501,322,106,501,322,105,,,0,0,1,,,,,,
501,322,107,501,322,105,,,0,0,2,,,,,,
501,322,113,501,322,113,,,0,0,0,,,,,,
501,322,123,501,322,124,,,0,0,-1,,,,,,
501,322,136,501,323,136,,,0,-1,0,,,,,,
501,323,152,501,323,153,,,0,0,-1,,,,,,
501,323,170,501,323,170,,,0,0,0,,,,,,
501,323,190,501,323,190,,,0,0,0,,,,,,
502,323,210,501,323,210,,,1,0,0,,,,,,
502,323,232,502,323,232,,,0,0,0,,,,,,
502,324,254,502,324,254,,,0,0,0,,,,,,
502,324,276,502,324,276,,,0,0,0,,,,,,
502,325,299,502,325,299,,,0,0,0,,,,,,
503,325,322,503,325,322,,,0,0,0,,,,,,
503,325,346,503,325,345,,,0,0,1,,,,,,
503,326,370,503,326,369,,,0,0,1,,,,,,
504,327,394,503,326,393,,,1,1,1,,,,,,
504,327,418,504,327,417,,,0,0,1,,,,,,
504,328,442,504,328,442,,,0,0,0,,,,,,
505,329,466,505,329,466,,,0,0,0,,,,,,
505,329,491,505,329,491,,,0,0,0,,,,,,
506,330,516,506,330,515,,,0,0,1,,,,,,
506,331,540,506,331,540,,,0,0,0,,,,,,
507,332,565,507,332,565,,,0,0,0,,,,,,
507,333,590,507,333,590,,,0,0,0,,,,,,
508,334,615,508,334,615,,,0,0,0,,,,,,
508,335,640,508,335,640,,,0,0,0,,,,,,
509,336,665,509,336,665,,,0,0,0,,,,,,
510,337,690,509,337,690,,,1,0,0,,,,,,
510,338,716,510,338,715,,,0,0,1,,,,,,
511,339,741,511,339,741,,,0,0,0,,,,,,
512,341,766,512,341,766,,,0,0,0,,,,,,
506,348,111,506,348,111,,,0,0,0,,,,,,
506,348,113,506,348,111,,,0,0,2,,,,,,
506,348,118,506,348,118,,,0,0,0,,,,,,
506,348,128,506,348,129,,,0,0,-1,,,,,,
506,349,140,506,349,140,,,0,0,0,,,,,,
506,349,156,506,349,156,,,0,0,0,,,,,,
506,349,173,506,349,173,,,0,0,0,,,,,,
506,349,193,506,349,193,,,0,0,0,,,,,,
506,349,213,506,349,213,,,0,0,0,,,,,,
507,349,234,506,349,234,,,1,0,0,,,,,,
507,350,256,507,350,256,,,0,0,0,,,,,,
507,350,278,507,350,278,,,0,0,0,,,,,,
507,351,301,507,351,301,,,0,0,0,,,,,,
507,351,324,507,351,324,,,0,0,0,,,,,,
508,351,347,508,351,347,,,0,0,0,,,,,,
508,352,371,508,351,371,,,0,1,0,,,,,,
508,352,395,508,352,395,,,0,0,0,,,,,,
509,353,419,508,353,419,,,1,0,0,,,,,,
509,354,443,509,354,443,,,0,0,0,,,,,,
510,354,468,509,354,467,,,1,0,1,,,,,,
510,355,492,510,355,492,,,0,0,0,,,,,,
510,356,517,510,355,516,,,0,1,1,,,,,,
511,356,541,511,356,541,,,0,0,0,,,,,,
511,357,566,511,357,566,,,0,0,0,,,,,,
512,358,591,512,358,591,,,0,0,0,,,,,,
513,359,616,512,359,616,,,1,0,0,,,,,,
513,360,641,513,360,641,,,0,0,0,,,,,,
514,361,666,513,361,666,,,1,0,0,,,,,,
514,362,691,514,362,691,,,0,0,0,,,,,,
515,363,716,515,363,716,,,0,0,0,,,,,,
516,364,742,516,364,742,,,0,0,0,,,,,,
517,365,767,516,365,767,,,1,0,0,,,,,,
511,375,117,511,375,117,,,0,0,0,,,,,,
511,375,119,511,375,117,,,0,0,2,,,,,,
511,375,124,511,375,123,,,0,0,1,,,,,,
511,375,133,511,375,134,,,0,0,-1,,,,,,
511,375,145,511,375,145,,,0,0,0,,,,,,
511,375,160,511,375,161,,,0,0,-1,,,,,,
511,375,177,511,375,177,,,0,0,0,,,,,,
511,376,196,511,375,196,,,0,1,0,,,,,,
512,376,216,511,376,216,,,1,0,0,,,,,,
512,376,237,512,376,237,,,0,0,0,,,,,,
512,376,258,512,376,258,,,0,0,0,,,,,,
512,377,280,512,377,280,,,0,0,0,,,,,,
512,377,303,512,377,303,,,0,0,0,,,,,,
513,377,326,513,377,326,,,0,0,0,,,,,,
513,378,349,513,377,349,,,0,1,0,,,,,,
513,378,373,513,378,372,,,0,0,1,,,,,,
514,379,396,513,378,396,,,1,1,0,,,,,,
514,379,420,514,379,420,,,0,0,0,,,,,,
514,380,445,514,380,444,,,0,0,1,,,,,,
515,380,469,515,380,468,,,0,0,1,,,,,,
515,381,493,515,381,493,,,0,0,0,,,,,,
516,382,518,516,382,517,,,0,0,1,,,,,,
516,382,542,516,382,542,,,0,0,0,,,,,,
517,383,567,517,383,567,,,0,0,0,,,,,,
517,384,592,517,384,592,,,0,0,0,,,,,,
518,385,617,518,385,617,,,0,0,0,,,,,,
518,386,642,518,386,642,,,0,0,0,,,,,,
519,387,667,519,387,667,,,0,0,0,,,,,,
520,388,692,519,388,692,,,1,0,0,,,,,,
520,389,717,520,389,717,,,0,0,0,,,,,,
521,390,742,521,390,742,,,0,0,0,,,,,,
522,391,768,522,391,767,,,0,0,1,,,,,,
517,402,123,517,402,123,,,0,0,0,,,,,,
517,402,125,517,402,123,,,0,0,2,,,,,,
517,402,129,517,402,129,,,0,0,0,,,,,,
517,402,138,517,402,139,,,0,0,-1,,,,,,
517,402,150,517,402,150,,,0,0,0,,,,,,
517,402,164,517,402,165,,,0,0,-1,,,,,,
517,402,181,517,402,181,,,0,0,0,,,,,,
517,402,199,517,402,200,,,0,0,-1,,,,,,
517,403,219,517,403,219,,,0,0,0,,,,,,
517,403,239,517,403,240,,,0,0,-1,,,,,,
518,403,261,518,403,261,,,0,0,0,,,,,,
518,403,283,518,403,283,,,0,0,0,,,,,,
518,404,305,518,404,305,,,0,0,0,,,,,,
518,404,328,518,404,328,,,0,0,0,,,,,,
519,404,351,519,404,351,,,0,0,0,,,,,,
519,405,374,519,404,374,,,0,1,0,,,,,,
519,405,398,519,405,398,,,0,0,0,,,,,,
520,406,422,519,405,422,,,1,1,0,,,,,,
520,406,446,520,406,446,,,0,0,0,,,,,,
520,407,470,520,407,470,,,0,0,0,,,,,,
521,408,494,521,408,494,,,0,0,0,,,,,,
521,408,519,521,408,519,,,0,0,0,,,,,,
522,409,544,522,409,544,,,0,0,0,,,,,,
522,410,568,522,409,568,,,0,1,0,,,,,,
523,410,593,523,410,593,,,0,0,0,,,,,,
523,411,618,523,411,618,,,0,0,0,,,,,,
524,412,643,524,412,643,,,0,0,0,,,,,,
525,413,668,524,413,668,,,1,0,0,,,,,,
525,414,693,525,414,693,,,0,0,0,,,,,,
526,415,718,526,415,718,,,0,0,0,,,,,,
527,416,743,527,416,743,,,0,0,0,,,,,,
527,417,768,527,417,768,,,0,0,0,,,,,,
523,429,130,523,429,129,,,0,0,1,,,,,,
523,429,131,523,429,129,,,0,0,2,,,,,,
523,429,135,523,429,135,,,0,0,0,,,,,,
523,429,144,523,429,145,,,0,0,-1,,,,,,
523,429,155,523,429,155,,,0,0,0,,,,,,
523,429,169,523,429,170,,,0,0,-1,,,,,,
523,429,185,523,429,185,,,0,0,0,,,,,,
523,430,203,523,429,204,,,0,1,-1,,,,,,
523,430,222,523,430,222,,,0,0,0,,,,,,
524,430,242,523,430,243,,,1,0,-1,,,,,,
524,430,264,524,430,264,,,0,0,0,,,,,,
524,431,285,524,430,285,,,0,1,0,,,,,,
524,431,307,524,431,307,,,0,0,0,,,,,,
525,431,330,524,431,330,,,1,0,0,,,,,,
525,431,353,525,431,353,,,0,0,0,,,,,,
525,432,376,525,432,376,,,0,0,0,,,,,,
525,432,400,525,432,400,,,0,0,0,,,,,,
526,433,424,526,432,423,,,0,1,1,,,,,,
526,433,447,526,433,447,,,0,0,0,,,,,,
527,434,472,526,433,471,,,1,1,1,,,,,,
527,434,496,527,434,495,,,0,0,1,,,,,,
527,435,520,527,435,520,,,0,0,0,,,,,,
528,436,545,528,436,545,,,0,0,0,,,,,,
528,436,569,528,436,569,,,0,0,0,,,,,,
529,437,594,529,437,594,,,0,0,0,,,,,,
529,438,619,529,437,619,,,0,1,0,,,,,,
530,438,644,530,438,644,,,0,0,0,,,,,,
531,439,669,531,439,669,,,0,0,0,,,,,,
531,440,694,531,440,694,,,0,0,0,,,,,,
532,441,719,532,441,719,,,0,0,0,,,,,,
533,442,744,533,442,744,,,0,0,0,,,,,,
533,443,769,533,443,769,,,0,0,0,,,,,,
530,457,136,530,457,136,,,0,0,0,,,,,,
530,457,137,530,457,136,,,0,0,1,,,,,,
530,457,142,530,457,142,,,0,0,0,,,,,,
530,457,149,530,457,151,,,0,0,-2,,,,,,
530,457,160,530,457,160,,,0,0,0,,,,,,
530,457,174,530,457,175,,,0,0,-1,,,,,,
530,457,190,530,457,190,,,0,0,0,,,,,,
530,457,207,530,457,208,,,0,0,-1,,,,,,
530,457,226,530,457,226,,,0,0,0,,,,,,
530,457,246,530,457,246,,,0,0,0,,,,,,
530,458,267,530,458,267,,,0,0,0,,,,,,
531,458,288,530,458,288,,,1,0,0,,,,,,
531,458,310,531,458,310,,,0,0,0,,,,,,
531,458,332,531,458,332,,,0,0,0,,,,,,
531,459,355,531,459,355,,,0,0,0,,,,,,
532,459,378,531,459,378,,,1,0,0,,,,,,
532,460,402,532,460,402,,,0,0,0,,,,,,
532,460,425,532,460,425,,,0,0,0,,,,,,
533,460,449,533,460,449,,,0,0,0,,,,,,
533,461,473,533,460,473,,,0,1,0,,,,,,
533,461,497,533,461,497,,,0,0,0,,,,,,
534,462,522,533,462,521,,,1,0,1,,,,,,
534,463,546,534,463,546,,,0,0,0,,,,,,
535,463,571,534,463,570,,,1,0,1,,,,,,
535,464,595,535,464,595,,,0,0,0,,,,,,
536,465,620,536,464,620,,,0,1,0,,,,,,
537,465,645,537,465,645,,,0,0,0,,,,,,
537,466,670,537,466,670,,,0,0,0,,,,,,
538,467,695,538,467,695,,,0,0,0,,,,,,
538,468,720,538,467,720,,,0,1,0,,,,,,
539,468,745,539,468,745,,,0,0,0,,,,,,
540,469,770,540,469,770,,,0,0,0,,,,,,
537,484,143,537,484,142,,,0,0,1,,,,,,
537,484,144,537,484,142,,,0,0,2,,,,,,
537,484,148,537,484,148,,,0,0,0,,,,,,
537,484,155,537,484,157,,,0,0,-2,,,,,,
537,484,166,537,484,166,,,0,0,0,,,,,,
537,484,179,537,484,180,,,0,0,-1,,,,,,
537,485,194,537,484,194,,,0,1,0,,,,,,
537,485,211,537,484,212,,,0,1,-1,,,,,,
537,485,230,537,485,230,,,0,0,0,,,,,,
537,485,249,537,485,250,,,0,0,-1,,,,,,
537,485,270,537,485,270,,,0,0,0,,,,,,
538,485,291,537,485,291,,,1,0,0,,,,,,
538,486,313,538,486,312,,,0,0,1,,,,,,
538,486,335,538,486,335,,,0,0,0,,,,,,
538,486,357,538,486,357,,,0,0,0,,,,,,
539,487,380,538,487,380,,,1,0,0,,,,,,
539,487,404,539,487,404,,,0,0,0,,,,,,
539,487,427,539,487,427,,,0,0,0,,,,,,
540,488,451,540,488,451,,,0,0,0,,,,,,
540,488,475,540,488,475,,,0,0,0,,,,,,
540,489,499,540,488,499,,,0,1,0,,,,,,
541,489,523,541,489,523,,,0,0,0,,,,,,
541,490,548,541,490,547,,,0,0,1,,,,,,
542,491,572,542,490,572,,,0,1,0,,,,,,
542,491,597,542,491,596,,,0,0,1,,,,,,
543,492,621,543,492,621,,,0,0,0,,,,,,
543,492,646,544,492,646,,,-1,0,0,,,,,,
544,493,671,544,493,671,,,0,0,0,,,,,,
545,494,696,545,494,696,,,0,0,0,,,,,,
545,495,721,545,494,721,,,0,1,0,,,,,,
546,495,746,546,495,746,,,0,0,0,,,,,,
547,496,771,547,496,771,,,0,0,0,,,,,,
544,512,149,544,512,149,,,0,0,0,,,,,,
544,512,150,544,512,149,,,0,0,1,,,,,,
544,512,154,544,512,154,,,0,0,0,,,,,,
544,512,161,544,512,163,,,0,0,-2,,,,,,
544,512,172,544,512,172,,,0,0,0,,,,,,
544,512,184,544,512,185,,,0,0,-1,,,,,,
544,512,199,544,512,199,,,0,0,0,,,,,,
544,513,216,544,512,216,,,0,1,0,,,,,,
544,513,234,544,513,234,,,0,0,0,,,,,,
545,513,253,544,513,253,,,1,0,0,,,,,,
545,513,273,545,513,273,,,0,0,0,,,,,,
545,513,294,545,513,294,,,0,0,0,,,,,,
545,514,315,545,514,315,,,0,0,0,,,,,,
545,514,337,545,514,337,,,0,0,0,,,,,,
546,514,360,546,514,360,,,0,0,0,,,,,,
546,514,383,546,514,383,,,0,0,0,,,,,,
546,515,406,546,515,406,,,0,0,0,,,,,,
547,515,429,546,515,429,,,1,0,0,,,,,,
547,516,453,547,516,453,,,0,0,0,,,,,,
547,516,477,547,516,477,,,0,0,0,,,,,,
548,516,501,548,516,501,,,0,0,0,,,,,,
548,517,525,548,516,525,,,0,1,0,,,,,,
549,517,549,549,517,549,,,0,0,0,,,,,,
549,518,573,549,518,573,,,0,0,0,,,,,,
550,519,598,550,519,598,,,0,0,0,,,,,,
550,519,623,550,519,622,,,0,0,1,,,,,,
551,520,647,551,520,647,,,0,0,0,,,,,,
551,520,672,551,520,672,,,0,0,0,,,,,,
552,521,697,552,521,697,,,0,0,0,,,,,,
553,522,722,552,522,722,,,1,0,0,,,,,,
553,523,747,553,523,747,,,0,0,0,,,,,,
554,523,772,554,523,772,,,0,0,0,,,,,,
552,540,156,552,540,156,,,0,0,0,,,,,,
552,540,157,552,540,156,,,0,0,1,,,,,,
552,540,161,552,540,161,,,0,0,0,,,,,,
552,540,168,552,540,169,,,0,0,-1,,,,,,
552,540,177,552,540,177,,,0,0,0,,,,,,
552,540,190,552,540,190,,,0,0,0,,,,,,
552,540,204,552,540,204,,,0,0,0,,,,,,
552,541,220,552,540,221,,,0,1,-1,,,,,,
552,541,238,552,541,238,,,0,0,0,,,,,,
552,541,257,552,541,257,,,0,0,0,,,,,,
553,541,277,553,541,276,,,0,0,1,,,,,,
553,541,297,553,541,297,,,0,0,0,,,,,,
553,542,318,553,542,318,,,0,0,0,,,,,,
553,542,340,553,542,340,,,0,0,0,,,,,,
553,542,363,554,542,362,,,-1,0,1,,,,,,
554,542,385,554,542,385,,,0,0,0,,,,,,
554,543,408,554,543,408,,,0,0,0,,,,,,
554,543,431,554,543,431,,,0,0,0,,,,,,
555,543,455,555,543,455,,,0,0,0,,,,,,
555,544,479,555,543,478,,,0,1,1,,,,,,
555,544,502,556,544,502,,,-1,0,0,,,,,,
556,545,527,556,544,526,,,0,1,1,,,,,,
556,545,551,556,545,550,,,0,0,1,,,,,,
557,546,575,557,545,575,,,0,1,0,,,,,,
557,546,599,557,546,599,,,0,0,0,,,,,,
558,547,624,558,547,624,,,0,0,0,,,,,,
558,547,649,558,547,648,,,0,0,1,,,,,,
559,548,673,559,548,673,,,0,0,0,,,,,,
560,549,698,560,548,698,,,0,1,0,,,,,,
560,549,723,560,549,723,,,0,0,0,,,,,,
561,550,748,561,550,748,,,0,0,0,,,,,,
562,551,773,561,551,773,,,1,0,0,,,,,,
560,568,163,560,568,163,,,0,0,0,,,,,,
560,568,164,560,568,163,,,0,0,1,,,,,,
560,568,168,560,568,168,,,0,0,0,,,,,,
560,568,174,560,568,175,,,0,0,-1,,,,,,
560,568,183,560,568,183,,,0,0,0,,,,,,
560,569,195,560,568,196,,,0,1,-1,,,,,,
560,569,209,560,569,209,,,0,0,0,,,,,,
560,569,225,560,569,225,,,0,0,0,,,,,,
560,569,242,560,569,242,,,0,0,0,,,,,,
560,569,261,560,569,261,,,0,0,0,,,,,,
561,569,280,561,569,280,,,0,0,0,,,,,,
561,569,301,561,569,301,,,0,0,0,,,,,,
561,570,322,561,570,322,,,0,0,0,,,,,,
561,570,343,561,570,343,,,0,0,0,,,,,,
562,570,365,562,570,365,,,0,0,0,,,,,,
562,570,388,562,570,388,,,0,0,0,,,,,,
562,571,411,562,571,411,,,0,0,0,,,,,,
562,571,434,562,571,434,,,0,0,0,,,,,,
563,571,457,563,571,457,,,0,0,0,,,,,,
563,572,481,563,571,480,,,0,1,1,,,,,,
564,572,504,564,572,504,,,0,0,0,,,,,,
564,573,528,564,572,528,,,0,1,0,,,,,,
564,573,552,564,573,552,,,0,0,0,,,,,,
565,574,577,564,573,576,,,1,1,1,,,,,,
565,574,601,565,574,601,,,0,0,0,,,,,,
566,575,626,565,574,625,,,1,1,1,,,,,,
566,575,650,566,575,650,,,0,0,0,,,,,,
567,576,675,567,575,675,,,0,1,0,,,,,,
568,576,700,568,576,700,,,0,0,0,,,,,,
568,577,725,568,577,724,,,0,0,1,,,,,,
569,578,749,569,578,749,,,0,0,0,,,,,,
570,578,774,569,578,774,,,1,0,0,,,,,,
568,597,170,568,596,170,,,0,1,0,,,,,,
568,597,171,568,596,170,,,0,1,1,,,,,,
568,597,174,568,596,174,,,0,1,0,,,,,,
568,597,181,568,596,182,,,0,1,-1,,,,,,
568,597,190,568,596,189,,,0,1,1,,,,,,
569,597,201,568,596,202,,,1,1,-1,,,,,,
569,597,215,568,597,214,,,1,0,1,,,,,,
569,597,230,568,597,230,,,1,0,0,,,,,,
569,597,247,569,597,247,,,0,0,0,,,,,,
569,597,265,569,597,265,,,0,0,0,,,,,,
569,598,284,569,597,284,,,0,1,0,,,,,,
569,598,304,569,597,304,,,0,1,0,,,,,,
570,598,325,569,598,325,,,1,0,0,,,,,,
570,598,346,570,598,346,,,0,0,0,,,,,,
570,598,368,570,598,368,,,0,0,0,,,,,,
570,599,391,570,598,390,,,0,1,1,,,,,,
571,599,413,570,599,413,,,1,0,0,,,,,,
571,599,436,571,599,436,,,0,0,0,,,,,,
571,600,459,571,599,459,,,0,1,0,,,,,,
572,600,483,572,600,483,,,0,0,0,,,,,,
572,600,506,572,600,506,,,0,0,0,,,,,,
572,601,530,572,600,530,,,0,1,0,,,,,,
573,601,554,573,601,554,,,0,0,0,,,,,,
573,602,578,573,601,578,,,0,1,0,,,,,,
574,602,603,574,602,603,,,0,0,0,,,,,,
574,603,627,574,602,627,,,0,1,0,,,,,,
575,603,652,575,603,651,,,0,0,1,,,,,,
575,604,676,575,603,676,,,0,1,0,,,,,,
576,604,701,576,604,701,,,0,0,0,,,,,,
577,605,726,577,605,726,,,0,0,0,,,,,,
577,606,751,577,606,750,,,0,0,1,,,,,,
578,606,776,578,606,775,,,0,0,1,,,,,,
577,625,177,577,625,177,,,0,0,0,,,,,,
577,625,178,577,625,177,,,0,0,1,,,,,,
577,625,181,577,625,181,,,0,0,0,,,,,,
577,625,187,577,625,188,,,0,0,-1,,,,,,
577,625,196,577,625,196,,,0,0,0,,,,,,
577,625,207,577,625,208,,,0,0,-1,,,,,,
577,625,220,577,625,220,,,0,0,0,,,,,,
578,625,235,577,625,236,,,1,0,-1,,,,,,
578,626,252,578,626,252,,,0,0,0,,,,,,
578,626,269,578,626,270,,,0,0,-1,,,,,,
578,626,288,578,626,288,,,0,0,0,,,,,,
578,626,308,578,626,308,,,0,0,0,,,,,,
578,626,329,578,626,329,,,0,0,0,,,,,,
579,627,350,578,626,350,,,1,1,0,,,,,,
579,627,371,579,627,371,,,0,0,0,,,,,,
579,627,393,579,627,393,,,0,0,0,,,,,,
579,627,416,579,627,416,,,0,0,0,,,,,,
580,628,439,579,627,439,,,1,1,0,,,,,,
580,628,462,580,628,462,,,0,0,0,,,,,,
580,628,485,580,628,485,,,0,0,0,,,,,,
581,629,509,581,629,509,,,0,0,0,,,,,,
581,629,532,581,629,532,,,0,0,0,,,,,,
582,629,556,582,629,556,,,0,0,0,,,,,,
582,630,580,582,629,580,,,0,1,0,,,,,,
583,630,605,583,630,605,,,0,0,0,,,,,,
583,631,629,583,630,629,,,0,1,0,,,,,,
584,631,653,584,631,653,,,0,0,0,,,,,,
584,632,678,584,631,678,,,0,1,0,,,,,,
585,632,703,585,632,703,,,0,0,0,,,,,,
585,633,727,585,633,727,,,0,0,0,,,,,,
586,634,752,586,634,752,,,0,0,0,,,,,,
587,634,777,586,634,777,,,1,0,0,,,,,,
586,654,184,586,653,184,,,0,1,0,,,,,,
586,654,185,586,653,184,,,0,1,1,,,,,,
586,654,188,586,653,188,,,0,1,0,,,,,,
587,654,194,586,653,195,,,1,1,-1,,,,,,
587,654,202,586,653,202,,,1,1,0,,,,,,
587,654,213,586,653,214,,,1,1,-1,,,,,,
587,654,226,586,654,226,,,1,0,0,,,,,,
587,654,240,586,654,241,,,1,0,-1,,,,,,
587,654,257,587,654,257,,,0,0,0,,,,,,
587,654,274,587,654,274,,,0,0,0,,,,,,
587,654,293,587,654,292,,,0,0,1,,,,,,
587,655,312,587,654,312,,,0,1,0,,,,,,
588,655,332,587,654,332,,,1,1,0,,,,,,
588,655,353,588,655,353,,,0,0,0,,,,,,
588,655,374,588,655,374,,,0,0,0,,,,,,
588,655,396,588,655,396,,,0,0,0,,,,,,
589,656,419,588,655,419,,,1,1,0,,,,,,
589,656,441,589,656,441,,,0,0,0,,,,,,
589,656,464,589,656,464,,,0,0,0,,,,,,
590,657,487,589,657,487,,,1,0,0,,,,,,
590,657,511,590,657,511,,,0,0,0,,,,,,
590,657,534,590,657,534,,,0,0,0,,,,,,
591,658,558,591,657,558,,,0,1,0,,,,,,
591,658,582,591,658,582,,,0,0,0,,,,,,
592,659,606,592,658,606,,,0,1,0,,,,,,
592,659,631,592,659,630,,,0,0,1,,,,,,
593,660,655,593,659,655,,,0,1,0,,,,,,
593,660,680,593,660,679,,,0,0,1,,,,,,
594,661,704,594,660,704,,,0,1,0,,,,,,
594,661,729,594,661,729,,,0,0,0,,,,,,
595,662,754,595,662,753,,,0,0,1,,,,,,
596,662,778,595,662,778,,,1,0,0,,,,,,
596,682,192,596,682,192,,,0,0,0,,,,,,
596,682,192,596,682,192,,,0,0,0,,,,,,
596,682,195,596,682,195,,,0,0,0,,,,,,
596,682,201,596,682,202,,,0,0,-1,,,,,,
596,682,209,596,682,209,,,0,0,0,,,,,,
596,683,219,596,682,220,,,0,1,-1,,,,,,
596,683,232,596,683,232,,,0,0,0,,,,,,
596,683,246,596,683,247,,,0,0,-1,,,,,,
596,683,262,596,683,262,,,0,0,0,,,,,,
597,683,279,596,683,279,,,1,0,0,,,,,,
597,683,297,597,683,297,,,0,0,0,,,,,,
597,683,316,597,683,316,,,0,0,0,,,,,,
597,683,336,597,683,336,,,0,0,0,,,,,,
597,684,357,597,683,357,,,0,1,0,,,,,,
598,684,378,598,684,378,,,0,0,0,,,,,,
598,684,400,598,684,400,,,0,0,0,,,,,,
598,684,422,598,684,422,,,0,0,0,,,,,,
598,685,444,598,684,444,,,0,1,0,,,,,,
599,685,467,599,685,467,,,0,0,0,,,,,,
599,685,490,599,685,490,,,0,0,0,,,,,,
599,686,513,599,686,513,,,0,0,0,,,,,,
600,686,537,599,686,536,,,1,0,1,,,,,,
600,686,560,600,686,560,,,0,0,0,,,,,,
601,687,584,600,686,584,,,1,1,0,,,,,,
601,687,608,601,687,608,,,0,0,0,,,,,,
602,688,633,601,687,632,,,1,1,1,,,,,,
602,688,657,602,688,657,,,0,0,0,,,,,,
603,688,681,602,688,681,,,1,0,0,,,,,,
603,689,706,603,689,706,,,0,0,0,,,,,,
604,689,730,603,689,730,,,1,0,0,,,,,,
604,690,755,604,690,755,,,0,0,0,,,,,,
605,691,780,605,690,780,,,0,1,0,,,,,,
606,711,199,606,711,199,,,0,0,0,,,,,,
606,711,200,606,711,199,,,0,0,1,,,,,,
606,711,203,606,711,202,,,0,0,1,,,,,,
606,711,208,606,711,209,,,0,0,-1,,,,,,
606,711,216,606,711,215,,,0,0,1,,,,,,
606,711,226,606,711,226,,,0,0,0,,,,,,
606,711,238,606,711,238,,,0,0,0,,,,,,
606,711,251,606,711,252,,,0,0,-1,,,,,,
606,712,267,606,711,267,,,0,1,0,,,,,,
606,712,284,606,711,284,,,0,1,0,,,,,,
607,712,301,607,712,301,,,0,0,0,,,,,,
607,712,320,607,712,320,,,0,0,0,,,,,,
607,712,340,607,712,340,,,0,0,0,,,,,,
607,712,360,607,712,360,,,0,0,0,,,,,,
607,712,381,607,712,381,,,0,0,0,,,,,,
608,713,403,607,712,403,,,1,1,0,,,,,,
608,713,425,608,713,425,,,0,0,0,,,,,,
608,713,447,608,713,447,,,0,0,0,,,,,,
609,713,470,609,713,469,,,0,0,1,,,,,,
609,714,492,609,714,492,,,0,0,0,,,,,,
609,714,516,609,714,515,,,0,0,1,,,,,,
610,714,539,609,714,539,,,1,0,0,,,,,,
610,715,563,610,714,562,,,0,1,1,,,,,,
610,715,586,610,715,586,,,0,0,0,,,,,,
611,716,610,611,715,610,,,0,1,0,,,,,,
611,716,634,611,716,634,,,0,0,0,,,,,,
612,716,659,612,716,659,,,0,0,0,,,,,,
612,717,683,612,717,683,,,0,0,0,,,,,,
613,717,708,613,717,707,,,0,0,1,,,,,,
614,718,732,613,718,732,,,1,0,0,,,,,,
614,718,757,614,718,756,,,0,0,1,,,,,,
615,719,782,614,719,781,,,1,0,1,,,,,,
616,740,206,616,740,206,,,0,0,0,,,,,,
616,740,207,616,740,206,,,0,0,1,,,,,,
616,740,210,616,740,210,,,0,0,0,,,,,,
616,740,215,616,740,216,,,0,0,-1,,,,,,
616,740,222,616,740,222,,,0,0,0,,,,,,
616,740,232,616,740,233,,,0,0,-1,,,,,,
616,740,244,616,740,244,,,0,0,0,,,,,,
616,740,257,616,740,258,,,0,0,-1,,,,,,
616,740,272,616,740,272,,,0,0,0,,,,,,
617,740,289,616,740,289,,,1,0,0,,,,,,
617,741,306,617,741,306,,,0,0,0,,,,,,
617,741,325,617,741,325,,,0,0,0,,,,,,
617,741,344,617,741,344,,,0,0,0,,,,,,
617,741,364,617,741,364,,,0,0,0,,,,,,
617,741,385,617,741,385,,,0,0,0,,,,,,
618,741,406,617,741,406,,,1,0,0,,,,,,
618,742,428,618,742,428,,,0,0,0,,,,,,
618,742,450,618,742,450,,,0,0,0,,,,,,
619,742,472,619,742,472,,,0,0,0,,,,,,
619,743,495,619,742,495,,,0,1,0,,,,,,
619,743,518,619,743,518,,,0,0,0,,,,,,
620,743,542,619,743,541,,,1,0,1,,,,,,
620,743,565,620,743,565,,,0,0,0,,,,,,
621,744,589,620,743,589,,,1,1,0,,,,,,
621,744,613,621,744,613,,,0,0,0,,,,,,
621,745,637,621,744,637,,,0,1,0,,,,,,
622,745,661,622,745,661,,,0,0,0,,,,,,
622,746,685,622,745,685,,,0,1,0,,,,,,
623,746,709,623,746,709,,,0,0,0,,,,,,
624,746,734,623,746,733,,,1,0,1,,,,,,
624,747,758,624,747,758,,,0,0,0,,,,,,
625,747,783,624,747,783,,,1,0,0,,,,,,
626,769,214,626,769,213,,,0,0,1,,,,,,
626,769,214,626,769,213,,,0,0,1,,,,,,
626,769,217,626,769,217,,,0,0,0,,,,,,
626,769,222,626,769,223,,,0,0,-1,,,,,,
626,769,229,626,769,229,,,0,0,0,,,,,,
627,769,238,626,769,239,,,1,0,-1,,,,,,
627,769,250,626,769,250,,,1,0,0,,,,,,
627,769,263,626,769,263,,,1,0,0,,,,,,
627,769,278,626,769,277,,,1,0,1,,,,,,
627,769,294,627,769,294,,,0,0,0,,,,,,
627,769,311,627,769,311,,,0,0,0,,,,,,
627,770,329,627,769,329,,,0,1,0,,,,,,
627,770,348,627,770,348,,,0,0,0,,,,,,
628,770,368,627,770,368,,,1,0,0,,,,,,
628,770,389,628,770,389,,,0,0,0,,,,,,
628,770,410,628,770,410,,,0,0,0,,,,,,
628,771,431,628,770,431,,,0,1,0,,,,,,
629,771,453,629,770,453,,,0,1,0,,,,,,
629,771,475,629,771,475,,,0,0,0,,,,,,
629,771,498,629,771,498,,,0,0,0,,,,,,
630,772,521,629,771,521,,,1,1,0,,,,,,
630,772,544,630,771,544,,,0,1,0,,,,,,
630,772,567,630,772,567,,,0,0,0,,,,,,
631,773,591,631,772,591,,,0,1,0,,,,,,
631,773,615,631,773,615,,,0,0,0,,,,,,
632,773,639,632,773,639,,,0,0,0,,,,,,
632,774,663,632,774,663,,,0,0,0,,,,,,
633,774,687,633,774,687,,,0,0,0,,,,,,
633,775,711,633,774,711,,,0,1,0,,,,,,
634,775,736,634,775,735,,,0,0,1,,,,,,
634,776,760,634,775,760,,,0,1,0,,,,,,
635,776,785,635,776,784,,,0,0,1,,,,,,
637,798,221,637,798,221,,,0,0,0,,,,,,
637,798,222,637,798,221,,,0,0,1,,,,,,
637,798,224,637,798,224,,,0,0,0,,,,,,
637,798,229,637,798,230,,,0,0,-1,,,,,,
637,798,236,637,798,236,,,0,0,0,,,,,,
637,798,245,637,798,246,,,0,0,-1,,,,,,
637,798,256,637,798,256,,,0,0,0,,,,,,
637,798,269,637,798,269,,,0,0,0,,,,,,
637,798,283,637,798,283,,,0,0,0,,,,,,
638,798,299,637,798,299,,,1,0,0,,,,,,
638,798,316,638,798,316,,,0,0,0,,,,,,
638,799,334,638,798,334,,,0,1,0,,,,,,
638,799,353,638,799,353,,,0,0,0,,,,,,
638,799,372,638,799,373,,,0,0,-1,,,,,,
639,799,393,639,799,393,,,0,0,0,,,,,,
639,799,413,639,799,414,,,0,0,-1,,,,,,
639,799,435,639,799,435,,,0,0,0,,,,,,
639,800,456,639,799,457,,,0,1,-1,,,,,,
640,800,479,640,800,479,,,0,0,0,,,,,,
640,800,501,640,800,501,,,0,0,0,,,,,,
640,800,524,640,800,524,,,0,0,0,,,,,,
641,801,547,640,800,547,,,1,1,0,,,,,,
641,801,570,641,801,570,,,0,0,0,,,,,,
641,801,593,641,801,593,,,0,0,0,,,,,,
642,802,617,642,802,617,,,0,0,0,,,,,,
642,802,641,642,802,641,,,0,0,0,,,,,,
643,803,665,643,803,665,,,0,0,0,,,,,,
643,803,689,643,803,689,,,0,0,0,,,,,,
644,803,713,644,803,713,,,0,0,0,,,,,,
644,804,738,644,803,737,,,0,1,1,,,,,,
645,804,762,645,804,762,,,0,0,0,,,,,,
645,805,787,645,804,786,,,0,1,1,,,,,,
648,827,228,648,827,228,,,0,0,0,,,,,,
648,827,229,648,827,228,,,0,0,1,,,,,,
648,827,232,648,827,231,,,0,0,1,,,,,,
648,827,236,648,827,237,,,0,0,-1,,,,,,
648,827,243,648,827,243,,,0,0,0,,,,,,
648,827,252,648,827,252,,,0,0,0,,,,,,
648,827,262,648,827,262,,,0,0,0,,,,,,
648,827,275,648,827,275,,,0,0,0,,,,,,
648,827,289,648,827,289,,,0,0,0,,,,,,
649,827,304,648,827,305,,,1,0,-1,,,,,,
649,827,321,649,827,321,,,0,0,0,,,,,,
649,828,339,649,827,339,,,0,1,0,,,,,,
649,828,357,649,828,357,,,0,0,0,,,,,,
649,828,376,649,828,377,,,0,0,-1,,,,,,
649,828,396,650,828,397,,,-1,0,-1,,,,,,
650,828,417,650,828,417,,,0,0,0,,,,,,
650,828,438,650,828,438,,,0,0,0,,,,,,
650,829,460,650,828,460,,,0,1,0,,,,,,
651,829,482,651,829,482,,,0,0,0,,,,,,
651,829,504,651,829,504,,,0,0,0,,,,,,
651,829,527,651,829,527,,,0,0,0,,,,,,
652,830,550,651,829,549,,,1,1,1,,,,,,
652,830,573,652,830,572,,,0,0,1,,,,,,
652,830,596,652,830,596,,,0,0,0,,,,,,
653,831,619,653,831,619,,,0,0,0,,,,,,
653,831,643,653,831,643,,,0,0,0,,,,,,
654,831,667,654,831,667,,,0,0,0,,,,,,
654,832,691,654,831,691,,,0,1,0,,,,,,
655,832,715,655,832,715,,,0,0,0,,,,,,
655,833,740,655,832,739,,,0,1,1,,,,,,
656,833,764,656,833,764,,,0,0,0,,,,,,
656,834,788,656,833,788,,,0,1,0,,,,,,
659,856,236,659,856,236,,,0,0,0,,,,,,
659,856,237,659,856,236,,,0,0,1,,,,,,
659,856,239,659,856,239,,,0,0,0,,,,,,
659,856,243,659,856,244,,,0,0,-1,,,,,,
659,856,250,659,856,250,,,0,0,0,,,,,,
659,856,258,659,856,259,,,0,0,-1,,,,,,
659,856,269,659,856,269,,,0,0,0,,,,,,
660,856,281,659,856,282,,,1,0,-1,,,,,,
660,856,295,660,856,295,,,0,0,0,,,,,,
660,856,310,660,856,310,,,0,0,0,,,,,,
660,857,326,660,857,326,,,0,0,0,,,,,,
660,857,343,660,857,344,,,0,0,-1,,,,,,
660,857,362,660,857,362,,,0,0,0,,,,,,
660,857,381,660,857,381,,,0,0,0,,,,,,
661,857,401,661,857,401,,,0,0,0,,,,,,
661,857,421,661,857,421,,,0,0,0,,,,,,
661,857,442,661,857,442,,,0,0,0,,,,,,
661,858,463,661,857,463,,,0,1,0,,,,,,
662,858,485,662,858,485,,,0,0,0,,,,,,
662,858,507,662,858,507,,,0,0,0,,,,,,
662,858,530,662,858,530,,,0,0,0,,,,,,
663,859,552,662,858,552,,,1,1,0,,,,,,
663,859,575,663,859,575,,,0,0,0,,,,,,
663,859,599,663,859,598,,,0,0,1,,,,,,
664,860,622,664,860,622,,,0,0,0,,,,,,
664,860,646,664,860,645,,,0,0,1,,,,,,
665,860,669,665,860,669,,,0,0,0,,,,,,
665,861,693,665,860,693,,,0,1,0,,,,,,
666,861,717,666,861,717,,,0,0,0,,,,,,
666,862,742,666,861,741,,,0,1,1,,,,,,
667,862,766,667,862,766,,,0,0,0,,,,,,
667,862,790,667,862,790,,,0,0,0,,,,,,
671,885,244,670,885,243,,,1,0,1,,,,,,
671,885,244,670,885,243,,,1,0,1,,,,,,
671,885,246,670,885,246,,,1,0,0,,,,,,
671,885,251,670,885,251,,,1,0,0,,,,,,
671,885,257,670,885,257,,,1,0,0,,,,,,
671,885,265,670,885,266,,,1,0,-1,,,,,,
671,885,275,671,885,275,,,0,0,0,,,,,,
671,885,287,671,885,288,,,0,0,-1,,,,,,
671,885,301,671,885,301,,,0,0,0,,,,,,
671,886,315,671,885,316,,,0,1,-1,,,,,,
671,886,331,671,886,331,,,0,0,0,,,,,,
671,886,348,671,886,349,,,0,0,-1,,,,,,
672,886,366,671,886,366,,,1,0,0,,,,,,
672,886,385,672,886,385,,,0,0,0,,,,,,
672,886,405,672,886,405,,,0,0,0,,,,,,
672,886,425,672,886,425,,,0,0,0,,,,,,
673,887,446,672,886,446,,,1,1,0,,,,,,
673,887,467,673,886,467,,,0,1,0,,,,,,
673,887,488,673,887,488,,,0,0,0,,,,,,
673,887,510,673,887,510,,,0,0,0,,,,,,
674,888,533,673,887,533,,,1,1,0,,,,,,
674,888,555,674,887,555,,,0,1,0,,,,,,
674,888,578,674,888,578,,,0,0,0,,,,,,
675,888,601,675,888,601,,,0,0,0,,,,,,
675,889,625,675,889,624,,,0,0,1,,,,,,
676,889,648,676,889,648,,,0,0,0,,,,,,
676,889,672,676,889,671,,,0,0,1,,,,,,
677,890,696,677,889,695,,,0,1,1,,,,,,
677,890,720,677,890,719,,,0,0,1,,,,,,
678,891,744,678,890,743,,,0,1,1,,,,,,
678,891,768,678,891,768,,,0,0,0,,,,,,
679,891,792,679,891,792,,,0,0,0,,,,,,
505,140,76,505,139,76,,,0,1,0,,,,,,
505,140,79,505,139,76,,,0,1,3,,,,,,
505,140,87,505,139,86,,,0,1,1,,,,,,
505,140,99,505,140,101,,,0,0,-2,,,,,,
505,140,116,505,140,115,,,0,0,1,,,,,,
505,141,134,505,140,135,,,0,1,-1,,,,,,
505,141,155,505,141,155,,,0,0,0,,,,,,
505,141,176,505,141,176,,,0,0,0,,,,,,
506,142,198,505,142,198,,,1,0,0,,,,,,
506,143,221,505,143,221,,,1,0,0,,,,,,
506,144,244,506,143,244,,,0,1,0,,,,,,
506,145,268,506,144,267,,,0,1,1,,,,,,
506,146,291,506,145,291,,,0,1,0,,,,,,
507,147,315,506,146,315,,,1,1,0,,,,,,
507,148,339,507,148,339,,,0,0,0,,,,,,
507,149,363,507,149,363,,,0,0,0,,,,,,
508,151,388,507,151,388,,,1,0,0,,,,,,
508,152,412,508,152,412,,,0,0,0,,,,,,
508,154,437,508,154,437,,,0,0,0,,,,,,
509,155,462,509,155,461,,,0,0,1,,,,,,
509,157,487,509,157,486,,,0,0,1,,,,,,
510,159,511,510,158,511,,,0,1,0,,,,,,
510,161,536,510,160,536,,,0,1,0,,,,,,
511,163,561,511,162,561,,,0,1,0,,,,,,
511,165,586,511,164,586,,,0,1,0,,,,,,
512,167,612,512,166,611,,,0,1,1,,,,,,
512,169,637,512,169,636,,,0,0,1,,,,,,
513,171,662,513,171,662,,,0,0,0,,,,,,
514,174,687,514,174,687,,,0,0,0,,,,,,
514,176,713,514,176,712,,,0,0,1,,,,,,
515,179,738,515,179,738,,,0,0,0,,,,,,
516,181,764,516,181,763,,,0,0,1,,,,,,
505,141,77,505,139,76,,,0,2,1,,,,,,
505,141,79,505,139,76,,,0,2,3,,,,,,
505,141,87,505,139,86,,,0,2,1,,,,,,
505,142,100,505,140,101,,,0,2,-1,,,,,,
505,142,116,505,140,115,,,0,2,1,,,,,,
505,142,135,505,140,135,,,0,2,0,,,,,,
505,143,155,505,141,155,,,0,2,0,,,,,,
506,143,176,505,141,176,,,1,2,0,,,,,,
506,144,198,505,142,198,,,1,2,0,,,,,,
506,144,221,505,143,221,,,1,1,0,,,,,,
506,145,244,506,143,244,,,0,2,0,,,,,,
506,146,268,506,144,267,,,0,2,1,,,,,,
507,147,291,506,145,291,,,1,2,0,,,,,,
507,148,315,506,146,315,,,1,2,0,,,,,,
507,149,339,507,148,339,,,0,1,0,,,,,,
507,151,364,507,149,363,,,0,2,1,,,,,,
508,152,388,507,151,388,,,1,1,0,,,,,,
508,153,412,508,152,412,,,0,1,0,,,,,,
508,155,437,508,154,437,,,0,1,0,,,,,,
509,157,462,509,155,461,,,0,2,1,,,,,,
509,158,487,509,157,486,,,0,1,1,,,,,,
510,160,511,510,158,511,,,0,2,0,,,,,,
510,162,536,510,160,536,,,0,2,0,,,,,,
511,164,561,511,162,561,,,0,2,0,,,,,,
511,166,587,511,164,586,,,0,2,1,,,,,,
512,168,612,512,166,611,,,0,2,1,,,,,,
513,170,637,512,169,636,,,1,1,1,,,,,,
513,173,662,513,171,662,,,0,2,0,,,,,,
514,175,687,514,174,687,,,0,1,0,,,,,,
515,177,713,514,176,712,,,1,1,1,,,,,,
515,180,738,515,179,738,,,0,1,0,,,,,,
516,182,764,516,181,763,,,0,1,1,,,,,,
506,147,77,505,147,77,,,1,0,0,,,,,,
506,147,80,505,147,77,,,1,0,3,,,,,,
506,147,87,505,147,87,,,1,0,0,,,,,,
506,147,100,505,147,102,,,1,0,-2,,,,,,
506,147,116,505,147,116,,,1,0,0,,,,,,
506,148,135,505,147,135,,,1,1,0,,,,,,
506,148,155,506,148,155,,,0,0,0,,,,,,
506,149,177,506,148,176,,,0,1,1,,,,,,
506,149,199,506,149,198,,,0,0,1,,,,,,
506,150,221,506,150,221,,,0,0,0,,,,,,
507,151,244,506,151,244,,,1,0,0,,,,,,
507,152,268,506,152,268,,,1,0,0,,,,,,
507,153,291,507,153,291,,,0,0,0,,,,,,
507,154,315,507,154,315,,,0,0,0,,,,,,
508,155,339,507,155,339,,,1,0,0,,,,,,
508,156,364,508,156,363,,,0,0,1,,,,,,
508,157,388,508,157,388,,,0,0,0,,,,,,
509,159,413,508,159,412,,,1,0,1,,,,,,
509,160,437,508,160,437,,,1,0,0,,,,,,
509,162,462,509,162,462,,,0,0,0,,,,,,
510,163,487,509,163,486,,,1,0,1,,,,,,
510,165,512,510,165,511,,,0,0,1,,,,,,
511,167,536,510,167,536,,,1,0,0,,,,,,
511,169,561,511,169,561,,,0,0,0,,,,,,
512,171,587,512,171,586,,,0,0,1,,,,,,
512,173,612,512,173,611,,,0,0,1,,,,,,
513,175,637,513,175,637,,,0,0,0,,,,,,
514,177,662,513,177,662,,,1,0,0,,,,,,
514,180,687,514,179,687,,,0,1,0,,,,,,
515,182,713,515,182,713,,,0,0,0,,,,,,
516,184,738,516,184,738,,,0,0,0,,,,,,
516,187,764,516,187,763,,,0,0,1,,,,,,
506,157,79,506,159,79,,,0,-2,0,,,,,,
506,157,81,506,159,79,,,0,-2,2,,,,,,
506,157,89,506,159,89,,,0,-2,0,,,,,,
506,157,101,506,159,103,,,0,-2,-2,,,,,,
506,157,117,506,159,117,,,0,-2,0,,,,,,
507,158,136,506,159,136,,,1,-1,0,,,,,,
507,158,156,506,160,156,,,1,-2,0,,,,,,
507,159,177,507,160,177,,,0,-1,0,,,,,,
507,159,199,507,161,199,,,0,-2,0,,,,,,
507,160,222,507,161,221,,,0,-1,1,,,,,,
507,160,245,507,162,244,,,0,-2,1,,,,,,
507,161,268,507,163,268,,,0,-2,0,,,,,,
508,162,292,507,164,291,,,1,-2,1,,,,,,
508,163,316,508,165,315,,,0,-2,1,,,,,,
508,164,340,508,166,339,,,0,-2,1,,,,,,
509,165,364,508,167,364,,,1,-2,0,,,,,,
509,167,388,509,168,388,,,0,-1,0,,,,,,
509,168,413,509,170,412,,,0,-2,1,,,,,,
510,169,437,509,171,437,,,1,-2,0,,,,,,
510,171,462,510,172,462,,,0,-1,0,,,,,,
511,172,487,510,174,487,,,1,-2,0,,,,,,
511,174,512,511,176,511,,,0,-2,1,,,,,,
511,176,537,511,177,536,,,0,-1,1,,,,,,
512,178,562,512,179,561,,,0,-1,1,,,,,,
513,179,587,513,181,586,,,0,-2,1,,,,,,
513,181,612,513,183,611,,,0,-2,1,,,,,,
514,183,637,514,185,637,,,0,-2,0,,,,,,
514,186,662,514,187,662,,,0,-1,0,,,,,,
515,188,688,515,189,687,,,0,-1,1,,,,,,
516,190,713,516,191,713,,,0,-1,0,,,,,,
516,192,738,517,194,738,,,-1,-2,0,,,,,,
517,195,764,517,196,763,,,0,-1,1,,,,,,
508,171,81,507,171,81,,,1,0,0,,,,,,
508,171,83,507,171,81,,,1,0,2,,,,,,
508,171,90,507,171,90,,,1,0,0,,,,,,
508,171,102,507,171,104,,,1,0,-2,,,,,,
508,171,118,507,171,118,,,1,0,0,,,,,,
508,172,137,507,171,137,,,1,1,0,,,,,,
508,172,157,507,172,157,,,1,0,0,,,,,,
508,172,178,508,172,178,,,0,0,0,,,,,,
508,173,200,508,173,199,,,0,0,1,,,,,,
508,173,222,508,173,222,,,0,0,0,,,,,,
508,174,245,508,174,245,,,0,0,0,,,,,,
509,175,269,508,175,268,,,1,0,1,,,,,,
509,176,292,508,176,292,,,1,0,0,,,,,,
509,176,316,509,176,316,,,0,0,0,,,,,,
509,177,340,509,177,340,,,0,0,0,,,,,,
510,178,364,509,178,364,,,1,0,0,,,,,,
510,180,389,510,179,388,,,0,1,1,,,,,,
510,181,413,510,181,413,,,0,0,0,,,,,,
511,182,438,510,182,437,,,1,0,1,,,,,,
511,184,462,511,183,462,,,0,1,0,,,,,,
512,185,487,511,185,487,,,1,0,0,,,,,,
512,186,512,512,186,512,,,0,0,0,,,,,,
513,188,537,512,188,536,,,1,0,1,,,,,,
513,190,562,513,190,561,,,0,0,1,,,,,,
514,192,587,514,191,586,,,0,1,1,,,,,,
514,193,612,514,193,612,,,0,0,0,,,,,,
515,195,637,515,195,637,,,0,0,0,,,,,,
516,197,662,515,197,662,,,1,0,0,,,,,,
516,199,688,516,199,687,,,0,0,1,,,,,,
517,201,713,517,201,713,,,0,0,0,,,,,,
518,203,738,518,203,738,,,0,0,0,,,,,,
518,206,764,518,205,764,,,0,1,0,,,,,,
509,188,83,509,189,83,,,0,-1,0,,,,,,
509,188,85,509,189,83,,,0,-1,2,,,,,,
509,188,92,509,189,92,,,0,-1,0,,,,,,
509,188,104,509,189,106,,,0,-1,-2,,,,,,
509,188,120,509,189,120,,,0,-1,0,,,,,,
509,188,138,509,189,139,,,0,-1,-1,,,,,,
509,189,158,509,190,158,,,0,-1,0,,,,,,
509,189,179,509,190,179,,,0,-1,0,,,,,,
510,190,201,510,191,200,,,0,-1,1,,,,,,
510,190,223,510,191,223,,,0,-1,0,,,,,,
510,191,246,510,192,246,,,0,-1,0,,,,,,
510,191,269,510,192,269,,,0,-1,0,,,,,,
510,192,293,510,193,292,,,0,-1,1,,,,,,
511,193,317,510,194,316,,,1,-1,1,,,,,,
511,194,341,511,195,340,,,0,-1,1,,,,,,
511,195,365,511,196,364,,,0,-1,1,,,,,,
512,196,389,511,197,389,,,1,-1,0,,,,,,
512,197,413,512,198,413,,,0,-1,0,,,,,,
512,198,438,512,199,438,,,0,-1,0,,,,,,
513,199,463,512,200,462,,,1,-1,1,,,,,,
513,201,487,513,202,487,,,0,-1,0,,,,,,
514,202,512,513,203,512,,,1,-1,0,,,,,,
514,203,537,514,205,537,,,0,-2,0,,,,,,
515,205,562,514,206,562,,,1,-1,0,,,,,,
515,207,587,515,208,587,,,0,-1,0,,,,,,
516,208,612,516,209,612,,,0,-1,0,,,,,,
516,210,637,516,211,637,,,0,-1,0,,,,,,
517,212,663,517,213,662,,,0,-1,1,,,,,,
518,214,688,518,214,688,,,0,0,0,,,,,,
518,216,713,518,216,713,,,0,0,0,,,,,,
519,218,739,519,219,738,,,0,-1,1,,,,,,
520,220,764,520,221,764,,,0,-1,0,,,,,,
511,207,86,511,207,86,,,0,0,0,,,,,,
511,207,88,511,207,86,,,0,0,2,,,,,,
511,207,95,511,207,95,,,0,0,0,,,,,,
511,207,107,511,207,108,,,0,0,-1,,,,,,
511,208,122,511,208,122,,,0,0,0,,,,,,
511,208,140,511,208,141,,,0,0,-1,,,,,,
511,208,159,511,208,159,,,0,0,0,,,,,,
511,208,180,511,208,180,,,0,0,0,,,,,,
512,209,202,511,209,201,,,1,0,1,,,,,,
512,209,224,511,209,224,,,1,0,0,,,,,,
512,210,247,512,210,247,,,0,0,0,,,,,,
512,210,270,512,210,270,,,0,0,0,,,,,,
512,211,294,512,211,293,,,0,0,1,,,,,,
513,212,317,512,211,317,,,1,1,0,,,,,,
513,213,341,513,212,341,,,0,1,0,,,,,,
513,213,365,513,213,365,,,0,0,0,,,,,,
514,214,390,513,214,389,,,1,0,1,,,,,,
514,215,414,513,215,414,,,1,0,0,,,,,,
514,216,439,514,216,438,,,0,0,1,,,,,,
515,218,463,514,217,463,,,1,1,0,,,,,,
515,219,488,515,219,487,,,0,0,1,,,,,,
516,220,513,515,220,512,,,1,0,1,,,,,,
516,221,538,516,221,537,,,0,0,1,,,,,,
517,223,563,516,223,562,,,1,0,1,,,,,,
517,224,588,517,224,587,,,0,0,1,,,,,,
518,226,613,517,226,612,,,1,0,1,,,,,,
518,227,638,518,227,637,,,0,0,1,,,,,,
519,229,663,519,229,663,,,0,0,0,,,,,,
520,231,688,520,230,688,,,0,1,0,,,,,,
520,232,714,520,232,713,,,0,0,1,,,,,,
521,234,739,521,234,739,,,0,0,0,,,,,,
522,236,764,521,236,764,,,1,0,0,,,,,,
513,228,90,513,229,89,,,0,-1,1,,,,,,
513,229,92,513,229,89,,,0,0,3,,,,,,
513,229,98,513,229,98,,,0,0,0,,,,,,
513,229,110,513,229,111,,,0,0,-1,,,,,,
514,229,125,513,230,125,,,1,-1,0,,,,,,
514,229,142,514,230,143,,,0,-1,-1,,,,,,
514,229,161,514,230,161,,,0,-1,0,,,,,,
514,230,182,514,230,182,,,0,0,0,,,,,,
514,230,203,514,231,203,,,0,-1,0,,,,,,
514,230,225,514,231,225,,,0,-1,0,,,,,,
514,231,248,514,231,248,,,0,0,0,,,,,,
514,231,271,514,232,271,,,0,-1,0,,,,,,
515,232,294,515,232,294,,,0,0,0,,,,,,
515,233,318,515,233,318,,,0,0,0,,,,,,
515,233,342,515,234,342,,,0,-1,0,,,,,,
516,234,366,515,235,366,,,1,-1,0,,,,,,
516,235,390,516,235,390,,,0,0,0,,,,,,
516,236,415,516,236,414,,,0,0,1,,,,,,
517,237,439,516,237,439,,,1,0,0,,,,,,
517,238,464,517,238,463,,,0,0,1,,,,,,
517,239,488,517,240,488,,,0,-1,0,,,,,,
518,240,513,518,241,513,,,0,-1,0,,,,,,
518,241,538,518,242,538,,,0,-1,0,,,,,,
519,243,563,519,243,563,,,0,0,0,,,,,,
519,244,588,519,244,588,,,0,0,0,,,,,,
520,245,613,520,246,613,,,0,-1,0,,,,,,
521,247,638,520,247,638,,,1,0,0,,,,,,
521,248,663,521,249,663,,,0,-1,0,,,,,,
522,250,689,522,250,688,,,0,0,1,,,,,,
523,251,714,523,252,714,,,0,-1,0,,,,,,
523,253,739,523,254,739,,,0,-1,0,,,,,,
524,255,765,524,255,764,,,0,0,1,,,,,,
516,251,94,516,251,93,,,0,0,1,,,,,,
516,251,96,516,251,93,,,0,0,3,,,,,,
516,251,102,516,251,102,,,0,0,0,,,,,,
516,251,113,516,251,114,,,0,0,-1,,,,,,
516,251,127,516,252,127,,,0,-1,0,,,,,,
516,252,144,516,252,145,,,0,0,-1,,,,,,
516,252,163,517,252,163,,,-1,0,0,,,,,,
517,252,184,517,252,184,,,0,0,0,,,,,,
517,252,205,517,253,205,,,0,-1,0,,,,,,
517,253,227,517,253,227,,,0,0,0,,,,,,
517,253,249,517,253,249,,,0,0,0,,,,,,
517,254,272,517,253,272,,,0,1,0,,,,,,
518,254,296,518,254,296,,,0,0,0,,,,,,
518,255,319,518,255,319,,,0,0,0,,,,,,
518,256,343,518,256,343,,,0,0,0,,,,,,
518,256,367,518,256,367,,,0,0,0,,,,,,
519,257,391,519,257,391,,,0,0,0,,,,,,
519,258,415,519,258,415,,,0,0,0,,,,,,
519,259,440,519,259,439,,,0,0,1,,,,,,
520,260,464,520,260,464,,,0,0,0,,,,,,
520,261,489,520,261,489,,,0,0,0,,,,,,
521,262,514,521,262,514,,,0,0,0,,,,,,
521,263,539,521,263,538,,,0,0,1,,,,,,
522,264,564,522,264,563,,,0,0,1,,,,,,
522,265,588,522,265,588,,,0,0,0,,,,,,
523,266,614,523,266,613,,,0,0,1,,,,,,
523,268,639,523,268,638,,,0,0,1,,,,,,
524,269,664,524,269,663,,,0,0,1,,,,,,
525,271,689,524,270,689,,,1,1,0,,,,,,
525,272,714,525,272,714,,,0,0,0,,,,,,
526,274,740,526,273,739,,,0,1,1,,,,,,
527,275,765,527,275,765,,,0,0,0,,,,,,
519,275,98,519,275,98,,,0,0,0,,,,,,
519,275,100,519,275,98,,,0,0,2,,,,,,
519,275,106,519,275,106,,,0,0,0,,,,,,
520,275,117,519,275,118,,,1,0,-1,,,,,,
520,275,131,519,276,131,,,1,-1,0,,,,,,
520,275,147,520,276,148,,,0,-1,-1,,,,,,
520,276,166,520,276,166,,,0,0,0,,,,,,
520,276,186,520,276,186,,,0,0,0,,,,,,
520,276,207,520,277,207,,,0,-1,0,,,,,,
520,277,229,520,277,229,,,0,0,0,,,,,,
520,277,251,520,277,251,,,0,0,0,,,,,,
521,277,274,521,277,274,,,0,0,0,,,,,,
521,278,297,521,278,297,,,0,0,0,,,,,,
521,278,320,521,279,320,,,0,-1,0,,,,,,
521,279,344,521,279,344,,,0,0,0,,,,,,
522,280,368,522,280,368,,,0,0,0,,,,,,
522,280,392,522,280,392,,,0,0,0,,,,,,
522,281,416,522,281,416,,,0,0,0,,,,,,
523,282,441,523,282,440,,,0,0,1,,,,,,
523,283,465,523,283,465,,,0,0,0,,,,,,
523,284,490,524,284,490,,,-1,0,0,,,,,,
524,285,514,524,285,514,,,0,0,0,,,,,,
524,286,539,525,286,539,,,-1,0,0,,,,,,
525,287,564,525,287,564,,,0,0,0,,,,,,
525,288,589,526,288,589,,,-1,0,0,,,,,,
526,289,614,526,289,614,,,0,0,0,,,,,,
527,290,639,527,290,639,,,0,0,0,,,,,,
527,291,664,527,292,664,,,0,-1,0,,,,,,
528,293,690,528,293,689,,,0,0,1,,,,,,
529,294,715,528,294,714,,,1,0,1,,,,,,
529,295,740,529,296,740,,,0,-1,0,,,,,,
530,297,765,530,297,765,,,0,0,0,,,,,,
523,300,103,523,300,103,,,0,0,0,,,,,,
523,300,105,523,300,103,,,0,0,2,,,,,,
523,300,111,523,300,110,,,0,0,1,,,,,,
523,300,121,523,300,122,,,0,0,-1,,,,,,
523,300,134,523,300,134,,,0,0,0,,,,,,
523,300,150,523,300,151,,,0,0,-1,,,,,,
523,300,169,523,300,168,,,0,0,1,,,,,,
524,300,188,523,300,188,,,1,0,0,,,,,,
524,301,209,523,301,209,,,1,0,0,,,,,,
524,301,231,524,301,231,,,0,0,0,,,,,,
524,301,253,524,301,253,,,0,0,0,,,,,,
524,302,275,524,302,275,,,0,0,0,,,,,,
524,302,298,524,302,298,,,0,0,0,,,,,,
525,303,322,525,303,321,,,0,0,1,,,,,,
525,303,345,525,303,345,,,0,0,0,,,,,,
525,304,369,525,304,369,,,0,0,0,,,,,,
526,305,393,525,304,393,,,1,1,0,,,,,,
526,305,417,526,305,417,,,0,0,0,,,,,,
526,306,442,526,306,441,,,0,0,1,,,,,,
527,307,466,527,306,466,,,0,1,0,,,,,,
527,308,491,527,307,490,,,0,1,1,,,,,,
528,308,515,528,308,515,,,0,0,0,,,,,,
528,309,540,528,309,540,,,0,0,0,,,,,,
529,310,565,529,310,564,,,0,0,1,,,,,,
529,311,590,529,311,589,,,0,0,1,,,,,,
530,312,615,530,312,614,,,0,0,1,,,,,,
530,313,640,530,313,639,,,0,0,1,,,,,,
531,315,665,531,314,665,,,0,1,0,,,,,,
532,316,690,531,316,690,,,1,0,0,,,,,,
532,317,715,532,317,715,,,0,0,0,,,,,,
533,318,741,533,318,740,,,0,0,1,,,,,,
534,320,766,533,319,766,,,1,1,0,,,,,,
527,325,108,527,325,108,,,0,0,0,,,,,,
527,325,110,527,325,108,,,0,0,2,,,,,,
527,325,115,527,325,115,,,0,0,0,,,,,,
527,325,125,527,325,127,,,0,0,-2,,,,,,
527,325,138,527,325,138,,,0,0,0,,,,,,
527,325,154,527,325,155,,,0,0,-1,,,,,,
528,326,172,527,326,171,,,1,0,1,,,,,,
528,326,191,527,326,191,,,1,0,0,,,,,,
528,326,211,528,326,211,,,0,0,0,,,,,,
528,326,233,528,326,233,,,0,0,0,,,,,,
528,327,255,528,327,255,,,0,0,0,,,,,,
528,327,277,528,327,277,,,0,0,0,,,,,,
529,327,300,528,328,300,,,1,-1,0,,,,,,
529,328,323,529,328,323,,,0,0,0,,,,,,
529,328,347,529,328,346,,,0,0,1,,,,,,
529,329,370,529,329,370,,,0,0,0,,,,,,
530,329,394,529,329,394,,,1,0,0,,,,,,
530,330,418,530,330,418,,,0,0,0,,,,,,
530,331,443,530,331,442,,,0,0,1,,,,,,
531,331,467,531,331,467,,,0,0,0,,,,,,
531,332,492,531,332,491,,,0,0,1,,,,,,
532,333,516,532,333,516,,,0,0,0,,,,,,
532,334,541,532,334,540,,,0,0,1,,,,,,
533,335,566,533,335,565,,,0,0,1,,,,,,
533,336,591,533,335,590,,,0,1,1,,,,,,
534,337,615,534,336,615,,,0,1,0,,,,,,
534,338,641,534,338,640,,,0,0,1,,,,,,
535,339,666,535,339,665,,,0,0,1,,,,,,
536,340,691,535,340,691,,,1,0,0,,,,,,
536,341,716,536,341,716,,,0,0,0,,,,,,
537,342,741,537,342,741,,,0,0,0,,,,,,
538,343,767,537,343,766,,,1,0,1,,,,,,
532,351,114,532,351,114,,,0,0,0,,,,,,
532,351,115,532,351,114,,,0,0,1,,,,,,
532,351,121,532,351,120,,,0,0,1,,,,,,
532,351,130,532,351,131,,,0,0,-1,,,,,,
532,351,142,532,351,142,,,0,0,0,,,,,,
532,351,158,532,351,158,,,0,0,0,,,,,,
532,351,175,532,351,175,,,0,0,0,,,,,,
532,352,194,532,351,194,,,0,1,0,,,,,,
532,352,214,532,352,214,,,0,0,0,,,,,,
533,352,235,532,352,235,,,1,0,0,,,,,,
533,352,257,533,352,257,,,0,0,0,,,,,,
533,353,279,533,353,279,,,0,0,0,,,,,,
533,353,302,533,353,302,,,0,0,0,,,,,,
533,354,325,533,353,325,,,0,1,0,,,,,,
534,354,348,534,354,348,,,0,0,0,,,,,,
534,355,372,534,354,371,,,0,1,1,,,,,,
534,355,396,534,355,395,,,0,0,1,,,,,,
535,356,420,534,355,419,,,1,1,1,,,,,,
535,356,444,535,356,443,,,0,0,1,,,,,,
535,357,468,535,357,468,,,0,0,0,,,,,,
536,358,493,536,357,492,,,0,1,1,,,,,,
536,358,517,536,358,517,,,0,0,0,,,,,,
537,359,542,537,359,541,,,0,0,1,,,,,,
537,360,567,537,359,566,,,0,1,1,,,,,,
538,361,591,538,360,591,,,0,1,0,,,,,,
538,362,616,538,361,616,,,0,1,0,,,,,,
539,363,641,539,362,641,,,0,1,0,,,,,,
539,364,666,539,363,666,,,0,1,0,,,,,,
540,365,691,540,364,691,,,0,1,0,,,,,,
541,366,717,540,365,716,,,1,1,1,,,,,,
541,367,742,541,366,742,,,0,1,0,,,,,,
542,368,767,542,368,767,,,0,0,0,,,,,,
537,377,120,537,377,119,,,0,0,1,,,,,,
537,377,121,537,377,119,,,0,0,2,,,,,,
537,377,126,537,377,126,,,0,0,0,,,,,,
537,377,135,537,377,136,,,0,0,-1,,,,,,
537,378,147,537,378,147,,,0,0,0,,,,,,
537,378,162,537,378,163,,,0,0,-1,,,,,,
537,378,179,537,378,178,,,0,0,1,,,,,,
537,378,197,537,378,197,,,0,0,0,,,,,,
537,378,217,537,378,217,,,0,0,0,,,,,,
537,378,238,537,378,238,,,0,0,0,,,,,,
538,379,259,538,379,259,,,0,0,0,,,,,,
538,379,281,538,379,281,,,0,0,0,,,,,,
538,379,304,538,379,304,,,0,0,0,,,,,,
538,380,327,538,380,327,,,0,0,0,,,,,,
539,380,350,539,380,350,,,0,0,0,,,,,,
539,381,373,539,380,373,,,0,1,0,,,,,,
539,381,397,539,381,397,,,0,0,0,,,,,,
540,382,421,539,381,421,,,1,1,0,,,,,,
540,382,445,540,382,445,,,0,0,0,,,,,,
540,383,469,540,383,469,,,0,0,0,,,,,,
541,383,494,541,383,493,,,0,0,1,,,,,,
541,384,518,541,384,518,,,0,0,0,,,,,,
542,385,543,542,385,542,,,0,0,1,,,,,,
542,386,568,542,385,567,,,0,1,1,,,,,,
543,386,592,543,386,592,,,0,0,0,,,,,,
543,387,617,543,387,617,,,0,0,0,,,,,,
544,388,642,544,388,642,,,0,0,0,,,,,,
544,389,667,544,389,667,,,0,0,0,,,,,,
545,390,692,545,390,692,,,0,0,0,,,,,,
546,391,717,546,391,717,,,0,0,0,,,,,,
546,392,743,546,392,742,,,0,0,1,,,,,,
547,393,768,547,393,768,,,0,0,0,,,,,,
542,404,126,542,404,125,,,0,0,1,,,,,,
542,404,127,542,404,125,,,0,0,2,,,,,,
542,404,132,542,404,131,,,0,0,1,,,,,,
542,404,140,542,404,141,,,0,0,-1,,,,,,
542,404,152,542,404,152,,,0,0,0,,,,,,
542,404,166,542,404,167,,,0,0,-1,,,,,,
543,405,183,542,404,182,,,1,1,1,,,,,,
543,405,201,542,404,201,,,1,1,0,,,,,,
543,405,220,542,405,220,,,1,0,0,,,,,,
543,405,241,543,405,241,,,0,0,0,,,,,,
543,405,262,543,405,262,,,0,0,0,,,,,,
543,406,284,543,405,284,,,0,1,0,,,,,,
543,406,306,543,406,306,,,0,0,0,,,,,,
544,406,329,544,406,329,,,0,0,0,,,,,,
544,407,352,544,406,352,,,0,1,0,,,,,,
544,407,375,544,407,375,,,0,0,0,,,,,,
545,408,399,544,407,398,,,1,1,1,,,,,,
545,408,423,545,408,422,,,0,0,1,,,,,,
545,409,447,545,408,446,,,0,1,1,,,,,,
546,409,471,546,409,470,,,0,0,1,,,,,,
546,410,495,546,410,495,,,0,0,0,,,,,,
547,410,519,546,410,519,,,1,0,0,,,,,,
547,411,544,547,411,544,,,0,0,0,,,,,,
547,412,569,547,411,568,,,0,1,1,,,,,,
548,413,593,548,412,593,,,0,1,0,,,,,,
549,413,618,548,413,618,,,1,0,0,,,,,,
549,414,643,549,414,643,,,0,0,0,,,,,,
550,415,668,549,415,668,,,1,0,0,,,,,,
550,416,693,550,416,693,,,0,0,0,,,,,,
551,417,718,551,417,718,,,0,0,0,,,,,,
552,418,743,552,418,743,,,0,0,0,,,,,,
552,419,769,552,419,768,,,0,0,1,,,,,,
548,431,132,548,431,131,,,0,0,1,,,,,,
548,431,133,548,431,131,,,0,0,2,,,,,,
548,431,138,548,431,137,,,0,0,1,,,,,,
548,431,146,548,431,147,,,0,0,-1,,,,,,
548,431,157,548,431,157,,,0,0,0,,,,,,
548,431,171,548,431,172,,,0,0,-1,,,,,,
548,432,187,548,431,187,,,0,1,0,,,,,,
548,432,204,548,431,205,,,0,1,-1,,,,,,
549,432,223,548,432,223,,,1,0,0,,,,,,
549,432,244,549,432,244,,,0,0,0,,,,,,
549,432,265,549,432,265,,,0,0,0,,,,,,
549,433,286,549,432,286,,,0,1,0,,,,,,
549,433,308,549,433,308,,,0,0,0,,,,,,
550,433,331,550,433,331,,,0,0,0,,,,,,
550,434,354,550,433,354,,,0,1,0,,,,,,
550,434,377,550,434,377,,,0,0,0,,,,,,
550,434,400,550,434,400,,,0,0,0,,,,,,
551,435,424,551,435,424,,,0,0,0,,,,,,
551,435,448,551,435,448,,,0,0,0,,,,,,
551,436,472,551,436,472,,,0,0,0,,,,,,
552,436,496,552,436,496,,,0,0,0,,,,,,
552,437,521,552,437,520,,,0,0,1,,,,,,
553,438,545,553,438,545,,,0,0,0,,,,,,
553,438,570,553,438,569,,,0,0,1,,,,,,
554,439,594,554,439,594,,,0,0,0,,,,,,
554,440,619,554,439,619,,,0,1,0,,,,,,
555,440,644,555,440,644,,,0,0,0,,,,,,
555,441,669,555,441,669,,,0,0,0,,,,,,
556,442,694,556,442,694,,,0,0,0,,,,,,
557,443,719,557,443,719,,,0,0,0,,,,,,
557,444,744,557,444,744,,,0,0,0,,,,,,
558,445,770,558,445,769,,,0,0,1,,,,,,
554,459,138,554,459,138,,,0,0,0,,,,,,
554,459,139,554,459,138,,,0,0,1,,,,,,
554,459,144,554,459,144,,,0,0,0,,,,,,
554,459,151,554,459,153,,,0,0,-2,,,,,,
554,459,162,555,459,162,,,-1,0,0,,,,,,
555,459,175,555,459,176,,,0,0,-1,,,,,,
555,459,191,555,459,191,,,0,0,0,,,,,,
555,459,208,555,459,209,,,0,0,-1,,,,,,
555,459,227,555,459,227,,,0,0,0,,,,,,
555,459,247,555,459,247,,,0,0,0,,,,,,
555,460,268,555,460,268,,,0,0,0,,,,,,
555,460,289,555,460,289,,,0,0,0,,,,,,
556,460,311,556,460,311,,,0,0,0,,,,,,
556,460,333,556,460,333,,,0,0,0,,,,,,
556,461,356,556,461,356,,,0,0,0,,,,,,
556,461,379,556,461,379,,,0,0,0,,,,,,
557,462,402,557,462,402,,,0,0,0,,,,,,
557,462,426,557,462,426,,,0,0,0,,,,,,
557,462,450,557,462,449,,,0,0,1,,,,,,
558,463,474,557,463,473,,,1,0,1,,,,,,
558,463,498,558,463,497,,,0,0,1,,,,,,
559,464,522,558,464,522,,,1,0,0,,,,,,
559,465,547,559,465,546,,,0,0,1,,,,,,
559,465,571,559,465,571,,,0,0,0,,,,,,
560,466,596,560,466,595,,,0,0,1,,,,,,
560,467,620,560,466,620,,,0,1,0,,,,,,
561,467,645,561,467,645,,,0,0,0,,,,,,
562,468,670,562,468,670,,,0,0,0,,,,,,
562,469,695,562,469,695,,,0,0,0,,,,,,
563,470,720,563,469,720,,,0,1,0,,,,,,
563,470,745,563,470,745,,,0,0,0,,,,,,
564,471,770,564,471,770,,,0,0,0,,,,,,
561,486,145,561,486,144,,,0,0,1,,,,,,
561,486,146,561,486,144,,,0,0,2,,,,,,
561,486,150,561,486,150,,,0,0,0,,,,,,
561,486,157,561,486,158,,,0,0,-1,,,,,,
561,486,167,561,486,167,,,0,0,0,,,,,,
561,486,180,561,486,181,,,0,0,-1,,,,,,
561,486,196,561,486,196,,,0,0,0,,,,,,
561,487,213,561,486,213,,,0,1,0,,,,,,
561,487,231,561,486,231,,,0,1,0,,,,,,
562,487,250,561,487,251,,,1,0,-1,,,,,,
562,487,271,562,487,271,,,0,0,0,,,,,,
562,487,292,562,487,292,,,0,0,0,,,,,,
562,488,313,562,487,313,,,0,1,0,,,,,,
562,488,336,562,488,335,,,0,0,1,,,,,,
563,488,358,563,488,358,,,0,0,0,,,,,,
563,489,381,563,488,381,,,0,1,0,,,,,,
563,489,404,563,489,404,,,0,0,0,,,,,,
564,489,428,564,489,428,,,0,0,0,,,,,,
564,490,452,564,490,451,,,0,0,1,,,,,,
564,490,475,564,490,475,,,0,0,0,,,,,,
565,491,499,565,490,499,,,0,1,0,,,,,,
565,491,524,565,491,523,,,0,0,1,,,,,,
566,492,548,566,492,548,,,0,0,0,,,,,,
566,492,572,566,492,572,,,0,0,0,,,,,,
567,493,597,567,493,597,,,0,0,0,,,,,,
567,494,622,567,493,621,,,0,1,1,,,,,,
568,494,646,568,494,646,,,0,0,0,,,,,,
568,495,671,568,495,671,,,0,0,0,,,,,,
569,496,696,569,496,696,,,0,0,0,,,,,,
569,496,721,569,496,721,,,0,0,0,,,,,,
570,497,746,570,497,746,,,0,0,0,,,,,,
571,498,771,571,498,771,,,0,0,0,,,,,,
568,514,151,568,514,151,,,0,0,0,,,,,,
568,514,152,568,514,151,,,0,0,1,,,,,,
568,514,156,568,514,156,,,0,0,0,,,,,,
568,514,163,568,514,164,,,0,0,-1,,,,,,
568,514,173,568,514,173,,,0,0,0,,,,,,
568,514,186,568,514,187,,,0,0,-1,,,,,,
568,514,200,568,514,200,,,0,0,0,,,,,,
568,514,217,568,514,217,,,0,0,0,,,,,,
569,514,235,568,514,235,,,1,0,0,,,,,,
569,515,254,568,514,254,,,1,1,0,,,,,,
569,515,274,569,515,274,,,0,0,0,,,,,,
569,515,295,569,515,295,,,0,0,0,,,,,,
569,515,316,569,515,316,,,0,0,0,,,,,,
569,516,338,569,515,338,,,0,1,0,,,,,,
570,516,361,570,516,360,,,0,0,1,,,,,,
570,516,383,570,516,383,,,0,0,0,,,,,,
570,517,406,570,516,406,,,0,1,0,,,,,,
571,517,430,570,517,430,,,1,0,0,,,,,,
571,517,453,571,517,453,,,0,0,0,,,,,,
571,518,477,571,517,477,,,0,1,0,,,,,,
572,518,501,572,518,501,,,0,0,0,,,,,,
572,519,525,572,518,525,,,0,1,0,,,,,,
573,519,550,573,519,549,,,0,0,1,,,,,,
573,520,574,573,519,574,,,0,1,0,,,,,,
573,520,598,574,520,598,,,-1,0,0,,,,,,
574,521,623,574,521,623,,,0,0,0,,,,,,
575,522,648,575,521,647,,,0,1,1,,,,,,
575,522,673,575,522,672,,,0,0,1,,,,,,
576,523,697,576,523,697,,,0,0,0,,,,,,
576,524,722,576,523,722,,,0,1,0,,,,,,
577,524,747,577,524,747,,,0,0,0,,,,,,
578,525,772,577,525,772,,,1,0,0,,,,,,
575,542,158,576,542,158,,,-1,0,0,,,,,,
575,542,159,576,542,158,,,-1,0,1,,,,,,
575,542,163,576,542,162,,,-1,0,1,,,,,,
575,542,169,576,542,171,,,-1,0,-2,,,,,,
576,542,179,576,542,179,,,0,0,0,,,,,,
576,542,191,576,542,192,,,0,0,-1,,,,,,
576,542,205,576,542,205,,,0,0,0,,,,,,
576,542,221,576,542,222,,,0,0,-1,,,,,,
576,542,239,576,542,239,,,0,0,0,,,,,,
576,543,258,576,542,258,,,0,1,0,,,,,,
576,543,278,576,542,277,,,0,1,1,,,,,,
576,543,298,576,543,298,,,0,0,0,,,,,,
577,543,319,577,543,319,,,0,0,0,,,,,,
577,543,341,577,543,341,,,0,0,0,,,,,,
577,544,363,577,543,363,,,0,1,0,,,,,,
577,544,386,577,544,386,,,0,0,0,,,,,,
578,544,409,578,544,409,,,0,0,0,,,,,,
578,545,432,578,544,432,,,0,1,0,,,,,,
578,545,455,578,545,455,,,0,0,0,,,,,,
579,545,479,579,545,479,,,0,0,0,,,,,,
579,546,503,579,545,503,,,0,1,0,,,,,,
579,546,527,579,546,527,,,0,0,0,,,,,,
580,547,551,580,546,551,,,0,1,0,,,,,,
580,547,575,580,547,575,,,0,0,0,,,,,,
581,548,600,581,548,600,,,0,0,0,,,,,,
581,548,624,581,548,624,,,0,0,0,,,,,,
582,549,649,582,549,649,,,0,0,0,,,,,,
582,550,674,582,549,673,,,0,1,1,,,,,,
583,550,699,583,550,698,,,0,0,1,,,,,,
584,551,724,584,551,723,,,0,0,1,,,,,,
584,552,749,584,552,748,,,0,0,1,,,,,,
585,552,774,585,552,773,,,0,0,1,,,,,,
583,570,165,583,570,165,,,0,0,0,,,,,,
583,570,166,583,570,165,,,0,0,1,,,,,,
583,570,169,583,570,169,,,0,0,0,,,,,,
583,570,176,583,570,177,,,0,0,-1,,,,,,
583,570,185,583,570,185,,,0,0,0,,,,,,
583,570,197,583,570,197,,,0,0,0,,,,,,
583,570,211,583,570,210,,,0,0,1,,,,,,
584,570,226,583,570,227,,,1,0,-1,,,,,,
584,570,243,583,570,243,,,1,0,0,,,,,,
584,571,262,584,570,262,,,0,1,0,,,,,,
584,571,281,584,570,281,,,0,1,0,,,,,,
584,571,302,584,571,301,,,0,0,1,,,,,,
584,571,323,584,571,322,,,0,0,1,,,,,,
585,571,344,585,571,344,,,0,0,0,,,,,,
585,572,366,585,571,366,,,0,1,0,,,,,,
585,572,388,585,572,388,,,0,0,0,,,,,,
585,572,411,585,572,411,,,0,0,0,,,,,,
586,573,434,586,572,434,,,0,1,0,,,,,,
586,573,458,586,573,457,,,0,0,1,,,,,,
586,573,481,586,573,481,,,0,0,0,,,,,,
587,574,505,587,573,504,,,0,1,1,,,,,,
587,574,529,587,574,528,,,0,0,1,,,,,,
588,575,553,587,574,552,,,1,1,1,,,,,,
588,575,577,588,575,577,,,0,0,0,,,,,,
589,576,601,588,575,601,,,1,1,0,,,,,,
589,576,626,589,576,626,,,0,0,0,,,,,,
590,577,651,589,576,650,,,1,1,1,,,,,,
590,577,675,590,577,675,,,0,0,0,,,,,,
591,578,700,591,578,700,,,0,0,0,,,,,,
591,579,725,591,578,724,,,0,1,1,,,,,,
592,579,750,592,579,749,,,0,0,1,,,,,,
593,580,775,592,580,774,,,1,0,1,,,,,,
591,598,172,591,598,171,,,0,0,1,,,,,,
591,598,173,591,598,171,,,0,0,2,,,,,,
591,598,176,591,598,176,,,0,0,0,,,,,,
591,598,182,591,598,183,,,0,0,-1,,,,,,
591,598,191,591,598,191,,,0,0,0,,,,,,
592,598,202,591,598,203,,,1,0,-1,,,,,,
592,598,216,591,598,216,,,1,0,0,,,,,,
592,599,231,591,598,232,,,1,1,-1,,,,,,
592,599,248,592,598,248,,,0,1,0,,,,,,
592,599,266,592,598,266,,,0,1,0,,,,,,
592,599,285,592,599,285,,,0,0,0,,,,,,
592,599,305,592,599,305,,,0,0,0,,,,,,
593,599,326,592,599,326,,,1,0,0,,,,,,
593,600,347,593,599,347,,,0,1,0,,,,,,
593,600,369,593,600,369,,,0,0,0,,,,,,
593,600,391,593,600,391,,,0,0,0,,,,,,
594,600,414,593,600,414,,,1,0,0,,,,,,
594,601,437,594,600,437,,,0,1,0,,,,,,
594,601,460,594,601,460,,,0,0,0,,,,,,
595,601,483,595,601,483,,,0,0,0,,,,,,
595,602,507,595,601,507,,,0,1,0,,,,,,
595,602,531,595,602,530,,,0,0,1,,,,,,
596,603,555,596,602,554,,,0,1,1,,,,,,
596,603,579,596,603,578,,,0,0,1,,,,,,
597,604,603,597,603,603,,,0,1,0,,,,,,
597,604,628,597,604,627,,,0,0,1,,,,,,
598,605,652,598,604,652,,,0,1,0,,,,,,
598,605,677,598,605,676,,,0,0,1,,,,,,
599,606,701,599,605,701,,,0,1,0,,,,,,
599,606,726,599,606,726,,,0,0,0,,,,,,
600,607,751,600,607,751,,,0,0,0,,,,,,
601,608,776,600,607,776,,,1,1,0,,,,,,
600,627,179,600,626,178,,,0,1,1,,,,,,
600,627,180,600,626,178,,,0,1,2,,,,,,
600,627,183,600,626,183,,,0,1,0,,,,,,
600,627,189,600,626,190,,,0,1,-1,,,,,,
600,627,197,600,626,197,,,0,1,0,,,,,,
600,627,208,600,626,209,,,0,1,-1,,,,,,
600,627,221,600,626,221,,,0,1,0,,,,,,
600,627,236,600,626,237,,,0,1,-1,,,,,,
600,627,253,600,627,253,,,0,0,0,,,,,,
600,627,270,600,627,271,,,0,0,-1,,,,,,
601,627,289,601,627,289,,,0,0,0,,,,,,
601,627,309,601,627,309,,,0,0,0,,,,,,
601,628,329,601,627,329,,,0,1,0,,,,,,
601,628,350,601,628,350,,,0,0,0,,,,,,
601,628,372,601,628,372,,,0,0,0,,,,,,
602,628,394,601,628,394,,,1,0,0,,,,,,
602,629,416,602,628,416,,,0,1,0,,,,,,
602,629,439,602,629,439,,,0,0,0,,,,,,
603,629,462,603,629,462,,,0,0,0,,,,,,
603,630,486,603,629,486,,,0,1,0,,,,,,
603,630,509,603,630,509,,,0,0,0,,,,,,
604,630,533,604,630,533,,,0,0,0,,,,,,
604,631,557,604,630,556,,,0,1,1,,,,,,
605,631,581,605,631,580,,,0,0,1,,,,,,
605,632,605,605,631,605,,,0,1,0,,,,,,
605,632,629,606,632,629,,,-1,0,0,,,,,,
606,633,654,606,632,653,,,0,1,1,,,,,,
607,633,678,607,633,678,,,0,0,0,,,,,,
607,634,703,607,633,703,,,0,1,0,,,,,,
608,634,728,608,634,727,,,0,0,1,,,,,,
608,635,752,608,635,752,,,0,0,0,,,,,,
609,636,777,609,635,777,,,0,1,0,,,,,,
609,655,186,609,655,186,,,0,0,0,,,,,,
609,655,187,609,655,186,,,0,0,1,,,,,,
609,655,190,609,655,189,,,0,0,1,,,,,,
609,655,196,609,655,196,,,0,0,0,,,,,,
609,655,204,609,655,204,,,0,0,0,,,,,,
609,655,214,609,655,215,,,0,0,-1,,,,,,
609,655,227,609,655,227,,,0,0,0,,,,,,
609,655,242,609,655,242,,,0,0,0,,,,,,
609,655,258,609,655,258,,,0,0,0,,,,,,
609,656,275,609,655,275,,,0,1,0,,,,,,
609,656,293,610,656,293,,,-1,0,0,,,,,,
610,656,313,610,656,313,,,0,0,0,,,,,,
610,656,333,610,656,333,,,0,0,0,,,,,,
610,656,354,610,656,354,,,0,0,0,,,,,,
610,657,375,610,656,375,,,0,1,0,,,,,,
610,657,397,610,656,397,,,0,1,0,,,,,,
611,657,419,611,657,419,,,0,0,0,,,,,,
611,657,442,611,657,442,,,0,0,0,,,,,,
611,658,465,612,657,465,,,-1,1,0,,,,,,
612,658,488,612,658,488,,,0,0,0,,,,,,
612,658,511,612,658,511,,,0,0,0,,,,,,
612,659,535,612,658,535,,,0,1,0,,,,,,
613,659,559,613,659,558,,,0,0,1,,,,,,
613,660,583,613,659,582,,,0,1,1,,,,,,
614,660,607,614,660,606,,,0,0,1,,,,,,
614,660,631,614,660,631,,,0,0,0,,,,,,
615,661,655,615,661,655,,,0,0,0,,,,,,
615,661,680,615,661,680,,,0,0,0,,,,,,
616,662,704,616,662,704,,,0,0,0,,,,,,
616,662,729,616,662,729,,,0,0,0,,,,,,
617,663,754,617,663,754,,,0,0,0,,,,,,
618,664,779,617,663,778,,,1,1,1,,,,,,
618,684,193,618,683,193,,,0,1,0,,,,,,
618,684,194,618,683,193,,,0,1,1,,,,,,
618,684,197,618,683,196,,,0,1,1,,,,,,
618,684,202,618,683,203,,,0,1,-1,,,,,,
618,684,210,618,683,210,,,0,1,0,,,,,,
618,684,220,618,683,221,,,0,1,-1,,,,,,
618,684,233,618,684,233,,,0,0,0,,,,,,
618,684,247,618,684,248,,,0,0,-1,,,,,,
618,684,263,618,684,263,,,0,0,0,,,,,,
618,684,280,618,684,280,,,0,0,0,,,,,,
619,684,298,619,684,298,,,0,0,0,,,,,,
619,684,317,619,684,317,,,0,0,0,,,,,,
619,685,337,619,684,337,,,0,1,0,,,,,,
619,685,357,619,684,357,,,0,1,0,,,,,,
619,685,379,620,685,378,,,-1,0,1,,,,,,
620,685,400,620,685,400,,,0,0,0,,,,,,
620,686,422,620,685,422,,,0,1,0,,,,,,
620,686,445,620,685,445,,,0,1,0,,,,,,
620,686,467,621,686,467,,,-1,0,0,,,,,,
621,686,490,621,686,490,,,0,0,0,,,,,,
621,687,514,621,687,513,,,0,0,1,,,,,,
622,687,537,621,687,537,,,1,0,0,,,,,,
622,688,561,622,687,560,,,0,1,1,,,,,,
622,688,585,622,688,584,,,0,0,1,,,,,,
623,688,609,623,688,608,,,0,0,1,,,,,,
623,689,633,623,689,633,,,0,0,0,,,,,,
624,689,657,624,689,657,,,0,0,0,,,,,,
624,690,682,624,690,681,,,0,0,1,,,,,,
625,690,706,625,690,706,,,0,0,0,,,,,,
625,691,731,625,691,730,,,0,0,1,,,,,,
626,691,755,626,691,755,,,0,0,0,,,,,,
627,692,780,626,692,780,,,1,0,0,,,,,,
627,712,200,627,712,200,,,0,0,0,,,,,,
627,712,201,627,712,200,,,0,0,1,,,,,,
627,712,204,627,712,203,,,0,0,1,,,,,,
627,712,209,627,712,210,,,0,0,-1,,,,,,
627,712,217,627,712,217,,,0,0,0,,,,,,
627,712,227,627,712,228,,,0,0,-1,,,,,,
628,713,239,627,712,239,,,1,1,0,,,,,,
628,713,252,627,712,253,,,1,1,-1,,,,,,
628,713,268,628,712,268,,,0,1,0,,,,,,
628,713,284,628,713,285,,,0,0,-1,,,,,,
628,713,302,628,713,302,,,0,0,0,,,,,,
628,713,321,628,713,321,,,0,0,0,,,,,,
628,713,341,628,713,341,,,0,0,0,,,,,,
629,713,361,629,713,361,,,0,0,0,,,,,,
629,714,382,629,713,382,,,0,1,0,,,,,,
629,714,403,629,714,403,,,0,0,0,,,,,,
629,714,425,629,714,425,,,0,0,0,,,,,,
630,714,448,630,714,447,,,0,0,1,,,,,,
630,715,470,630,714,470,,,0,1,0,,,,,,
630,715,493,630,715,493,,,0,0,0,,,,,,
631,715,516,630,715,516,,,1,0,0,,,,,,
631,716,540,631,715,539,,,0,1,1,,,,,,
631,716,563,631,716,563,,,0,0,0,,,,,,
632,716,587,632,716,586,,,0,0,1,,,,,,
632,717,611,632,717,610,,,0,0,1,,,,,,
633,717,635,633,717,635,,,0,0,0,,,,,,
633,718,659,633,717,659,,,0,1,0,,,,,,
634,718,683,634,718,683,,,0,0,0,,,,,,
634,719,708,634,718,707,,,0,1,1,,,,,,
635,719,732,635,719,732,,,0,0,0,,,,,,
635,720,757,635,719,757,,,0,1,0,,,,,,
636,720,782,636,720,781,,,0,0,1,,,,,,
637,741,208,637,741,207,,,0,0,1,,,,,,
637,741,208,637,741,207,,,0,0,1,,,,,,
637,741,211,637,741,211,,,0,0,0,,,,,,
637,741,216,637,741,217,,,0,0,-1,,,,,,
637,741,224,637,741,223,,,0,0,1,,,,,,
637,741,233,637,741,234,,,0,0,-1,,,,,,
637,741,245,637,741,245,,,0,0,0,,,,,,
637,741,258,637,741,259,,,0,0,-1,,,,,,
637,741,273,637,741,273,,,0,0,0,,,,,,
638,742,289,637,741,290,,,1,1,-1,,,,,,
638,742,307,638,742,307,,,0,0,0,,,,,,
638,742,325,638,742,326,,,0,0,-1,,,,,,
638,742,345,638,742,345,,,0,0,0,,,,,,
638,742,365,638,742,365,,,0,0,0,,,,,,
639,742,386,638,742,385,,,1,0,1,,,,,,
639,743,407,639,742,407,,,0,1,0,,,,,,
639,743,428,639,743,428,,,0,0,0,,,,,,
639,743,451,639,743,450,,,0,0,1,,,,,,
640,743,473,640,743,473,,,0,0,0,,,,,,
640,744,496,640,743,495,,,0,1,1,,,,,,
640,744,519,640,744,518,,,0,0,1,,,,,,
641,744,542,641,744,542,,,0,0,0,,,,,,
641,745,565,641,744,565,,,0,1,0,,,,,,
641,745,589,641,745,589,,,0,0,0,,,,,,
642,745,613,642,745,613,,,0,0,0,,,,,,
642,746,637,642,745,637,,,0,1,0,,,,,,
643,746,661,643,746,661,,,0,0,0,,,,,,
643,747,685,643,746,685,,,0,1,0,,,,,,
644,747,710,644,747,709,,,0,0,1,,,,,,
644,748,734,644,747,734,,,0,1,0,,,,,,
645,748,759,645,748,758,,,0,0,1,,,,,,
645,749,783,645,748,783,,,0,1,0,,,,,,
647,770,215,647,770,215,,,0,0,0,,,,,,
647,770,216,647,770,215,,,0,0,1,,,,,,
647,770,218,647,770,218,,,0,0,0,,,,,,
647,770,223,647,770,224,,,0,0,-1,,,,,,
647,770,230,647,770,230,,,0,0,0,,,,,,
647,770,240,647,770,240,,,0,0,0,,,,,,
647,770,251,647,770,251,,,0,0,0,,,,,,
647,770,264,647,770,264,,,0,0,0,,,,,,
648,770,279,647,770,278,,,1,0,1,,,,,,
648,770,295,648,770,295,,,0,0,0,,,,,,
648,771,312,648,770,312,,,0,1,0,,,,,,
648,771,330,648,770,330,,,0,1,0,,,,,,
648,771,349,648,771,349,,,0,0,0,,,,,,
648,771,369,648,771,369,,,0,0,0,,,,,,
649,771,389,649,771,389,,,0,0,0,,,,,,
649,771,410,649,771,410,,,0,0,0,,,,,,
649,772,432,649,771,432,,,0,1,0,,,,,,
649,772,454,649,772,454,,,0,0,0,,,,,,
650,772,476,650,772,476,,,0,0,0,,,,,,
650,772,499,650,772,498,,,0,0,1,,,,,,
650,773,521,650,772,521,,,0,1,0,,,,,,
651,773,545,651,773,544,,,0,0,1,,,,,,
651,773,568,651,773,568,,,0,0,0,,,,,,
651,774,591,651,773,591,,,0,1,0,,,,,,
652,774,615,652,774,615,,,0,0,0,,,,,,
652,774,639,652,774,639,,,0,0,0,,,,,,
653,775,663,653,775,663,,,0,0,0,,,,,,
653,775,687,653,775,687,,,0,0,0,,,,,,
654,776,712,654,775,711,,,0,1,1,,,,,,
654,776,736,654,776,736,,,0,0,0,,,,,,
655,777,761,655,776,760,,,0,1,1,,,,,,
655,777,785,655,777,785,,,0,0,0,,,,,,
657,799,222,657,799,222,,,0,0,0,,,,,,
657,799,223,657,799,222,,,0,0,1,,,,,,
657,799,226,657,799,225,,,0,0,1,,,,,,
657,799,230,657,799,231,,,0,0,-1,,,,,,
658,799,237,657,799,237,,,1,0,0,,,,,,
658,799,246,657,799,247,,,1,0,-1,,,,,,
658,799,257,658,799,257,,,0,0,0,,,,,,
658,799,270,658,799,270,,,0,0,0,,,,,,
658,799,284,658,799,284,,,0,0,0,,,,,,
658,799,300,658,799,300,,,0,0,0,,,,,,
658,799,317,658,799,317,,,0,0,0,,,,,,
658,800,335,658,799,335,,,0,1,0,,,,,,
658,800,353,658,800,353,,,0,0,0,,,,,,
659,800,373,659,800,373,,,0,0,0,,,,,,
659,800,393,659,800,393,,,0,0,0,,,,,,
659,800,414,659,800,414,,,0,0,0,,,,,,
659,801,435,659,800,435,,,0,1,0,,,,,,
660,801,457,660,800,457,,,0,1,0,,,,,,
660,801,479,660,801,479,,,0,0,0,,,,,,
660,801,501,660,801,502,,,0,0,-1,,,,,,
661,802,524,660,801,524,,,1,1,0,,,,,,
661,802,547,661,801,547,,,0,1,0,,,,,,
661,802,570,661,802,570,,,0,0,0,,,,,,
662,802,594,662,802,594,,,0,0,0,,,,,,
662,803,617,662,803,617,,,0,0,0,,,,,,
662,803,641,663,803,641,,,-1,0,0,,,,,,
663,804,665,663,804,665,,,0,0,0,,,,,,
663,804,689,664,804,689,,,-1,0,0,,,,,,
664,804,714,664,804,713,,,0,0,1,,,,,,
664,805,738,665,804,738,,,-1,1,0,,,,,,
665,805,762,665,805,762,,,0,0,0,,,,,,
666,806,787,666,805,787,,,0,1,0,,,,,,
668,828,230,668,828,229,,,0,0,1,,,,,,
668,828,230,668,828,229,,,0,0,1,,,,,,
668,828,233,668,828,232,,,0,0,1,,,,,,
668,828,237,668,828,238,,,0,0,-1,,,,,,
668,828,244,668,828,244,,,0,0,0,,,,,,
668,828,253,668,828,253,,,0,0,0,,,,,,
668,828,263,668,828,263,,,0,0,0,,,,,,
668,828,276,668,828,276,,,0,0,0,,,,,,
668,828,290,668,828,290,,,0,0,0,,,,,,
669,828,305,669,828,306,,,0,0,-1,,,,,,
669,828,322,669,828,322,,,0,0,0,,,,,,
669,829,339,669,828,340,,,0,1,-1,,,,,,
669,829,358,669,829,358,,,0,0,0,,,,,,
669,829,377,669,829,377,,,0,0,0,,,,,,
669,829,397,670,829,397,,,-1,0,0,,,,,,
670,829,418,670,829,418,,,0,0,0,,,,,,
670,829,439,670,829,439,,,0,0,0,,,,,,
670,830,460,670,829,460,,,0,1,0,,,,,,
670,830,482,671,830,482,,,-1,0,0,,,,,,
671,830,505,671,830,505,,,0,0,0,,,,,,
671,830,527,671,830,527,,,0,0,0,,,,,,
671,831,550,671,830,550,,,0,1,0,,,,,,
672,831,573,672,831,573,,,0,0,0,,,,,,
672,831,596,672,831,596,,,0,0,0,,,,,,
673,832,620,673,832,620,,,0,0,0,,,,,,
673,832,644,673,832,643,,,0,0,1,,,,,,
673,832,667,674,832,667,,,-1,0,0,,,,,,
674,833,691,674,832,691,,,0,1,0,,,,,,
674,833,716,675,833,715,,,-1,0,1,,,,,,
675,834,740,675,833,740,,,0,1,0,,,,,,
675,834,764,676,834,764,,,-1,0,0,,,,,,
676,835,789,676,834,789,,,0,1,0,,,,,,
679,857,237,679,857,237,,,0,0,0,,,,,,
679,857,238,679,857,237,,,0,0,1,,,,,,
679,857,240,679,857,240,,,0,0,0,,,,,,
679,857,245,679,857,245,,,0,0,0,,,,,,
679,857,251,679,857,251,,,0,0,0,,,,,,
679,857,259,679,857,260,,,0,0,-1,,,,,,
679,857,270,679,857,270,,,0,0,0,,,,,,
679,857,282,679,857,283,,,0,0,-1,,,,,,
679,857,296,679,857,296,,,0,0,0,,,,,,
679,857,311,679,857,311,,,0,0,0,,,,,,
679,858,327,680,858,327,,,-1,0,0,,,,,,
680,858,344,680,858,344,,,0,0,0,,,,,,
680,858,362,680,858,362,,,0,0,0,,,,,,
680,858,381,680,858,382,,,0,0,-1,,,,,,
680,858,401,680,858,401,,,0,0,0,,,,,,
680,858,422,680,858,422,,,0,0,0,,,,,,
681,858,442,681,858,442,,,0,0,0,,,,,,
681,859,464,681,858,464,,,0,1,0,,,,,,
681,859,486,681,859,485,,,0,0,1,,,,,,
682,859,508,681,859,508,,,1,0,0,,,,,,
682,859,530,682,859,530,,,0,0,0,,,,,,
682,860,553,682,859,553,,,0,1,0,,,,,,
683,860,576,683,860,575,,,0,0,1,,,,,,
683,860,599,683,860,599,,,0,0,0,,,,,,
683,861,622,683,861,622,,,0,0,0,,,,,,
684,861,646,684,861,646,,,0,0,0,,,,,,
684,861,670,684,861,669,,,0,0,1,,,,,,
685,862,694,685,861,693,,,0,1,1,,,,,,
685,862,718,685,862,717,,,0,0,1,,,,,,
686,863,742,686,862,742,,,0,1,0,,,,,,
686,863,766,686,863,766,,,0,0,0,,,,,,
687,863,791,687,863,791,,,0,0,0,,,,,,
690,886,245,690,886,244,,,0,0,1,,,,,,
690,886,245,690,886,244,,,0,0,1,,,,,,
690,886,248,690,886,247,,,0,0,1,,,,,,
690,886,252,690,886,252,,,0,0,0,,,,,,
690,886,258,690,886,258,,,0,0,0,,,,,,
690,886,266,690,886,267,,,0,0,-1,,,,,,
690,886,276,690,886,276,,,0,0,0,,,,,,
690,886,288,690,886,289,,,0,0,-1,,,,,,
690,886,301,690,886,301,,,0,0,0,,,,,,
690,887,316,690,886,317,,,0,1,-1,,,,,,
691,887,332,691,887,332,,,0,0,0,,,,,,
691,887,349,691,887,349,,,0,0,0,,,,,,
691,887,367,691,887,367,,,0,0,0,,,,,,
691,887,386,691,887,386,,,0,0,0,,,,,,
691,887,405,691,887,405,,,0,0,0,,,,,,
691,887,426,691,887,426,,,0,0,0,,,,,,
692,888,446,692,887,446,,,0,1,0,,,,,,
692,888,467,692,887,467,,,0,1,0,,,,,,
692,888,489,692,888,489,,,0,0,0,,,,,,
693,888,511,693,888,511,,,0,0,0,,,,,,
693,888,533,693,888,533,,,0,0,0,,,,,,
693,889,556,693,888,556,,,0,1,0,,,,,,
694,889,579,694,889,578,,,0,0,1,,,,,,
694,889,602,694,889,601,,,0,0,1,,,,,,
694,890,625,694,890,625,,,0,0,0,,,,,,
695,890,648,695,890,648,,,0,0,0,,,,,,
695,890,672,695,890,672,,,0,0,0,,,,,,
696,891,696,696,890,696,,,0,1,0,,,,,,
696,891,720,696,891,720,,,0,0,0,,,,,,
697,891,744,697,891,744,,,0,0,0,,,,,,
697,892,768,697,892,768,,,0,0,0,,,,,,
698,892,793,698,892,792,,,0,0,1,,,,,,
533,147,81,533,147,81,,,0,0,0,,,,,,
533,147,83,533,147,81,,,0,0,2,,,,,,
533,147,90,533,147,90,,,0,0,0,,,,,,
533,148,103,533,147,104,,,0,1,-1,,,,,,
533,148,118,533,148,118,,,0,0,0,,,,,,
533,148,137,533,148,137,,,0,0,0,,,,,,
533,149,157,533,149,157,,,0,0,0,,,,,,
533,149,178,533,149,178,,,0,0,0,,,,,,
533,150,200,533,150,200,,,0,0,0,,,,,,
533,150,222,533,150,222,,,0,0,0,,,,,,
534,151,245,534,151,245,,,0,0,0,,,,,,
534,152,269,534,152,268,,,0,0,1,,,,,,
534,153,292,534,153,292,,,0,0,0,,,,,,
534,154,316,534,154,316,,,0,0,0,,,,,,
535,155,340,535,155,340,,,0,0,0,,,,,,
535,156,364,535,156,364,,,0,0,0,,,,,,
535,158,389,535,158,389,,,0,0,0,,,,,,
536,159,413,535,159,413,,,1,0,0,,,,,,
536,161,438,536,161,438,,,0,0,0,,,,,,
536,162,462,536,162,462,,,0,0,0,,,,,,
537,164,487,537,164,487,,,0,0,0,,,,,,
537,166,512,537,165,512,,,0,1,0,,,,,,
538,167,537,538,167,537,,,0,0,0,,,,,,
538,169,562,538,169,562,,,0,0,0,,,,,,
539,171,587,539,171,587,,,0,0,0,,,,,,
539,173,612,539,173,612,,,0,0,0,,,,,,
540,175,637,540,175,637,,,0,0,0,,,,,,
540,178,662,540,177,662,,,0,1,0,,,,,,
541,180,688,541,180,688,,,0,0,0,,,,,,
542,182,713,541,182,713,,,1,0,0,,,,,,
542,185,738,542,185,738,,,0,0,0,,,,,,
543,187,764,543,187,763,,,0,0,1,,,,,,
533,149,81,533,147,81,,,0,2,0,,,,,,
533,149,83,533,147,81,,,0,2,2,,,,,,
533,149,90,533,147,90,,,0,2,0,,,,,,
533,149,103,533,147,104,,,0,2,-1,,,,,,
533,149,119,533,148,118,,,0,1,1,,,,,,
533,150,137,533,148,137,,,0,2,0,,,,,,
533,150,157,533,149,157,,,0,1,0,,,,,,
533,151,178,533,149,178,,,0,2,0,,,,,,
533,151,200,533,150,200,,,0,1,0,,,,,,
534,152,222,533,150,222,,,1,2,0,,,,,,
534,153,245,534,151,245,,,0,2,0,,,,,,
534,153,269,534,152,268,,,0,1,1,,,,,,
534,154,292,534,153,292,,,0,1,0,,,,,,
534,155,316,534,154,316,,,0,1,0,,,,,,
535,156,340,535,155,340,,,0,1,0,,,,,,
535,158,364,535,156,364,,,0,2,0,,,,,,
535,159,389,535,158,389,,,0,1,0,,,,,,
536,160,413,535,159,413,,,1,1,0,,,,,,
536,162,438,536,161,438,,,0,1,0,,,,,,
536,163,462,536,162,462,,,0,1,0,,,,,,
537,165,487,537,164,487,,,0,1,0,,,,,,
537,167,512,537,165,512,,,0,2,0,,,,,,
538,169,537,538,167,537,,,0,2,0,,,,,,
538,171,562,538,169,562,,,0,2,0,,,,,,
539,172,587,539,171,587,,,0,1,0,,,,,,
539,175,612,539,173,612,,,0,2,0,,,,,,
540,177,637,540,175,637,,,0,2,0,,,,,,
540,179,662,540,177,662,,,0,2,0,,,,,,
541,181,688,541,180,688,,,0,1,0,,,,,,
542,183,713,541,182,713,,,1,1,0,,,,,,
542,186,738,542,185,738,,,0,1,0,,,,,,
543,188,764,543,187,763,,,0,1,1,,,,,,
533,154,82,533,154,82,,,0,0,0,,,,,,
533,154,84,533,154,82,,,0,0,2,,,,,,
533,154,91,533,154,91,,,0,0,0,,,,,,
533,154,103,533,154,105,,,0,0,-2,,,,,,
533,155,119,533,155,119,,,0,0,0,,,,,,
533,155,137,533,155,138,,,0,0,-1,,,,,,
534,155,157,534,155,157,,,0,0,0,,,,,,
534,156,178,534,155,178,,,0,1,0,,,,,,
534,156,200,534,156,200,,,0,0,0,,,,,,
534,157,223,534,157,223,,,0,0,0,,,,,,
534,158,246,534,158,246,,,0,0,0,,,,,,
534,159,269,534,159,269,,,0,0,0,,,,,,
535,160,292,535,160,292,,,0,0,0,,,,,,
535,161,316,535,161,316,,,0,0,0,,,,,,
535,162,340,535,162,340,,,0,0,0,,,,,,
535,163,364,535,163,364,,,0,0,0,,,,,,
536,164,389,536,164,389,,,0,0,0,,,,,,
536,165,413,536,165,413,,,0,0,0,,,,,,
536,167,438,536,167,438,,,0,0,0,,,,,,
537,168,462,536,168,462,,,1,0,0,,,,,,
537,170,487,537,170,487,,,0,0,0,,,,,,
538,172,512,537,171,512,,,1,1,0,,,,,,
538,173,537,538,173,537,,,0,0,0,,,,,,
539,175,562,538,175,562,,,1,0,0,,,,,,
539,177,587,539,177,587,,,0,0,0,,,,,,
540,179,612,539,179,612,,,1,0,0,,,,,,
540,181,637,540,181,637,,,0,0,0,,,,,,
541,183,663,541,183,662,,,0,0,1,,,,,,
542,185,688,542,185,688,,,0,0,0,,,,,,
542,188,713,542,187,713,,,0,1,0,,,,,,
543,190,739,543,190,739,,,0,0,0,,,,,,
544,192,764,543,192,764,,,1,0,0,,,,,,
534,164,83,534,165,83,,,0,-1,0,,,,,,
534,164,85,534,165,83,,,0,-1,2,,,,,,
534,164,92,534,165,92,,,0,-1,0,,,,,,
534,164,104,534,165,106,,,0,-1,-2,,,,,,
534,164,120,534,166,120,,,0,-2,0,,,,,,
534,164,138,534,166,139,,,0,-2,-1,,,,,,
534,165,158,534,166,158,,,0,-1,0,,,,,,
534,165,179,534,167,179,,,0,-2,0,,,,,,
535,166,201,535,167,200,,,0,-1,1,,,,,,
535,166,223,535,168,223,,,0,-2,0,,,,,,
535,167,246,535,169,246,,,0,-2,0,,,,,,
535,168,269,535,170,269,,,0,-2,0,,,,,,
535,169,293,535,171,292,,,0,-2,1,,,,,,
536,170,316,535,171,316,,,1,-1,0,,,,,,
536,171,340,536,172,340,,,0,-1,0,,,,,,
536,172,365,536,173,364,,,0,-1,1,,,,,,
536,173,389,536,174,389,,,0,-1,0,,,,,,
537,174,413,536,176,413,,,1,-2,0,,,,,,
537,176,438,537,177,438,,,0,-1,0,,,,,,
538,177,463,537,179,462,,,1,-2,1,,,,,,
538,179,487,538,180,487,,,0,-1,0,,,,,,
538,180,512,538,182,512,,,0,-2,0,,,,,,
539,182,537,539,183,537,,,0,-1,0,,,,,,
539,184,562,539,185,562,,,0,-1,0,,,,,,
540,185,587,540,187,587,,,0,-2,0,,,,,,
540,187,612,540,189,612,,,0,-2,0,,,,,,
541,189,637,541,191,637,,,0,-2,0,,,,,,
542,191,663,541,192,662,,,1,-1,1,,,,,,
542,193,688,542,194,688,,,0,-1,0,,,,,,
543,195,713,543,197,713,,,0,-2,0,,,,,,
544,198,739,544,199,739,,,0,-1,0,,,,,,
544,200,764,544,201,764,,,0,-1,0,,,,,,
535,177,85,535,177,85,,,0,0,0,,,,,,
535,177,87,535,177,85,,,0,0,2,,,,,,
535,177,94,535,177,94,,,0,0,0,,,,,,
535,177,106,535,177,107,,,0,0,-1,,,,,,
535,177,121,535,177,121,,,0,0,0,,,,,,
535,178,139,535,177,140,,,0,1,-1,,,,,,
535,178,159,535,178,159,,,0,0,0,,,,,,
535,178,179,535,178,180,,,0,0,-1,,,,,,
536,179,201,536,179,201,,,0,0,0,,,,,,
536,179,224,536,179,223,,,0,0,1,,,,,,
536,180,246,536,180,246,,,0,0,0,,,,,,
536,181,270,536,181,269,,,0,0,1,,,,,,
536,182,293,536,182,293,,,0,0,0,,,,,,
537,182,317,536,182,317,,,1,0,0,,,,,,
537,183,341,537,183,341,,,0,0,0,,,,,,
537,184,365,537,184,365,,,0,0,0,,,,,,
537,185,389,537,185,389,,,0,0,0,,,,,,
538,187,414,537,186,413,,,1,1,1,,,,,,
538,188,438,538,188,438,,,0,0,0,,,,,,
539,189,463,538,189,463,,,1,0,0,,,,,,
539,191,488,539,191,488,,,0,0,0,,,,,,
539,192,512,539,192,512,,,0,0,0,,,,,,
540,194,537,540,194,537,,,0,0,0,,,,,,
540,195,562,540,195,562,,,0,0,0,,,,,,
541,197,587,541,197,587,,,0,0,0,,,,,,
541,199,612,541,199,612,,,0,0,0,,,,,,
542,201,638,542,201,638,,,0,0,0,,,,,,
543,202,663,542,202,663,,,1,0,0,,,,,,
543,204,688,543,204,688,,,0,0,0,,,,,,
544,206,713,544,206,713,,,0,0,0,,,,,,
545,209,739,545,209,739,,,0,0,0,,,,,,
545,211,764,545,211,764,,,0,0,0,,,,,,
537,193,87,536,194,87,,,1,-1,0,,,,,,
537,193,89,536,194,87,,,1,-1,2,,,,,,
537,193,96,536,194,96,,,1,-1,0,,,,,,
537,194,107,536,194,109,,,1,0,-2,,,,,,
537,194,123,537,195,123,,,0,-1,0,,,,,,
537,194,140,537,195,141,,,0,-1,-1,,,,,,
537,194,160,537,195,160,,,0,-1,0,,,,,,
537,195,181,537,196,181,,,0,-1,0,,,,,,
537,195,202,537,196,202,,,0,-1,0,,,,,,
537,196,224,537,197,224,,,0,-1,0,,,,,,
537,196,247,537,197,247,,,0,-1,0,,,,,,
538,197,270,537,198,270,,,1,-1,0,,,,,,
538,198,294,538,199,293,,,0,-1,1,,,,,,
538,198,317,538,199,317,,,0,-1,0,,,,,,
538,199,341,538,200,341,,,0,-1,0,,,,,,
539,200,365,538,201,365,,,1,-1,0,,,,,,
539,201,390,539,202,389,,,0,-1,1,,,,,,
539,202,414,539,203,414,,,0,-1,0,,,,,,
540,203,439,539,204,438,,,1,-1,1,,,,,,
540,205,463,540,206,463,,,0,-1,0,,,,,,
540,206,488,540,207,488,,,0,-1,0,,,,,,
541,207,513,541,208,512,,,0,-1,1,,,,,,
541,209,538,541,210,537,,,0,-1,1,,,,,,
542,210,563,542,211,562,,,0,-1,1,,,,,,
542,212,588,542,213,587,,,0,-1,1,,,,,,
543,213,613,543,214,612,,,0,-1,1,,,,,,
543,215,638,543,216,638,,,0,-1,0,,,,,,
544,217,663,544,218,663,,,0,-1,0,,,,,,
545,219,688,545,219,688,,,0,0,0,,,,,,
545,220,714,545,221,713,,,0,-1,1,,,,,,
546,222,739,546,224,739,,,0,-2,0,,,,,,
547,224,764,547,225,764,,,0,-1,0,,,,,,
538,212,90,538,212,90,,,0,0,0,,,,,,
538,212,92,538,212,90,,,0,0,2,,,,,,
538,212,98,538,212,98,,,0,0,0,,,,,,
538,212,110,538,212,111,,,0,0,-1,,,,,,
539,213,125,539,213,125,,,0,0,0,,,,,,
539,213,142,539,213,143,,,0,0,-1,,,,,,
539,213,161,539,213,161,,,0,0,0,,,,,,
539,213,182,539,213,182,,,0,0,0,,,,,,
539,214,203,539,214,203,,,0,0,0,,,,,,
539,214,225,539,214,225,,,0,0,0,,,,,,
539,215,248,539,215,248,,,0,0,0,,,,,,
539,215,271,539,215,271,,,0,0,0,,,,,,
540,216,294,540,216,294,,,0,0,0,,,,,,
540,217,318,540,216,318,,,0,1,0,,,,,,
540,217,342,540,217,342,,,0,0,0,,,,,,
540,218,366,540,218,366,,,0,0,0,,,,,,
541,219,390,541,219,390,,,0,0,0,,,,,,
541,220,415,541,220,414,,,0,0,1,,,,,,
541,221,439,541,221,439,,,0,0,0,,,,,,
542,222,464,541,222,463,,,1,0,1,,,,,,
542,224,488,542,224,488,,,0,0,0,,,,,,
543,225,513,542,225,513,,,1,0,0,,,,,,
543,226,538,543,226,538,,,0,0,0,,,,,,
544,227,563,543,227,563,,,1,0,0,,,,,,
544,229,588,544,229,588,,,0,0,0,,,,,,
545,230,613,544,230,613,,,1,0,0,,,,,,
545,232,638,545,232,638,,,0,0,0,,,,,,
546,234,663,546,233,663,,,0,1,0,,,,,,
547,235,689,547,235,689,,,0,0,0,,,,,,
547,237,714,547,237,714,,,0,0,0,,,,,,
548,239,739,548,239,739,,,0,0,0,,,,,,
549,241,765,548,240,764,,,1,1,1,,,,,,
541,233,93,540,233,93,,,1,0,0,,,,,,
541,233,95,540,233,93,,,1,0,2,,,,,,
541,233,102,540,233,101,,,1,0,1,,,,,,
541,233,113,540,234,114,,,1,-1,-1,,,,,,
541,233,127,541,234,127,,,0,-1,0,,,,,,
541,233,144,541,234,145,,,0,-1,-1,,,,,,
541,234,163,541,234,163,,,0,0,0,,,,,,
541,234,183,541,235,183,,,0,-1,0,,,,,,
541,234,205,541,235,204,,,0,-1,1,,,,,,
541,235,227,541,235,227,,,0,0,0,,,,,,
541,235,249,541,236,249,,,0,-1,0,,,,,,
542,236,272,542,236,272,,,0,0,0,,,,,,
542,236,295,542,237,295,,,0,-1,0,,,,,,
542,237,319,542,237,319,,,0,0,0,,,,,,
542,238,343,542,238,343,,,0,0,0,,,,,,
543,238,367,543,239,367,,,0,-1,0,,,,,,
543,239,391,543,240,391,,,0,-1,0,,,,,,
543,240,415,543,241,415,,,0,-1,0,,,,,,
544,241,440,543,242,439,,,1,-1,1,,,,,,
544,242,464,544,243,464,,,0,-1,0,,,,,,
545,243,489,544,244,489,,,1,-1,0,,,,,,
545,244,514,545,245,513,,,0,-1,1,,,,,,
545,246,539,545,246,538,,,0,0,1,,,,,,
546,247,563,546,247,563,,,0,0,0,,,,,,
546,248,588,546,249,588,,,0,-1,0,,,,,,
547,249,613,547,250,613,,,0,-1,0,,,,,,
548,251,639,547,252,638,,,1,-1,1,,,,,,
548,252,664,548,253,663,,,0,-1,1,,,,,,
549,254,689,549,254,689,,,0,0,0,,,,,,
549,255,714,549,256,714,,,0,-1,0,,,,,,
550,257,740,550,258,739,,,0,-1,1,,,,,,
551,259,765,551,259,765,,,0,0,0,,,,,,
543,255,97,543,255,97,,,0,0,0,,,,,,
543,255,99,543,255,97,,,0,0,2,,,,,,
543,255,105,543,255,105,,,0,0,0,,,,,,
543,255,116,543,255,117,,,0,0,-1,,,,,,
543,256,130,543,256,130,,,0,0,0,,,,,,
543,256,147,543,256,147,,,0,0,0,,,,,,
544,256,165,544,256,165,,,0,0,0,,,,,,
544,256,185,544,256,185,,,0,0,0,,,,,,
544,257,206,544,257,206,,,0,0,0,,,,,,
544,257,228,544,257,228,,,0,0,0,,,,,,
544,257,251,544,257,251,,,0,0,0,,,,,,
544,258,273,544,257,274,,,0,1,-1,,,,,,
545,258,297,545,258,297,,,0,0,0,,,,,,
545,259,320,545,259,320,,,0,0,0,,,,,,
545,260,344,545,260,344,,,0,0,0,,,,,,
545,260,368,545,260,368,,,0,0,0,,,,,,
546,261,392,546,261,392,,,0,0,0,,,,,,
546,262,416,546,262,416,,,0,0,0,,,,,,
546,263,440,546,263,440,,,0,0,0,,,,,,
547,264,465,546,264,465,,,1,0,0,,,,,,
547,265,490,547,265,490,,,0,0,0,,,,,,
548,266,514,547,266,514,,,1,0,0,,,,,,
548,267,539,548,267,539,,,0,0,0,,,,,,
549,268,564,548,268,564,,,1,0,0,,,,,,
549,269,589,549,269,589,,,0,0,0,,,,,,
550,270,614,549,270,614,,,1,0,0,,,,,,
550,272,639,550,272,639,,,0,0,0,,,,,,
551,273,664,550,273,664,,,1,0,0,,,,,,
551,274,689,551,274,689,,,0,0,0,,,,,,
552,276,715,552,275,714,,,0,1,1,,,,,,
553,277,740,553,277,740,,,0,0,0,,,,,,
553,279,765,553,278,765,,,0,1,0,,,,,,
546,279,102,546,279,101,,,0,0,1,,,,,,
546,279,103,546,279,101,,,0,0,2,,,,,,
546,279,109,546,279,109,,,0,0,0,,,,,,
546,279,119,546,279,121,,,0,0,-2,,,,,,
546,279,133,546,279,133,,,0,0,0,,,,,,
547,279,149,546,279,150,,,1,0,-1,,,,,,
547,279,168,547,280,167,,,0,-1,1,,,,,,
547,280,187,547,280,187,,,0,0,0,,,,,,
547,280,208,547,280,208,,,0,0,0,,,,,,
547,280,230,547,280,230,,,0,0,0,,,,,,
547,281,252,547,281,252,,,0,0,0,,,,,,
547,281,275,547,281,275,,,0,0,0,,,,,,
548,281,298,548,282,298,,,0,-1,0,,,,,,
548,282,321,548,282,321,,,0,0,0,,,,,,
548,283,345,548,283,345,,,0,0,0,,,,,,
548,283,369,548,284,369,,,0,-1,0,,,,,,
549,284,393,549,284,393,,,0,0,0,,,,,,
549,285,417,549,285,417,,,0,0,0,,,,,,
549,285,441,549,286,441,,,0,-1,0,,,,,,
550,286,466,550,287,465,,,0,-1,1,,,,,,
550,287,490,550,288,490,,,0,-1,0,,,,,,
551,288,515,551,289,515,,,0,-1,0,,,,,,
551,289,540,551,290,539,,,0,-1,1,,,,,,
552,290,565,552,290,564,,,0,0,1,,,,,,
552,291,590,552,291,589,,,0,0,1,,,,,,
553,292,615,553,293,614,,,0,-1,1,,,,,,
553,294,640,553,294,639,,,0,0,1,,,,,,
554,295,665,554,295,664,,,0,0,1,,,,,,
554,296,690,554,296,690,,,0,0,0,,,,,,
555,297,715,555,298,715,,,0,-1,0,,,,,,
556,299,740,556,299,740,,,0,0,0,,,,,,
556,300,766,556,300,766,,,0,0,0,,,,,,
550,303,106,550,303,106,,,0,0,0,,,,,,
550,303,108,550,303,106,,,0,0,2,,,,,,
550,303,113,550,303,113,,,0,0,0,,,,,,
550,303,123,550,303,125,,,0,0,-2,,,,,,
550,303,137,550,303,137,,,0,0,0,,,,,,
550,303,152,550,303,153,,,0,0,-1,,,,,,
550,304,170,550,304,170,,,0,0,0,,,,,,
550,304,190,550,304,190,,,0,0,0,,,,,,
550,304,210,550,304,210,,,0,0,0,,,,,,
551,304,232,550,304,232,,,1,0,0,,,,,,
551,305,254,551,305,254,,,0,0,0,,,,,,
551,305,276,551,305,276,,,0,0,0,,,,,,
551,306,299,551,306,299,,,0,0,0,,,,,,
551,306,323,551,306,322,,,0,0,1,,,,,,
552,307,346,552,307,346,,,0,0,0,,,,,,
552,307,370,552,307,370,,,0,0,0,,,,,,
552,308,394,552,308,394,,,0,0,0,,,,,,
553,308,418,552,308,418,,,1,0,0,,,,,,
553,309,442,553,309,442,,,0,0,0,,,,,,
553,310,467,553,310,466,,,0,0,1,,,,,,
554,311,491,554,311,491,,,0,0,0,,,,,,
554,312,516,554,312,515,,,0,0,1,,,,,,
555,313,540,555,313,540,,,0,0,0,,,,,,
555,313,565,555,313,565,,,0,0,0,,,,,,
556,314,590,556,314,590,,,0,0,0,,,,,,
556,316,615,556,315,615,,,0,1,0,,,,,,
557,317,640,557,317,640,,,0,0,0,,,,,,
557,318,665,557,318,665,,,0,0,0,,,,,,
558,319,691,558,319,691,,,0,0,0,,,,,,
558,320,716,558,320,716,,,0,0,0,,,,,,
559,322,741,559,322,741,,,0,0,0,,,,,,
560,323,766,559,323,766,,,1,0,0,,,,,,
554,328,111,554,328,111,,,0,0,0,,,,,,
554,328,113,554,328,111,,,0,0,2,,,,,,
554,328,118,554,328,118,,,0,0,0,,,,,,
554,328,128,554,328,129,,,0,0,-1,,,,,,
554,328,140,554,328,141,,,0,0,-1,,,,,,
554,328,156,554,328,157,,,0,0,-1,,,,,,
554,329,173,554,329,173,,,0,0,0,,,,,,
554,329,193,554,329,193,,,0,0,0,,,,,,
554,329,213,554,329,212,,,0,0,1,,,,,,
554,329,234,554,329,234,,,0,0,0,,,,,,
555,330,256,555,330,256,,,0,0,0,,,,,,
555,330,278,555,330,278,,,0,0,0,,,,,,
555,330,301,555,331,301,,,0,-1,0,,,,,,
555,331,324,555,331,324,,,0,0,0,,,,,,
555,331,347,556,332,347,,,-1,-1,0,,,,,,
556,332,371,556,332,371,,,0,0,0,,,,,,
556,332,395,556,333,395,,,0,-1,0,,,,,,
556,333,419,556,333,419,,,0,0,0,,,,,,
557,334,443,557,334,443,,,0,0,0,,,,,,
557,334,468,557,334,467,,,0,0,1,,,,,,
558,335,492,558,335,492,,,0,0,0,,,,,,
558,336,517,558,336,516,,,0,0,1,,,,,,
558,337,541,559,337,541,,,-1,0,0,,,,,,
559,338,566,559,338,566,,,0,0,0,,,,,,
559,339,591,560,338,591,,,-1,1,0,,,,,,
560,340,616,560,339,616,,,0,1,0,,,,,,
560,341,641,561,341,641,,,-1,0,0,,,,,,
561,342,666,561,342,666,,,0,0,0,,,,,,
562,343,691,562,343,691,,,0,0,0,,,,,,
562,344,716,562,344,716,,,0,0,0,,,,,,
563,345,742,563,345,741,,,0,0,1,,,,,,
564,346,767,563,346,767,,,1,0,0,,,,,,
558,354,117,558,354,117,,,0,0,0,,,,,,
558,354,118,558,354,117,,,0,0,1,,,,,,
558,354,123,558,354,123,,,0,0,0,,,,,,
558,354,132,558,354,134,,,0,0,-2,,,,,,
558,354,145,558,354,145,,,0,0,0,,,,,,
558,354,160,558,354,161,,,0,0,-1,,,,,,
558,354,177,558,354,177,,,0,0,0,,,,,,
558,354,196,558,354,196,,,0,0,0,,,,,,
559,355,215,559,355,215,,,0,0,0,,,,,,
559,355,236,559,355,236,,,0,0,0,,,,,,
559,355,258,559,355,258,,,0,0,0,,,,,,
559,356,280,559,355,280,,,0,1,0,,,,,,
559,356,303,559,356,303,,,0,0,0,,,,,,
560,356,326,559,356,326,,,1,0,0,,,,,,
560,357,349,560,357,349,,,0,0,0,,,,,,
560,357,373,560,357,372,,,0,0,1,,,,,,
560,358,396,560,358,396,,,0,0,0,,,,,,
561,358,420,560,358,420,,,1,0,0,,,,,,
561,359,444,561,359,444,,,0,0,0,,,,,,
561,360,469,561,359,468,,,0,1,1,,,,,,
562,360,493,562,360,493,,,0,0,0,,,,,,
562,361,518,562,361,517,,,0,0,1,,,,,,
563,362,542,563,362,542,,,0,0,0,,,,,,
563,363,567,563,362,567,,,0,1,0,,,,,,
564,363,592,564,363,592,,,0,0,0,,,,,,
564,364,617,564,364,617,,,0,0,0,,,,,,
565,365,642,565,365,642,,,0,0,0,,,,,,
565,366,667,565,366,667,,,0,0,0,,,,,,
566,367,692,566,367,692,,,0,0,0,,,,,,
567,368,717,566,368,717,,,1,0,0,,,,,,
567,369,742,567,369,742,,,0,0,0,,,,,,
568,371,768,568,370,767,,,0,1,1,,,,,,
563,380,122,563,380,122,,,0,0,0,,,,,,
563,380,124,563,380,122,,,0,0,2,,,,,,
563,380,128,563,380,128,,,0,0,0,,,,,,
563,380,137,563,380,139,,,0,0,-2,,,,,,
563,380,149,563,380,149,,,0,0,0,,,,,,
563,380,164,563,380,165,,,0,0,-1,,,,,,
563,380,180,563,380,180,,,0,0,0,,,,,,
563,381,199,563,380,199,,,0,1,0,,,,,,
563,381,218,563,381,218,,,0,0,0,,,,,,
563,381,239,563,381,239,,,0,0,0,,,,,,
564,381,260,564,381,260,,,0,0,0,,,,,,
564,382,282,564,381,282,,,0,1,0,,,,,,
564,382,305,564,382,305,,,0,0,0,,,,,,
564,382,328,564,382,328,,,0,0,0,,,,,,
565,383,351,565,383,351,,,0,0,0,,,,,,
565,383,374,565,383,374,,,0,0,0,,,,,,
565,384,398,565,384,397,,,0,0,1,,,,,,
565,384,422,565,384,421,,,0,0,1,,,,,,
566,385,446,566,385,445,,,0,0,1,,,,,,
566,385,470,566,385,470,,,0,0,0,,,,,,
567,386,494,567,386,494,,,0,0,0,,,,,,
567,387,519,567,386,518,,,0,1,1,,,,,,
567,387,543,567,387,543,,,0,0,0,,,,,,
568,388,568,568,388,568,,,0,0,0,,,,,,
568,389,593,568,389,593,,,0,0,0,,,,,,
569,390,618,569,389,618,,,0,1,0,,,,,,
569,391,643,569,390,643,,,0,1,0,,,,,,
570,392,668,570,391,668,,,0,1,0,,,,,,
571,392,693,571,392,693,,,0,0,0,,,,,,
571,393,718,571,393,718,,,0,0,0,,,,,,
572,394,743,572,394,743,,,0,0,0,,,,,,
572,396,768,572,395,768,,,0,1,0,,,,,,
568,407,128,568,407,128,,,0,0,0,,,,,,
568,407,129,568,407,128,,,0,0,1,,,,,,
568,407,134,568,407,134,,,0,0,0,,,,,,
568,407,142,568,407,144,,,0,0,-2,,,,,,
568,407,154,568,407,154,,,0,0,0,,,,,,
568,407,168,568,407,169,,,0,0,-1,,,,,,
568,407,184,568,407,184,,,0,0,0,,,,,,
568,407,202,568,407,202,,,0,0,0,,,,,,
568,407,221,568,407,221,,,0,0,0,,,,,,
569,408,242,568,407,242,,,1,1,0,,,,,,
569,408,263,569,408,263,,,0,0,0,,,,,,
569,408,285,569,408,285,,,0,0,0,,,,,,
569,408,307,569,408,307,,,0,0,0,,,,,,
569,409,330,569,408,330,,,0,1,0,,,,,,
570,409,353,570,409,353,,,0,0,0,,,,,,
570,410,376,570,409,376,,,0,1,0,,,,,,
570,410,399,570,410,399,,,0,0,0,,,,,,
571,410,423,570,410,423,,,1,0,0,,,,,,
571,411,447,571,411,447,,,0,0,0,,,,,,
571,412,471,571,411,471,,,0,1,0,,,,,,
572,412,496,572,412,496,,,0,0,0,,,,,,
572,413,520,572,412,520,,,0,1,0,,,,,,
572,413,544,572,413,544,,,0,0,0,,,,,,
573,414,569,572,414,569,,,1,0,0,,,,,,
573,415,594,573,415,594,,,0,0,0,,,,,,
574,416,619,573,415,619,,,1,1,0,,,,,,
574,416,644,574,416,644,,,0,0,0,,,,,,
575,417,668,575,417,669,,,0,0,-1,,,,,,
576,418,694,576,418,694,,,0,0,0,,,,,,
576,419,719,576,419,719,,,0,0,0,,,,,,
577,420,744,577,420,744,,,0,0,0,,,,,,
578,421,769,577,421,769,,,1,0,0,,,,,,
574,433,134,573,434,134,,,1,-1,0,,,,,,
574,433,135,573,434,134,,,1,-1,1,,,,,,
574,433,140,573,434,140,,,1,-1,0,,,,,,
574,434,148,573,434,149,,,1,0,-1,,,,,,
574,434,159,574,434,159,,,0,0,0,,,,,,
574,434,172,574,434,173,,,0,0,-1,,,,,,
574,434,188,574,434,188,,,0,0,0,,,,,,
574,434,206,574,434,206,,,0,0,0,,,,,,
574,434,225,574,434,224,,,0,0,1,,,,,,
574,434,245,574,434,245,,,0,0,0,,,,,,
574,435,266,574,435,266,,,0,0,0,,,,,,
574,435,287,574,435,287,,,0,0,0,,,,,,
575,435,309,575,435,309,,,0,0,0,,,,,,
575,435,332,575,435,332,,,0,0,0,,,,,,
575,436,355,575,436,355,,,0,0,0,,,,,,
575,436,378,575,436,378,,,0,0,0,,,,,,
576,437,401,576,437,401,,,0,0,0,,,,,,
576,437,425,576,437,424,,,0,0,1,,,,,,
576,438,449,576,438,448,,,0,0,1,,,,,,
577,438,473,577,438,472,,,0,0,1,,,,,,
577,439,497,577,439,497,,,0,0,0,,,,,,
578,439,521,577,439,521,,,1,0,0,,,,,,
578,440,546,578,440,545,,,0,0,1,,,,,,
578,441,570,578,440,570,,,0,1,0,,,,,,
579,441,595,579,441,595,,,0,0,0,,,,,,
579,442,620,579,442,620,,,0,0,0,,,,,,
580,443,645,580,442,645,,,0,1,0,,,,,,
581,443,669,580,443,669,,,1,0,0,,,,,,
581,444,694,581,444,694,,,0,0,0,,,,,,
582,445,720,582,445,719,,,0,0,1,,,,,,
582,446,745,582,446,745,,,0,0,0,,,,,,
583,447,770,583,447,770,,,0,0,0,,,,,,
579,461,140,579,461,140,,,0,0,0,,,,,,
579,461,141,579,461,140,,,0,0,1,,,,,,
579,461,146,579,461,146,,,0,0,0,,,,,,
580,461,153,579,461,155,,,1,0,-2,,,,,,
580,461,164,580,461,164,,,0,0,0,,,,,,
580,461,177,580,461,178,,,0,0,-1,,,,,,
580,461,193,580,461,193,,,0,0,0,,,,,,
580,461,210,580,461,210,,,0,0,0,,,,,,
580,461,228,580,461,228,,,0,0,0,,,,,,
580,461,248,580,461,248,,,0,0,0,,,,,,
580,462,269,580,462,269,,,0,0,0,,,,,,
580,462,290,580,462,290,,,0,0,0,,,,,,
581,462,312,581,462,312,,,0,0,0,,,,,,
581,463,334,581,462,334,,,0,1,0,,,,,,
581,463,357,581,463,357,,,0,0,0,,,,,,
581,463,380,581,463,380,,,0,0,0,,,,,,
582,464,403,582,464,403,,,0,0,0,,,,,,
582,464,427,582,464,426,,,0,0,1,,,,,,
582,465,450,582,465,450,,,0,0,0,,,,,,
583,465,474,582,465,474,,,1,0,0,,,,,,
583,466,498,583,466,498,,,0,0,0,,,,,,
583,466,523,583,466,522,,,0,0,1,,,,,,
584,467,547,584,467,547,,,0,0,0,,,,,,
584,467,572,584,467,571,,,0,0,1,,,,,,
585,468,596,585,468,596,,,0,0,0,,,,,,
585,469,621,585,468,621,,,0,1,0,,,,,,
586,469,646,586,469,646,,,0,0,0,,,,,,
586,470,671,586,470,670,,,0,0,1,,,,,,
587,471,695,587,471,695,,,0,0,0,,,,,,
588,472,721,587,471,720,,,1,1,1,,,,,,
588,472,746,588,472,746,,,0,0,0,,,,,,
589,473,771,588,473,771,,,1,0,0,,,,,,
586,488,147,586,488,146,,,0,0,1,,,,,,
586,488,148,586,488,146,,,0,0,2,,,,,,
586,488,152,586,488,152,,,0,0,0,,,,,,
586,488,159,586,488,160,,,0,0,-1,,,,,,
586,488,169,586,488,169,,,0,0,0,,,,,,
586,488,182,586,488,183,,,0,0,-1,,,,,,
586,488,197,586,488,197,,,0,0,0,,,,,,
586,489,214,586,488,214,,,0,1,0,,,,,,
586,489,232,586,488,232,,,0,1,0,,,,,,
586,489,251,586,489,252,,,0,0,-1,,,,,,
587,489,272,586,489,272,,,1,0,0,,,,,,
587,489,293,587,489,293,,,0,0,0,,,,,,
587,490,314,587,489,314,,,0,1,0,,,,,,
587,490,336,587,490,336,,,0,0,0,,,,,,
587,490,359,587,490,359,,,0,0,0,,,,,,
588,491,382,588,490,382,,,0,1,0,,,,,,
588,491,405,588,491,405,,,0,0,0,,,,,,
588,491,428,588,491,428,,,0,0,0,,,,,,
589,492,452,588,492,452,,,1,0,0,,,,,,
589,492,476,589,492,476,,,0,0,0,,,,,,
589,493,500,589,493,500,,,0,0,0,,,,,,
590,493,524,590,493,524,,,0,0,0,,,,,,
590,494,548,590,494,548,,,0,0,0,,,,,,
591,494,573,591,494,573,,,0,0,0,,,,,,
591,495,597,591,495,597,,,0,0,0,,,,,,
592,496,622,592,495,622,,,0,1,0,,,,,,
592,496,647,592,496,647,,,0,0,0,,,,,,
593,497,672,593,497,671,,,0,0,1,,,,,,
593,498,697,593,498,696,,,0,0,1,,,,,,
594,498,722,594,498,721,,,0,0,1,,,,,,
594,499,747,594,499,747,,,0,0,0,,,,,,
595,500,772,595,500,772,,,0,0,0,,,,,,
593,516,153,593,516,153,,,0,0,0,,,,,,
593,516,154,593,516,153,,,0,0,1,,,,,,
593,516,158,593,516,158,,,0,0,0,,,,,,
593,516,165,593,516,166,,,0,0,-1,,,,,,
593,516,175,593,516,175,,,0,0,0,,,,,,
593,516,187,593,516,188,,,0,0,-1,,,,,,
593,516,202,593,516,202,,,0,0,0,,,,,,
593,516,218,593,516,219,,,0,0,-1,,,,,,
593,516,236,593,516,236,,,0,0,0,,,,,,
593,516,255,593,516,255,,,0,0,0,,,,,,
593,517,275,593,517,275,,,0,0,0,,,,,,
593,517,296,593,517,296,,,0,0,0,,,,,,
594,517,317,594,517,317,,,0,0,0,,,,,,
594,517,339,594,517,339,,,0,0,0,,,,,,
594,518,361,594,518,361,,,0,0,0,,,,,,
594,518,384,594,518,384,,,0,0,0,,,,,,
595,518,407,595,518,407,,,0,0,0,,,,,,
595,519,430,595,518,430,,,0,1,0,,,,,,
595,519,454,595,519,454,,,0,0,0,,,,,,
596,520,478,595,519,478,,,1,1,0,,,,,,
596,520,502,596,520,502,,,0,0,0,,,,,,
596,521,526,596,520,526,,,0,1,0,,,,,,
597,521,550,597,521,550,,,0,0,0,,,,,,
597,522,574,597,521,574,,,0,1,0,,,,,,
598,522,599,598,522,599,,,0,0,0,,,,,,
598,523,623,598,522,623,,,0,1,0,,,,,,
599,523,648,599,523,648,,,0,0,0,,,,,,
599,524,673,599,524,673,,,0,0,0,,,,,,
600,525,698,600,525,698,,,0,0,0,,,,,,
600,525,723,600,525,723,,,0,0,0,,,,,,
601,526,748,601,526,748,,,0,0,0,,,,,,
602,527,773,601,527,773,,,1,0,0,,,,,,
600,544,160,600,544,160,,,0,0,0,,,,,,
600,544,161,600,544,160,,,0,0,1,,,,,,
600,544,165,600,544,164,,,0,0,1,,,,,,
600,544,171,600,544,172,,,0,0,-1,,,,,,
600,544,181,600,544,181,,,0,0,0,,,,,,
600,544,193,600,544,194,,,0,0,-1,,,,,,
600,544,207,600,544,207,,,0,0,0,,,,,,
600,544,223,600,544,223,,,0,0,0,,,,,,
600,544,240,600,544,240,,,0,0,0,,,,,,
600,544,259,600,544,259,,,0,0,0,,,,,,
600,544,279,600,544,278,,,0,0,1,,,,,,
601,545,299,600,544,299,,,1,1,0,,,,,,
601,545,320,601,545,320,,,0,0,0,,,,,,
601,545,342,601,545,342,,,0,0,0,,,,,,
601,545,364,601,545,364,,,0,0,0,,,,,,
601,546,387,601,545,386,,,0,1,1,,,,,,
602,546,409,602,546,409,,,0,0,0,,,,,,
602,546,433,602,546,432,,,0,0,1,,,,,,
602,547,456,602,547,456,,,0,0,0,,,,,,
603,547,480,602,547,479,,,1,0,1,,,,,,
603,548,503,603,547,503,,,0,1,0,,,,,,
603,548,527,603,548,527,,,0,0,0,,,,,,
604,549,552,604,548,551,,,0,1,1,,,,,,
604,549,576,604,549,576,,,0,0,0,,,,,,
605,550,600,605,549,600,,,0,1,0,,,,,,
605,550,625,605,550,625,,,0,0,0,,,,,,
606,551,649,606,550,649,,,0,1,0,,,,,,
606,551,674,606,551,674,,,0,0,0,,,,,,
607,552,699,607,552,699,,,0,0,0,,,,,,
607,553,724,607,553,724,,,0,0,0,,,,,,
608,553,749,608,553,749,,,0,0,0,,,,,,
609,554,774,608,554,774,,,1,0,0,,,,,,
607,572,167,607,572,167,,,0,0,0,,,,,,
607,572,168,607,572,167,,,0,0,1,,,,,,
607,572,171,607,572,171,,,0,0,0,,,,,,
607,572,177,607,572,179,,,0,0,-2,,,,,,
607,572,187,607,572,187,,,0,0,0,,,,,,
607,572,198,607,572,199,,,0,0,-1,,,,,,
607,572,212,607,572,212,,,0,0,0,,,,,,
607,572,228,607,572,228,,,0,0,0,,,,,,
607,572,245,607,572,245,,,0,0,0,,,,,,
608,572,263,607,572,263,,,1,0,0,,,,,,
608,572,282,608,572,282,,,0,0,0,,,,,,
608,573,302,608,572,302,,,0,1,0,,,,,,
608,573,323,608,573,323,,,0,0,0,,,,,,
608,573,345,608,573,345,,,0,0,0,,,,,,
609,573,367,609,573,367,,,0,0,0,,,,,,
609,574,389,609,573,389,,,0,1,0,,,,,,
609,574,412,609,574,412,,,0,0,0,,,,,,
609,574,435,609,574,435,,,0,0,0,,,,,,
610,575,458,610,575,458,,,0,0,0,,,,,,
610,575,482,610,575,481,,,0,0,1,,,,,,
610,575,505,610,575,505,,,0,0,0,,,,,,
611,576,529,610,575,529,,,1,1,0,,,,,,
611,576,553,611,576,553,,,0,0,0,,,,,,
612,577,578,611,576,577,,,1,1,1,,,,,,
612,577,602,612,577,602,,,0,0,0,,,,,,
613,578,626,612,577,626,,,1,1,0,,,,,,
613,578,651,613,578,651,,,0,0,0,,,,,,
614,579,676,613,579,675,,,1,0,1,,,,,,
614,580,700,614,580,700,,,0,0,0,,,,,,
615,580,725,614,580,725,,,1,0,0,,,,,,
615,581,750,615,581,750,,,0,0,0,,,,,,
616,582,775,616,581,775,,,0,1,0,,,,,,
615,600,173,615,600,173,,,0,0,0,,,,,,
615,600,174,615,600,173,,,0,0,1,,,,,,
615,600,178,615,600,178,,,0,0,0,,,,,,
615,600,184,615,600,185,,,0,0,-1,,,,,,
615,600,193,615,600,193,,,0,0,0,,,,,,
615,600,204,615,600,205,,,0,0,-1,,,,,,
615,600,217,615,600,217,,,0,0,0,,,,,,
615,600,232,615,600,233,,,0,0,-1,,,,,,
615,600,249,615,600,249,,,0,0,0,,,,,,
615,600,267,615,600,267,,,0,0,0,,,,,,
616,601,286,616,600,286,,,0,1,0,,,,,,
616,601,306,616,600,306,,,0,1,0,,,,,,
616,601,327,616,601,326,,,0,0,1,,,,,,
616,601,348,616,601,348,,,0,0,0,,,,,,
616,601,370,616,601,370,,,0,0,0,,,,,,
617,602,392,616,601,392,,,1,1,0,,,,,,
617,602,414,617,602,414,,,0,0,0,,,,,,
617,602,437,617,602,437,,,0,0,0,,,,,,
617,603,460,618,603,460,,,-1,0,0,,,,,,
618,603,484,618,603,484,,,0,0,0,,,,,,
618,603,507,618,603,507,,,0,0,0,,,,,,
619,604,531,618,603,531,,,1,1,0,,,,,,
619,604,555,619,604,555,,,0,0,0,,,,,,
619,605,579,619,604,579,,,0,1,0,,,,,,
620,605,604,620,605,603,,,0,0,1,,,,,,
620,606,628,620,605,628,,,0,1,0,,,,,,
621,606,652,621,606,652,,,0,0,0,,,,,,
621,607,677,621,606,677,,,0,1,0,,,,,,
622,607,702,622,607,701,,,0,0,1,,,,,,
622,608,727,622,608,726,,,0,0,1,,,,,,
623,609,751,623,608,751,,,0,1,0,,,,,,
624,609,776,623,609,776,,,1,0,0,,,,,,
623,628,180,623,628,180,,,0,0,0,,,,,,
623,628,181,623,628,180,,,0,0,1,,,,,,
623,628,185,623,628,185,,,0,0,0,,,,,,
623,628,190,623,628,192,,,0,0,-2,,,,,,
623,628,199,623,628,199,,,0,0,0,,,,,,
623,628,210,623,628,211,,,0,0,-1,,,,,,
623,628,223,623,628,223,,,0,0,0,,,,,,
623,628,237,623,628,238,,,0,0,-1,,,,,,
623,628,254,623,628,254,,,0,0,0,,,,,,
624,629,271,623,628,272,,,1,1,-1,,,,,,
624,629,290,624,629,290,,,0,0,0,,,,,,
624,629,310,624,629,310,,,0,0,0,,,,,,
624,629,330,624,629,330,,,0,0,0,,,,,,
624,629,351,624,629,351,,,0,0,0,,,,,,
624,630,373,624,630,373,,,0,0,0,,,,,,
625,630,395,624,630,395,,,1,0,0,,,,,,
625,630,417,625,630,417,,,0,0,0,,,,,,
625,630,440,625,630,440,,,0,0,0,,,,,,
626,631,463,626,631,463,,,0,0,0,,,,,,
626,631,486,626,631,486,,,0,0,0,,,,,,
626,631,510,626,631,510,,,0,0,0,,,,,,
627,632,533,626,631,533,,,1,1,0,,,,,,
627,632,557,627,632,557,,,0,0,0,,,,,,
627,633,581,627,632,581,,,0,1,0,,,,,,
628,633,605,628,633,605,,,0,0,0,,,,,,
628,634,630,628,633,629,,,0,1,1,,,,,,
629,634,654,629,634,654,,,0,0,0,,,,,,
629,635,679,629,634,678,,,0,1,1,,,,,,
630,635,703,630,635,703,,,0,0,0,,,,,,
630,636,728,630,635,728,,,0,1,0,,,,,,
631,636,753,631,636,753,,,0,0,0,,,,,,
632,637,778,631,637,778,,,1,0,0,,,,,,
631,656,187,631,656,187,,,0,0,0,,,,,,
631,656,188,631,656,187,,,0,0,1,,,,,,
631,656,191,631,656,191,,,0,0,0,,,,,,
631,656,197,631,656,198,,,0,0,-1,,,,,,
632,657,205,631,656,205,,,1,1,0,,,,,,
632,657,216,631,656,217,,,1,1,-1,,,,,,
632,657,228,631,656,228,,,1,1,0,,,,,,
632,657,243,631,656,243,,,1,1,0,,,,,,
632,657,259,632,656,259,,,0,1,0,,,,,,
632,657,276,632,657,276,,,0,0,0,,,,,,
632,657,294,632,657,294,,,0,0,0,,,,,,
632,657,314,632,657,314,,,0,0,0,,,,,,
632,658,334,632,657,334,,,0,1,0,,,,,,
633,658,355,632,657,355,,,1,1,0,,,,,,
633,658,376,633,658,376,,,0,0,0,,,,,,
633,658,398,633,658,398,,,0,0,0,,,,,,
633,658,420,633,658,420,,,0,0,0,,,,,,
634,659,442,634,658,442,,,0,1,0,,,,,,
634,659,465,634,659,465,,,0,0,0,,,,,,
634,659,488,634,659,488,,,0,0,0,,,,,,
635,660,512,634,659,512,,,1,1,0,,,,,,
635,660,535,635,660,535,,,0,0,0,,,,,,
635,661,559,635,660,559,,,0,1,0,,,,,,
636,661,583,636,661,583,,,0,0,0,,,,,,
636,661,607,636,661,607,,,0,0,0,,,,,,
637,662,631,637,662,631,,,0,0,0,,,,,,
637,662,656,637,662,656,,,0,0,0,,,,,,
638,663,680,638,663,680,,,0,0,0,,,,,,
638,663,705,638,663,704,,,0,0,1,,,,,,
639,664,730,639,664,729,,,0,0,1,,,,,,
639,664,754,639,664,754,,,0,0,0,,,,,,
640,665,779,640,665,779,,,0,0,0,,,,,,
640,685,195,640,685,195,,,0,0,0,,,,,,
640,685,195,640,685,195,,,0,0,0,,,,,,
640,685,198,640,685,198,,,0,0,0,,,,,,
640,685,204,640,685,205,,,0,0,-1,,,,,,
640,685,212,640,685,212,,,0,0,0,,,,,,
640,685,222,640,685,223,,,0,0,-1,,,,,,
640,685,234,640,685,234,,,0,0,0,,,,,,
641,685,248,640,685,249,,,1,0,-1,,,,,,
641,685,264,641,685,264,,,0,0,0,,,,,,
641,686,281,641,685,281,,,0,1,0,,,,,,
641,686,299,641,686,299,,,0,0,0,,,,,,
641,686,318,641,686,318,,,0,0,0,,,,,,
641,686,338,641,686,338,,,0,0,0,,,,,,
641,686,358,641,686,358,,,0,0,0,,,,,,
642,686,379,642,686,379,,,0,0,0,,,,,,
642,687,401,642,686,401,,,0,1,0,,,,,,
642,687,423,642,687,423,,,0,0,0,,,,,,
642,687,445,642,687,445,,,0,0,0,,,,,,
643,687,468,643,687,468,,,0,0,0,,,,,,
643,688,491,643,687,491,,,0,1,0,,,,,,
643,688,514,643,688,514,,,0,0,0,,,,,,
644,688,538,643,688,537,,,1,0,1,,,,,,
644,689,561,644,689,561,,,0,0,0,,,,,,
645,689,585,644,689,585,,,1,0,0,,,,,,
645,690,609,645,690,609,,,0,0,0,,,,,,
645,690,633,645,690,633,,,0,0,0,,,,,,
646,691,658,646,691,658,,,0,0,0,,,,,,
646,691,682,646,691,682,,,0,0,0,,,,,,
647,692,706,647,692,706,,,0,0,0,,,,,,
647,692,731,647,692,731,,,0,0,0,,,,,,
648,693,756,648,693,756,,,0,0,0,,,,,,
649,693,781,648,693,780,,,1,0,1,,,,,,
649,714,202,649,713,202,,,0,1,0,,,,,,
649,714,203,649,713,202,,,0,1,1,,,,,,
649,714,205,649,713,205,,,0,1,0,,,,,,
649,714,211,649,713,211,,,0,1,0,,,,,,
649,714,218,649,713,218,,,0,1,0,,,,,,
649,714,228,649,713,229,,,0,1,-1,,,,,,
650,714,240,649,714,240,,,1,0,0,,,,,,
650,714,254,649,714,254,,,1,0,0,,,,,,
650,714,269,650,714,269,,,0,0,0,,,,,,
650,714,285,650,714,286,,,0,0,-1,,,,,,
650,714,303,650,714,303,,,0,0,0,,,,,,
650,714,322,650,714,322,,,0,0,0,,,,,,
650,715,342,650,714,342,,,0,1,0,,,,,,
651,715,362,650,714,362,,,1,1,0,,,,,,
651,715,383,651,715,382,,,0,0,1,,,,,,
651,715,404,651,715,404,,,0,0,0,,,,,,
651,715,426,651,715,426,,,0,0,0,,,,,,
652,716,448,651,715,448,,,1,1,0,,,,,,
652,716,471,652,716,471,,,0,0,0,,,,,,
652,716,494,652,716,493,,,0,0,1,,,,,,
652,717,517,652,716,516,,,0,1,1,,,,,,
653,717,540,653,717,540,,,0,0,0,,,,,,
653,717,564,653,717,563,,,0,0,1,,,,,,
654,718,587,653,718,587,,,1,0,0,,,,,,
654,718,611,654,718,611,,,0,0,0,,,,,,
654,718,635,654,718,635,,,0,0,0,,,,,,
655,719,659,655,719,659,,,0,0,0,,,,,,
655,719,684,655,719,683,,,0,0,1,,,,,,
656,720,708,656,720,708,,,0,0,0,,,,,,
656,720,733,656,720,732,,,0,0,1,,,,,,
657,721,757,657,721,757,,,0,0,0,,,,,,
658,721,782,657,721,782,,,1,0,0,,,,,,
659,742,209,659,742,209,,,0,0,0,,,,,,
659,742,210,659,742,209,,,0,0,1,,,,,,
659,742,212,659,742,212,,,0,0,0,,,,,,
659,742,217,659,742,218,,,0,0,-1,,,,,,
659,742,225,659,742,225,,,0,0,0,,,,,,
659,742,234,659,742,235,,,0,0,-1,,,,,,
659,743,246,659,743,246,,,0,0,0,,,,,,
659,743,259,659,743,260,,,0,0,-1,,,,,,
659,743,274,659,743,274,,,0,0,0,,,,,,
659,743,290,659,743,291,,,0,0,-1,,,,,,
659,743,308,659,743,308,,,0,0,0,,,,,,
660,743,326,659,743,327,,,1,0,-1,,,,,,
660,743,346,660,743,346,,,0,0,0,,,,,,
660,743,366,660,743,366,,,0,0,0,,,,,,
660,744,386,660,744,386,,,0,0,0,,,,,,
660,744,407,660,744,407,,,0,0,0,,,,,,
661,744,429,661,744,429,,,0,0,0,,,,,,
661,744,451,661,744,451,,,0,0,0,,,,,,
661,745,474,661,745,474,,,0,0,0,,,,,,
661,745,496,661,745,496,,,0,0,0,,,,,,
662,745,519,662,745,519,,,0,0,0,,,,,,
662,746,542,662,745,542,,,0,1,0,,,,,,
663,746,566,663,746,566,,,0,0,0,,,,,,
663,746,590,663,746,589,,,0,0,1,,,,,,
663,747,613,663,747,613,,,0,0,0,,,,,,
664,747,637,663,747,637,,,1,0,0,,,,,,
664,747,661,664,747,661,,,0,0,0,,,,,,
665,748,686,664,747,685,,,1,1,1,,,,,,
665,748,710,665,748,710,,,0,0,0,,,,,,
666,749,735,665,748,734,,,1,1,1,,,,,,
666,749,759,666,749,759,,,0,0,0,,,,,,
667,750,784,666,749,784,,,1,1,0,,,,,,
668,771,216,668,771,216,,,0,0,0,,,,,,
668,771,217,668,771,216,,,0,0,1,,,,,,
668,771,220,668,771,219,,,0,0,1,,,,,,
668,771,224,668,771,225,,,0,0,-1,,,,,,
668,771,232,668,771,231,,,0,0,1,,,,,,
669,771,241,668,771,241,,,1,0,0,,,,,,
669,771,252,669,771,252,,,0,0,0,,,,,,
669,771,265,669,771,265,,,0,0,0,,,,,,
669,772,280,669,771,279,,,0,1,1,,,,,,
669,772,296,669,771,296,,,0,1,0,,,,,,
669,772,313,669,772,313,,,0,0,0,,,,,,
669,772,331,669,772,331,,,0,0,0,,,,,,
669,772,350,669,772,350,,,0,0,0,,,,,,
670,772,370,669,772,370,,,1,0,0,,,,,,
670,772,390,670,772,390,,,0,0,0,,,,,,
670,773,411,670,772,411,,,0,1,0,,,,,,
670,773,432,670,773,432,,,0,0,0,,,,,,
671,773,454,670,773,454,,,1,0,0,,,,,,
671,773,477,671,773,477,,,0,0,0,,,,,,
671,774,499,671,773,499,,,0,1,0,,,,,,
671,774,522,671,774,522,,,0,0,0,,,,,,
672,774,545,672,774,545,,,0,0,0,,,,,,
672,775,568,672,774,568,,,0,1,0,,,,,,
673,775,592,672,775,592,,,1,0,0,,,,,,
673,775,616,673,775,615,,,0,0,1,,,,,,
673,776,639,673,775,639,,,0,1,0,,,,,,
674,776,663,674,776,663,,,0,0,0,,,,,,
674,776,688,674,776,687,,,0,0,1,,,,,,
675,777,712,675,777,712,,,0,0,0,,,,,,
675,777,736,675,777,736,,,0,0,0,,,,,,
676,778,761,676,777,761,,,0,1,0,,,,,,
676,778,785,676,778,785,,,0,0,0,,,,,,
678,800,224,678,800,224,,,0,0,0,,,,,,
678,800,224,678,800,224,,,0,0,0,,,,,,
678,800,227,678,800,227,,,0,0,0,,,,,,
678,800,232,678,800,232,,,0,0,0,,,,,,
678,800,238,678,800,238,,,0,0,0,,,,,,
678,800,247,678,800,248,,,0,0,-1,,,,,,
679,800,258,679,800,258,,,0,0,0,,,,,,
679,800,271,679,800,271,,,0,0,0,,,,,,
679,800,285,679,800,285,,,0,0,0,,,,,,
679,800,301,679,800,301,,,0,0,0,,,,,,
679,801,318,679,801,318,,,0,0,0,,,,,,
679,801,335,679,801,336,,,0,0,-1,,,,,,
679,801,354,679,801,354,,,0,0,0,,,,,,
680,801,374,679,801,374,,,1,0,0,,,,,,
680,801,394,680,801,394,,,0,0,0,,,,,,
680,801,415,680,801,415,,,0,0,0,,,,,,
680,802,436,680,802,436,,,0,0,0,,,,,,
680,802,458,680,802,458,,,0,0,0,,,,,,
681,802,480,681,802,480,,,0,0,0,,,,,,
681,802,502,681,802,502,,,0,0,0,,,,,,
681,803,525,681,803,525,,,0,0,0,,,,,,
682,803,548,681,803,548,,,1,0,0,,,,,,
682,803,571,682,803,571,,,0,0,0,,,,,,
682,804,594,682,803,594,,,0,1,0,,,,,,
683,804,618,683,804,618,,,0,0,0,,,,,,
683,804,642,683,804,642,,,0,0,0,,,,,,
684,805,666,684,805,666,,,0,0,0,,,,,,
684,805,690,684,805,690,,,0,0,0,,,,,,
685,806,714,685,806,714,,,0,0,0,,,,,,
685,806,738,685,806,738,,,0,0,0,,,,,,
686,806,763,686,806,763,,,0,0,0,,,,,,
686,807,787,686,806,787,,,0,1,0,,,,,,
689,829,231,688,829,231,,,1,0,0,,,,,,
689,829,232,688,829,231,,,1,0,1,,,,,,
689,829,234,688,829,234,,,1,0,0,,,,,,
689,829,239,688,829,239,,,1,0,0,,,,,,
689,829,245,688,829,245,,,1,0,0,,,,,,
689,829,254,688,829,254,,,1,0,0,,,,,,
689,829,265,689,829,264,,,0,0,1,,,,,,
689,829,277,689,829,277,,,0,0,0,,,,,,
689,829,291,689,829,291,,,0,0,0,,,,,,
689,829,306,689,829,307,,,0,0,-1,,,,,,
689,830,323,689,830,323,,,0,0,0,,,,,,
689,830,340,689,830,340,,,0,0,0,,,,,,
690,830,359,689,830,358,,,1,0,1,,,,,,
690,830,378,689,830,378,,,1,0,0,,,,,,
690,830,398,690,830,398,,,0,0,0,,,,,,
690,830,418,690,830,418,,,0,0,0,,,,,,
690,831,439,690,831,439,,,0,0,0,,,,,,
691,831,461,690,831,461,,,1,0,0,,,,,,
691,831,483,691,831,483,,,0,0,0,,,,,,
691,831,505,691,831,505,,,0,0,0,,,,,,
692,832,528,691,831,528,,,1,1,0,,,,,,
692,832,550,692,831,550,,,0,1,0,,,,,,
692,832,574,692,832,573,,,0,0,1,,,,,,
693,832,597,692,832,597,,,1,0,0,,,,,,
693,833,620,693,833,620,,,0,0,0,,,,,,
693,833,644,693,833,644,,,0,0,0,,,,,,
694,834,668,694,833,668,,,0,1,0,,,,,,
694,834,692,694,834,692,,,0,0,0,,,,,,
695,834,716,695,834,716,,,0,0,0,,,,,,
695,835,740,695,834,740,,,0,1,0,,,,,,
696,835,765,696,835,765,,,0,0,0,,,,,,
696,836,789,696,835,789,,,0,1,0,,,,,,
699,858,238,699,858,238,,,0,0,0,,,,,,
699,858,239,699,858,238,,,0,0,1,,,,,,
699,858,241,699,858,241,,,0,0,0,,,,,,
699,858,246,699,858,246,,,0,0,0,,,,,,
699,858,252,699,858,252,,,0,0,0,,,,,,
699,858,261,699,858,261,,,0,0,0,,,,,,
699,858,271,699,858,271,,,0,0,0,,,,,,
699,858,283,699,858,284,,,0,0,-1,,,,,,
699,858,297,699,858,297,,,0,0,0,,,,,,
700,858,312,699,858,312,,,1,0,0,,,,,,
700,859,328,700,859,328,,,0,0,0,,,,,,
700,859,345,700,859,345,,,0,0,0,,,,,,
700,859,363,700,859,363,,,0,0,0,,,,,,
700,859,382,700,859,382,,,0,0,0,,,,,,
700,859,402,700,859,402,,,0,0,0,,,,,,
701,859,422,700,859,422,,,1,0,0,,,,,,
701,860,443,701,860,443,,,0,0,0,,,,,,
701,860,464,701,860,464,,,0,0,0,,,,,,
701,860,486,701,860,486,,,0,0,0,,,,,,
702,860,508,701,860,508,,,1,0,0,,,,,,
702,860,531,702,860,531,,,0,0,0,,,,,,
702,861,553,702,860,553,,,0,1,0,,,,,,
703,861,576,703,861,576,,,0,0,0,,,,,,
703,861,599,703,861,599,,,0,0,0,,,,,,
703,862,623,703,862,623,,,0,0,0,,,,,,
704,862,646,703,862,646,,,1,0,0,,,,,,
704,862,670,704,862,670,,,0,0,0,,,,,,
705,863,694,704,862,694,,,1,1,0,,,,,,
705,863,718,705,863,718,,,0,0,0,,,,,,
706,864,742,705,863,742,,,1,1,0,,,,,,
706,864,767,706,864,767,,,0,0,0,,,,,,
707,864,791,706,864,791,,,1,0,0,,,,,,
710,887,246,710,887,245,,,0,0,1,,,,,,
710,887,246,710,887,245,,,0,0,1,,,,,,
710,887,249,710,887,248,,,0,0,1,,,,,,
710,887,253,710,887,253,,,0,0,0,,,,,,
710,887,259,710,887,259,,,0,0,0,,,,,,
710,887,267,710,887,268,,,0,0,-1,,,,,,
710,887,277,710,887,277,,,0,0,0,,,,,,
710,887,289,710,887,290,,,0,0,-1,,,,,,
710,887,302,710,887,302,,,0,0,0,,,,,,
710,888,317,710,887,317,,,0,1,0,,,,,,
710,888,333,710,888,333,,,0,0,0,,,,,,
711,888,350,710,888,350,,,1,0,0,,,,,,
711,888,368,711,888,368,,,0,0,0,,,,,,
711,888,387,711,888,387,,,0,0,0,,,,,,
711,888,406,711,888,406,,,0,0,0,,,,,,
711,888,426,711,888,426,,,0,0,0,,,,,,
712,889,447,711,889,447,,,1,0,0,,,,,,
712,889,468,711,889,468,,,1,0,0,,,,,,
712,889,490,712,889,489,,,0,0,1,,,,,,
712,889,511,712,889,511,,,0,0,0,,,,,,
713,889,534,713,889,534,,,0,0,0,,,,,,
713,890,556,713,889,556,,,0,1,0,,,,,,
713,890,579,713,890,579,,,0,0,0,,,,,,
714,890,602,713,890,602,,,1,0,0,,,,,,
714,891,625,714,891,625,,,0,0,0,,,,,,
714,891,649,714,891,649,,,0,0,0,,,,,,
715,891,673,715,891,672,,,0,0,1,,,,,,
715,892,696,715,891,696,,,0,1,0,,,,,,
716,892,720,716,892,720,,,0,0,0,,,,,,
716,892,744,716,892,744,,,0,0,0,,,,,,
717,893,769,717,893,769,,,0,0,0,,,,,,
717,893,793,717,893,793,,,0,0,0,,,,,,
561,155,85,560,155,85,,,1,0,0,,,,,,
561,155,87,560,155,85,,,1,0,2,,,,,,
561,155,94,560,155,94,,,1,0,0,,,,,,
561,155,106,560,155,107,,,1,0,-1,,,,,,
561,156,121,561,155,121,,,0,1,0,,,,,,
561,156,139,561,156,140,,,0,0,-1,,,,,,
561,156,159,561,156,159,,,0,0,0,,,,,,
561,157,180,561,157,180,,,0,0,0,,,,,,
561,157,201,561,157,201,,,0,0,0,,,,,,
561,158,224,561,158,224,,,0,0,0,,,,,,
561,159,247,561,158,246,,,0,1,1,,,,,,
562,159,270,561,159,269,,,1,0,1,,,,,,
562,160,293,562,160,293,,,0,0,0,,,,,,
562,161,317,562,161,317,,,0,0,0,,,,,,
562,162,341,562,162,341,,,0,0,0,,,,,,
563,164,365,562,163,365,,,1,1,0,,,,,,
563,165,389,563,165,389,,,0,0,0,,,,,,
563,166,414,563,166,414,,,0,0,0,,,,,,
564,168,438,563,168,438,,,1,0,0,,,,,,
564,169,463,564,169,463,,,0,0,0,,,,,,
564,171,488,564,171,487,,,0,0,1,,,,,,
565,172,512,565,172,512,,,0,0,0,,,,,,
565,174,537,565,174,537,,,0,0,0,,,,,,
566,176,562,566,175,562,,,0,1,0,,,,,,
566,178,587,566,177,587,,,0,1,0,,,,,,
567,180,613,567,179,612,,,0,1,1,,,,,,
567,182,638,567,181,637,,,0,1,1,,,,,,
568,184,663,568,183,663,,,0,1,0,,,,,,
568,186,688,568,186,688,,,0,0,0,,,,,,
569,188,713,569,188,713,,,0,0,0,,,,,,
570,191,739,569,191,738,,,1,0,1,,,,,,
570,193,764,570,193,764,,,0,0,0,,,,,,
561,156,85,560,155,85,,,1,1,0,,,,,,
561,156,87,560,155,85,,,1,1,2,,,,,,
561,157,94,560,155,94,,,1,2,0,,,,,,
561,157,106,560,155,107,,,1,2,-1,,,,,,
561,157,121,561,155,121,,,0,2,0,,,,,,
561,157,139,561,156,140,,,0,1,-1,,,,,,
561,158,159,561,156,159,,,0,2,0,,,,,,
561,158,180,561,157,180,,,0,1,0,,,,,,
561,159,201,561,157,201,,,0,2,0,,,,,,
561,159,224,561,158,224,,,0,1,0,,,,,,
562,160,247,561,158,246,,,1,2,1,,,,,,
562,161,270,561,159,269,,,1,2,1,,,,,,
562,162,293,562,160,293,,,0,2,0,,,,,,
562,163,317,562,161,317,,,0,2,0,,,,,,
562,164,341,562,162,341,,,0,2,0,,,,,,
563,165,365,562,163,365,,,1,2,0,,,,,,
563,166,389,563,165,389,,,0,1,0,,,,,,
563,167,414,563,166,414,,,0,1,0,,,,,,
564,169,438,563,168,438,,,1,1,0,,,,,,
564,170,463,564,169,463,,,0,1,0,,,,,,
564,172,488,564,171,487,,,0,1,1,,,,,,
565,174,513,565,172,512,,,0,2,1,,,,,,
565,175,537,565,174,537,,,0,1,0,,,,,,
566,177,562,566,175,562,,,0,2,0,,,,,,
566,179,587,566,177,587,,,0,2,0,,,,,,
567,181,613,567,179,612,,,0,2,1,,,,,,
567,183,638,567,181,637,,,0,2,1,,,,,,
568,185,663,568,183,663,,,0,2,0,,,,,,
568,187,688,568,186,688,,,0,1,0,,,,,,
569,189,713,569,188,713,,,0,1,0,,,,,,
570,192,739,569,191,738,,,1,1,1,,,,,,
570,194,764,570,193,764,,,0,1,0,,,,,,
561,162,86,561,161,86,,,0,1,0,,,,,,
561,162,88,561,161,86,,,0,1,2,,,,,,
561,162,95,561,161,94,,,0,1,1,,,,,,
561,162,106,561,161,108,,,0,1,-2,,,,,,
561,162,122,561,162,122,,,0,0,0,,,,,,
561,162,140,561,162,140,,,0,0,0,,,,,,
561,163,159,561,162,159,,,0,1,0,,,,,,
561,163,180,561,163,180,,,0,0,0,,,,,,
562,164,202,561,163,201,,,1,1,1,,,,,,
562,164,224,561,164,224,,,1,0,0,,,,,,
562,165,247,562,165,247,,,0,0,0,,,,,,
562,166,270,562,166,270,,,0,0,0,,,,,,
562,167,293,562,167,293,,,0,0,0,,,,,,
563,168,317,562,168,317,,,1,0,0,,,,,,
563,169,341,562,169,341,,,1,0,0,,,,,,
563,170,365,563,170,365,,,0,0,0,,,,,,
563,171,389,563,171,389,,,0,0,0,,,,,,
564,172,414,563,172,414,,,1,0,0,,,,,,
564,174,438,564,173,438,,,0,1,0,,,,,,
564,175,463,564,175,463,,,0,0,0,,,,,,
565,177,488,564,176,487,,,1,1,1,,,,,,
565,178,513,565,178,512,,,0,0,1,,,,,,
566,180,537,565,179,537,,,1,1,0,,,,,,
566,182,562,566,181,562,,,0,1,0,,,,,,
567,183,587,566,183,587,,,1,0,0,,,,,,
567,185,613,567,185,612,,,0,0,1,,,,,,
568,187,638,567,187,637,,,1,0,1,,,,,,
568,189,663,568,189,663,,,0,0,0,,,,,,
569,191,688,569,191,688,,,0,0,0,,,,,,
569,194,714,569,193,713,,,0,1,1,,,,,,
570,196,739,570,196,739,,,0,0,0,,,,,,
571,198,764,570,198,764,,,1,0,0,,,,,,
562,171,87,561,172,87,,,1,-1,0,,,,,,
562,171,89,561,172,87,,,1,-1,2,,,,,,
562,171,96,562,172,96,,,0,-1,0,,,,,,
562,171,107,562,172,109,,,0,-1,-2,,,,,,
562,171,123,562,172,123,,,0,-1,0,,,,,,
562,171,140,562,173,141,,,0,-2,-1,,,,,,
562,172,160,562,173,160,,,0,-1,0,,,,,,
562,172,180,562,174,181,,,0,-2,-1,,,,,,
562,173,202,562,174,202,,,0,-1,0,,,,,,
562,173,224,562,175,224,,,0,-2,0,,,,,,
563,174,247,562,175,247,,,1,-1,0,,,,,,
563,175,270,563,176,270,,,0,-1,0,,,,,,
563,175,294,563,177,293,,,0,-2,1,,,,,,
563,176,317,563,178,317,,,0,-2,0,,,,,,
563,177,341,563,179,341,,,0,-2,0,,,,,,
564,178,365,563,180,365,,,1,-2,0,,,,,,
564,179,390,564,181,389,,,0,-2,1,,,,,,
564,181,414,564,182,414,,,0,-1,0,,,,,,
565,182,439,564,183,438,,,1,-1,1,,,,,,
565,183,463,565,185,463,,,0,-2,0,,,,,,
565,185,488,565,186,488,,,0,-1,0,,,,,,
566,186,513,566,188,512,,,0,-2,1,,,,,,
566,188,538,566,189,537,,,0,-1,1,,,,,,
567,190,563,567,191,562,,,0,-1,1,,,,,,
567,191,588,567,193,587,,,0,-2,1,,,,,,
568,193,613,568,195,612,,,0,-2,1,,,,,,
568,195,638,568,197,638,,,0,-2,0,,,,,,
569,197,663,569,198,663,,,0,-1,0,,,,,,
569,199,688,569,200,688,,,0,-1,0,,,,,,
570,201,714,570,202,713,,,0,-1,1,,,,,,
571,203,739,571,205,739,,,0,-2,0,,,,,,
571,205,764,571,207,764,,,0,-2,0,,,,,,
563,183,89,562,183,89,,,1,0,0,,,,,,
563,183,90,562,183,89,,,1,0,1,,,,,,
563,183,97,563,183,97,,,0,0,0,,,,,,
563,184,109,563,183,110,,,0,1,-1,,,,,,
563,184,124,563,183,124,,,0,1,0,,,,,,
563,184,141,563,184,142,,,0,0,-1,,,,,,
563,184,161,563,184,161,,,0,0,0,,,,,,
563,185,181,563,185,181,,,0,0,0,,,,,,
563,185,203,563,185,202,,,0,0,1,,,,,,
563,186,225,563,186,225,,,0,0,0,,,,,,
564,186,248,563,186,247,,,1,0,1,,,,,,
564,187,271,563,187,270,,,1,0,1,,,,,,
564,188,294,564,188,294,,,0,0,0,,,,,,
564,189,318,564,188,318,,,0,1,0,,,,,,
564,189,342,564,189,342,,,0,0,0,,,,,,
565,190,366,564,190,366,,,1,0,0,,,,,,
565,191,390,565,191,390,,,0,0,0,,,,,,
565,193,414,565,192,414,,,0,1,0,,,,,,
566,194,439,565,194,439,,,1,0,0,,,,,,
566,195,464,566,195,463,,,0,0,1,,,,,,
566,196,488,566,196,488,,,0,0,0,,,,,,
567,198,513,567,198,513,,,0,0,0,,,,,,
567,199,538,567,199,537,,,0,0,1,,,,,,
568,201,563,568,201,562,,,0,0,1,,,,,,
568,203,588,568,202,587,,,0,1,1,,,,,,
569,204,613,569,204,613,,,0,0,0,,,,,,
569,206,638,569,206,638,,,0,0,0,,,,,,
570,208,663,570,208,663,,,0,0,0,,,,,,
570,210,689,570,209,688,,,0,1,1,,,,,,
571,212,714,571,211,714,,,0,1,0,,,,,,
572,214,739,572,214,739,,,0,0,0,,,,,,
572,216,765,572,216,764,,,0,0,1,,,,,,
564,199,91,564,200,91,,,0,-1,0,,,,,,
564,199,93,564,200,91,,,0,-1,2,,,,,,
564,199,99,564,200,99,,,0,-1,0,,,,,,
564,199,111,564,200,112,,,0,-1,-1,,,,,,
564,199,125,564,200,125,,,0,-1,0,,,,,,
564,200,143,564,201,143,,,0,-1,0,,,,,,
564,200,162,564,201,162,,,0,-1,0,,,,,,
564,200,182,564,201,182,,,0,-1,0,,,,,,
565,201,204,565,202,203,,,0,-1,1,,,,,,
565,201,226,565,202,226,,,0,-1,0,,,,,,
565,202,248,565,203,248,,,0,-1,0,,,,,,
565,202,271,565,203,271,,,0,-1,0,,,,,,
565,203,295,565,204,294,,,0,-1,1,,,,,,
566,204,318,565,205,318,,,1,-1,0,,,,,,
566,205,342,566,206,342,,,0,-1,0,,,,,,
566,206,366,566,206,366,,,0,0,0,,,,,,
566,207,390,566,207,390,,,0,0,0,,,,,,
567,208,415,566,208,414,,,1,0,1,,,,,,
567,209,439,567,210,439,,,0,-1,0,,,,,,
567,210,464,567,211,464,,,0,-1,0,,,,,,
568,211,489,568,212,488,,,0,-1,1,,,,,,
568,213,513,568,213,513,,,0,0,0,,,,,,
569,214,538,569,215,538,,,0,-1,0,,,,,,
569,215,563,569,216,563,,,0,-1,0,,,,,,
570,217,588,570,218,588,,,0,-1,0,,,,,,
570,218,613,570,219,613,,,0,-1,0,,,,,,
571,220,638,571,221,638,,,0,-1,0,,,,,,
571,222,664,571,223,663,,,0,-1,1,,,,,,
572,224,689,572,224,688,,,0,0,1,,,,,,
572,225,714,572,226,714,,,0,-1,0,,,,,,
573,227,739,573,228,739,,,0,-1,0,,,,,,
574,229,765,574,230,764,,,0,-1,1,,,,,,
566,217,94,565,217,93,,,1,0,1,,,,,,
566,217,95,565,217,93,,,1,0,2,,,,,,
566,217,102,565,217,101,,,1,0,1,,,,,,
566,218,113,566,217,114,,,0,1,-1,,,,,,
566,218,127,566,218,127,,,0,0,0,,,,,,
566,218,144,566,218,145,,,0,0,-1,,,,,,
566,218,163,566,218,163,,,0,0,0,,,,,,
566,219,184,566,218,183,,,0,1,1,,,,,,
566,219,205,566,219,204,,,0,0,1,,,,,,
567,219,227,566,219,227,,,1,0,0,,,,,,
567,220,249,566,220,249,,,1,0,0,,,,,,
567,220,272,567,220,272,,,0,0,0,,,,,,
567,221,296,567,221,295,,,0,0,1,,,,,,
567,222,319,567,221,319,,,0,1,0,,,,,,
568,223,343,567,222,343,,,1,1,0,,,,,,
568,223,367,568,223,367,,,0,0,0,,,,,,
568,224,391,568,224,391,,,0,0,0,,,,,,
568,225,415,568,225,415,,,0,0,0,,,,,,
569,226,440,568,226,439,,,1,0,1,,,,,,
569,227,464,569,227,464,,,0,0,0,,,,,,
570,228,489,569,228,489,,,1,0,0,,,,,,
570,230,514,570,229,513,,,0,1,1,,,,,,
570,231,539,570,231,538,,,0,0,1,,,,,,
571,232,563,571,232,563,,,0,0,0,,,,,,
571,234,588,571,234,588,,,0,0,0,,,,,,
572,235,614,572,235,613,,,0,0,1,,,,,,
572,237,639,572,236,638,,,0,1,1,,,,,,
573,238,664,573,238,663,,,0,0,1,,,,,,
574,240,689,574,240,689,,,0,0,0,,,,,,
574,242,714,574,241,714,,,0,1,0,,,,,,
575,243,740,575,243,739,,,0,0,1,,,,,,
575,245,765,575,245,765,,,0,0,0,,,,,,
568,238,97,568,238,97,,,0,0,0,,,,,,
568,238,99,568,238,97,,,0,0,2,,,,,,
568,238,105,568,238,105,,,0,0,0,,,,,,
568,238,115,568,238,117,,,0,0,-2,,,,,,
568,238,130,568,239,130,,,0,-1,0,,,,,,
568,238,146,568,239,147,,,0,-1,-1,,,,,,
568,238,165,568,239,165,,,0,-1,0,,,,,,
568,239,185,568,239,185,,,0,0,0,,,,,,
568,239,206,568,240,206,,,0,-1,0,,,,,,
569,239,228,568,240,228,,,1,-1,0,,,,,,
569,240,250,569,240,250,,,0,0,0,,,,,,
569,240,273,569,241,273,,,0,-1,0,,,,,,
569,241,296,569,241,296,,,0,0,0,,,,,,
569,242,320,569,242,320,,,0,0,0,,,,,,
570,242,344,569,243,344,,,1,-1,0,,,,,,
570,243,368,570,243,367,,,0,0,1,,,,,,
570,244,392,570,244,391,,,0,0,1,,,,,,
571,245,416,570,245,416,,,1,0,0,,,,,,
571,246,440,571,246,440,,,0,0,0,,,,,,
571,247,465,571,247,465,,,0,0,0,,,,,,
572,248,490,571,248,489,,,1,0,1,,,,,,
572,249,514,572,249,514,,,0,0,0,,,,,,
573,250,539,572,251,539,,,1,-1,0,,,,,,
573,251,564,573,252,564,,,0,-1,0,,,,,,
573,252,589,573,253,589,,,0,-1,0,,,,,,
574,254,614,574,254,614,,,0,0,0,,,,,,
575,255,639,574,256,639,,,1,-1,0,,,,,,
575,257,664,575,257,664,,,0,0,0,,,,,,
576,258,689,576,259,689,,,0,-1,0,,,,,,
576,260,715,576,260,714,,,0,0,1,,,,,,
577,261,740,577,262,740,,,0,-1,0,,,,,,
578,263,765,577,263,765,,,1,0,0,,,,,,
571,260,101,570,259,100,,,1,1,1,,,,,,
571,260,102,570,259,100,,,1,1,2,,,,,,
571,260,108,570,259,108,,,1,1,0,,,,,,
571,260,119,570,259,120,,,1,1,-1,,,,,,
571,260,132,570,260,132,,,1,0,0,,,,,,
571,260,149,570,260,149,,,1,0,0,,,,,,
571,260,167,571,260,167,,,0,0,0,,,,,,
571,260,187,571,260,187,,,0,0,0,,,,,,
571,261,208,571,261,207,,,0,0,1,,,,,,
571,261,230,571,261,229,,,0,0,1,,,,,,
571,262,252,571,261,252,,,0,1,0,,,,,,
572,262,274,571,262,275,,,1,0,-1,,,,,,
572,263,298,572,262,298,,,0,1,0,,,,,,
572,263,321,572,263,321,,,0,0,0,,,,,,
572,264,345,572,264,345,,,0,0,0,,,,,,
572,264,368,572,264,368,,,0,0,0,,,,,,
573,265,393,573,265,392,,,0,0,1,,,,,,
573,266,417,573,266,416,,,0,0,1,,,,,,
573,267,441,573,267,441,,,0,0,0,,,,,,
574,268,466,573,268,465,,,1,0,1,,,,,,
574,269,490,574,269,490,,,0,0,0,,,,,,
575,270,515,574,270,515,,,1,0,0,,,,,,
575,271,540,575,271,539,,,0,0,1,,,,,,
575,272,564,575,272,564,,,0,0,0,,,,,,
576,273,589,576,273,589,,,0,0,0,,,,,,
576,274,614,576,274,614,,,0,0,0,,,,,,
577,276,640,577,276,639,,,0,0,1,,,,,,
578,277,665,577,277,664,,,1,0,1,,,,,,
578,278,690,578,278,689,,,0,0,1,,,,,,
579,280,715,578,279,715,,,1,1,0,,,,,,
579,281,740,579,281,740,,,0,0,0,,,,,,
580,283,766,580,282,765,,,0,1,1,,,,,,
573,283,105,573,283,105,,,0,0,0,,,,,,
573,283,106,573,283,105,,,0,0,1,,,,,,
573,283,112,573,283,112,,,0,0,0,,,,,,
573,283,122,573,283,124,,,0,0,-2,,,,,,
574,283,135,573,283,135,,,1,0,0,,,,,,
574,283,152,573,283,152,,,1,0,0,,,,,,
574,283,170,574,284,169,,,0,-1,1,,,,,,
574,283,189,574,284,189,,,0,-1,0,,,,,,
574,284,210,574,284,209,,,0,0,1,,,,,,
574,284,231,574,284,231,,,0,0,0,,,,,,
574,284,253,574,285,253,,,0,-1,0,,,,,,
574,285,276,574,285,276,,,0,0,0,,,,,,
575,285,299,575,286,299,,,0,-1,0,,,,,,
575,286,322,575,286,322,,,0,0,0,,,,,,
575,286,346,575,287,346,,,0,-1,0,,,,,,
575,287,369,575,287,369,,,0,0,0,,,,,,
576,288,393,576,288,393,,,0,0,0,,,,,,
576,288,418,576,289,417,,,0,-1,1,,,,,,
576,289,442,576,289,442,,,0,0,0,,,,,,
577,290,466,576,290,466,,,1,0,0,,,,,,
577,291,491,577,291,491,,,0,0,0,,,,,,
577,292,516,577,292,515,,,0,0,1,,,,,,
578,293,540,578,293,540,,,0,0,0,,,,,,
578,294,565,578,294,565,,,0,0,0,,,,,,
579,295,590,579,295,590,,,0,0,0,,,,,,
579,296,615,579,296,615,,,0,0,0,,,,,,
580,297,640,580,298,640,,,0,-1,0,,,,,,
580,298,665,580,299,665,,,0,-1,0,,,,,,
581,300,690,581,300,690,,,0,0,0,,,,,,
582,301,716,581,301,715,,,1,0,1,,,,,,
582,302,741,582,303,741,,,0,-1,0,,,,,,
583,304,766,583,304,766,,,0,0,0,,,,,,
577,307,109,577,306,109,,,0,1,0,,,,,,
577,307,111,577,306,109,,,0,1,2,,,,,,
577,307,116,577,306,116,,,0,1,0,,,,,,
577,307,126,577,306,127,,,0,1,-1,,,,,,
577,307,139,577,306,139,,,0,1,0,,,,,,
577,307,155,577,307,155,,,0,0,0,,,,,,
577,307,172,577,307,172,,,0,0,0,,,,,,
577,307,192,577,307,191,,,0,0,1,,,,,,
577,308,212,577,307,211,,,0,1,1,,,,,,
577,308,233,577,308,233,,,0,0,0,,,,,,
578,308,255,578,308,255,,,0,0,0,,,,,,
578,309,277,578,309,277,,,0,0,0,,,,,,
578,309,300,578,309,300,,,0,0,0,,,,,,
578,310,323,578,310,323,,,0,0,0,,,,,,
578,310,347,578,310,347,,,0,0,0,,,,,,
579,311,371,578,311,370,,,1,0,1,,,,,,
579,311,395,579,311,394,,,0,0,1,,,,,,
579,312,419,579,312,418,,,0,0,1,,,,,,
580,313,443,579,312,443,,,1,1,0,,,,,,
580,313,467,580,313,467,,,0,0,0,,,,,,
580,314,492,580,314,491,,,0,0,1,,,,,,
581,315,516,581,315,516,,,0,0,0,,,,,,
581,316,541,581,316,541,,,0,0,0,,,,,,
582,317,566,582,316,565,,,0,1,1,,,,,,
582,318,591,582,317,590,,,0,1,1,,,,,,
583,319,616,583,318,615,,,0,1,1,,,,,,
583,320,641,583,320,640,,,0,0,1,,,,,,
584,321,666,584,321,665,,,0,0,1,,,,,,
584,322,691,584,322,691,,,0,0,0,,,,,,
585,324,716,585,323,716,,,0,1,0,,,,,,
585,325,741,585,325,741,,,0,0,0,,,,,,
586,326,767,586,326,766,,,0,0,1,,,,,,
580,331,114,580,331,114,,,0,0,0,,,,,,
580,331,116,580,331,114,,,0,0,2,,,,,,
580,331,121,580,331,121,,,0,0,0,,,,,,
581,331,130,580,331,132,,,1,0,-2,,,,,,
581,332,143,580,331,143,,,1,1,0,,,,,,
581,332,158,580,332,159,,,1,0,-1,,,,,,
581,332,175,580,332,175,,,1,0,0,,,,,,
581,332,194,581,332,194,,,0,0,0,,,,,,
581,332,214,581,332,214,,,0,0,0,,,,,,
581,333,235,581,333,235,,,0,0,0,,,,,,
581,333,257,581,333,257,,,0,0,0,,,,,,
581,333,279,581,333,279,,,0,0,0,,,,,,
582,334,302,581,334,302,,,1,0,0,,,,,,
582,334,325,582,334,325,,,0,0,0,,,,,,
582,335,348,582,335,348,,,0,0,0,,,,,,
582,335,372,582,335,372,,,0,0,0,,,,,,
583,336,396,582,336,395,,,1,0,1,,,,,,
583,336,420,583,336,419,,,0,0,1,,,,,,
583,337,444,583,337,444,,,0,0,0,,,,,,
584,338,468,584,338,468,,,0,0,0,,,,,,
584,338,493,584,338,492,,,0,0,1,,,,,,
584,339,517,584,339,517,,,0,0,0,,,,,,
585,340,542,585,340,541,,,0,0,1,,,,,,
585,341,567,585,341,566,,,0,0,1,,,,,,
586,342,591,586,341,591,,,0,1,0,,,,,,
586,343,616,586,342,616,,,0,1,0,,,,,,
587,344,641,587,344,641,,,0,0,0,,,,,,
587,345,666,587,345,666,,,0,0,0,,,,,,
588,346,692,588,346,691,,,0,0,1,,,,,,
589,347,717,588,347,716,,,1,0,1,,,,,,
589,348,742,589,348,742,,,0,0,0,,,,,,
590,349,767,590,349,767,,,0,0,0,,,,,,
585,357,119,584,357,119,,,1,0,0,,,,,,
585,357,121,584,357,119,,,1,0,2,,,,,,
585,357,126,584,357,126,,,1,0,0,,,,,,
585,357,135,584,357,136,,,1,0,-1,,,,,,
585,357,147,584,357,147,,,1,0,0,,,,,,
585,357,162,584,357,162,,,1,0,0,,,,,,
585,357,179,584,357,178,,,1,0,1,,,,,,
585,357,197,585,357,197,,,0,0,0,,,,,,
585,358,217,585,358,216,,,0,0,1,,,,,,
585,358,238,585,358,237,,,0,0,1,,,,,,
585,358,259,585,358,259,,,0,0,0,,,,,,
586,359,281,585,358,281,,,1,1,0,,,,,,
586,359,304,585,359,304,,,1,0,0,,,,,,
586,359,327,586,359,327,,,0,0,0,,,,,,
586,360,350,586,360,350,,,0,0,0,,,,,,
586,360,373,586,360,373,,,0,0,0,,,,,,
587,361,397,586,361,397,,,1,0,0,,,,,,
587,361,421,587,361,421,,,0,0,0,,,,,,
587,362,445,587,362,445,,,0,0,0,,,,,,
588,363,469,588,362,469,,,0,1,0,,,,,,
588,363,494,588,363,493,,,0,0,1,,,,,,
588,364,518,588,364,518,,,0,0,0,,,,,,
589,365,543,589,365,542,,,0,0,1,,,,,,
589,366,568,589,365,567,,,0,1,1,,,,,,
590,366,592,590,366,592,,,0,0,0,,,,,,
590,367,617,590,367,617,,,0,0,0,,,,,,
591,368,642,591,368,642,,,0,0,0,,,,,,
591,369,667,591,369,667,,,0,0,0,,,,,,
592,370,692,592,370,692,,,0,0,0,,,,,,
593,371,717,592,371,717,,,1,0,0,,,,,,
593,372,743,593,372,742,,,0,0,1,,,,,,
594,373,768,594,373,768,,,0,0,0,,,,,,
589,383,125,589,383,125,,,0,0,0,,,,,,
589,383,126,589,383,125,,,0,0,1,,,,,,
589,383,131,589,383,131,,,0,0,0,,,,,,
589,383,139,589,383,141,,,0,0,-2,,,,,,
589,383,151,589,383,151,,,0,0,0,,,,,,
589,383,166,589,383,166,,,0,0,0,,,,,,
589,383,182,589,383,182,,,0,0,0,,,,,,
589,383,200,589,383,200,,,0,0,0,,,,,,
590,384,220,590,384,219,,,0,0,1,,,,,,
590,384,240,590,384,240,,,0,0,0,,,,,,
590,384,261,590,384,261,,,0,0,0,,,,,,
590,384,283,590,384,283,,,0,0,0,,,,,,
590,385,306,590,385,306,,,0,0,0,,,,,,
590,385,328,590,385,328,,,0,0,0,,,,,,
591,385,352,591,385,351,,,0,0,1,,,,,,
591,386,375,591,386,375,,,0,0,0,,,,,,
591,386,399,591,386,398,,,0,0,1,,,,,,
592,387,422,591,387,422,,,1,0,0,,,,,,
592,387,446,592,387,446,,,0,0,0,,,,,,
592,388,471,592,388,470,,,0,0,1,,,,,,
593,389,495,593,388,495,,,0,1,0,,,,,,
593,389,519,593,389,519,,,0,0,0,,,,,,
593,390,544,593,390,543,,,0,0,1,,,,,,
594,391,568,594,391,568,,,0,0,0,,,,,,
594,392,593,594,391,593,,,0,1,0,,,,,,
595,392,618,595,392,618,,,0,0,0,,,,,,
595,393,643,595,393,643,,,0,0,0,,,,,,
596,394,668,596,394,668,,,0,0,0,,,,,,
596,395,693,596,395,693,,,0,0,0,,,,,,
597,396,718,597,396,718,,,0,0,0,,,,,,
598,397,743,597,397,743,,,1,0,0,,,,,,
598,398,769,598,398,768,,,0,0,1,,,,,,
594,409,131,594,409,130,,,0,0,1,,,,,,
594,409,132,594,409,130,,,0,0,2,,,,,,
594,409,136,594,409,136,,,0,0,0,,,,,,
594,409,145,594,409,146,,,0,0,-1,,,,,,
594,409,156,594,409,156,,,0,0,0,,,,,,
594,409,170,594,409,171,,,0,0,-1,,,,,,
594,409,186,594,409,186,,,0,0,0,,,,,,
594,410,204,594,409,204,,,0,1,0,,,,,,
594,410,223,594,410,222,,,0,0,1,,,,,,
595,410,243,594,410,243,,,1,0,0,,,,,,
595,410,264,595,410,264,,,0,0,0,,,,,,
595,411,286,595,410,286,,,0,1,0,,,,,,
595,411,308,595,411,308,,,0,0,0,,,,,,
595,411,330,595,411,330,,,0,0,0,,,,,,
596,412,353,596,411,353,,,0,1,0,,,,,,
596,412,377,596,412,376,,,0,0,1,,,,,,
596,412,400,596,412,400,,,0,0,0,,,,,,
596,413,424,596,413,423,,,0,0,1,,,,,,
597,413,448,597,413,447,,,0,0,1,,,,,,
597,414,472,597,414,472,,,0,0,0,,,,,,
597,415,496,597,414,496,,,0,1,0,,,,,,
598,415,520,597,415,520,,,1,0,0,,,,,,
598,416,545,598,416,545,,,0,0,0,,,,,,
599,417,570,598,416,569,,,1,1,1,,,,,,
599,417,594,599,417,594,,,0,0,0,,,,,,
600,418,619,599,418,619,,,1,0,0,,,,,,
600,419,644,600,419,644,,,0,0,0,,,,,,
601,420,669,600,419,669,,,1,1,0,,,,,,
601,421,694,601,420,694,,,0,1,0,,,,,,
602,422,719,602,421,719,,,0,1,0,,,,,,
602,422,744,602,422,744,,,0,0,0,,,,,,
603,423,769,603,423,769,,,0,0,0,,,,,,
599,436,137,599,436,136,,,0,0,1,,,,,,
599,436,138,599,436,136,,,0,0,2,,,,,,
599,436,142,599,436,142,,,0,0,0,,,,,,
599,436,150,599,436,151,,,0,0,-1,,,,,,
599,436,161,599,436,161,,,0,0,0,,,,,,
599,436,174,599,436,175,,,0,0,-1,,,,,,
599,436,190,599,436,190,,,0,0,0,,,,,,
600,436,207,599,436,208,,,1,0,-1,,,,,,
600,437,226,600,436,226,,,0,1,0,,,,,,
600,437,246,600,437,246,,,0,0,0,,,,,,
600,437,267,600,437,267,,,0,0,0,,,,,,
600,437,288,600,437,288,,,0,0,0,,,,,,
600,438,310,600,437,310,,,0,1,0,,,,,,
601,438,333,601,438,333,,,0,0,0,,,,,,
601,438,355,601,438,355,,,0,0,0,,,,,,
601,439,378,601,438,378,,,0,1,0,,,,,,
601,439,402,601,439,401,,,0,0,1,,,,,,
602,439,425,602,439,425,,,0,0,0,,,,,,
602,440,449,602,440,449,,,0,0,0,,,,,,
602,440,473,602,440,473,,,0,0,0,,,,,,
603,441,497,603,441,497,,,0,0,0,,,,,,
603,442,522,603,441,522,,,0,1,0,,,,,,
603,442,546,603,442,546,,,0,0,0,,,,,,
604,443,571,604,443,570,,,0,0,1,,,,,,
604,444,595,604,443,595,,,0,1,0,,,,,,
605,444,620,605,444,620,,,0,0,0,,,,,,
605,445,645,605,445,645,,,0,0,0,,,,,,
606,446,670,606,446,670,,,0,0,0,,,,,,
606,447,695,606,446,694,,,0,1,1,,,,,,
607,447,720,607,447,720,,,0,0,0,,,,,,
608,448,745,607,448,745,,,1,0,0,,,,,,
608,449,770,608,449,770,,,0,0,0,,,,,,
605,463,143,605,463,142,,,0,0,1,,,,,,
605,463,144,605,463,142,,,0,0,2,,,,,,
605,463,148,605,463,148,,,0,0,0,,,,,,
605,463,155,605,463,157,,,0,0,-2,,,,,,
605,463,166,605,463,166,,,0,0,0,,,,,,
605,463,179,605,463,180,,,0,0,-1,,,,,,
605,463,194,605,463,194,,,0,0,0,,,,,,
605,463,211,605,463,212,,,0,0,-1,,,,,,
605,464,230,605,463,229,,,0,1,1,,,,,,
605,464,249,605,463,249,,,0,1,0,,,,,,
606,464,270,605,464,270,,,1,0,0,,,,,,
606,464,291,606,464,291,,,0,0,0,,,,,,
606,464,313,606,464,313,,,0,0,0,,,,,,
606,465,335,606,464,335,,,0,1,0,,,,,,
606,465,357,606,465,357,,,0,0,0,,,,,,
607,465,380,607,465,380,,,0,0,0,,,,,,
607,466,404,607,466,403,,,0,0,1,,,,,,
607,466,427,607,466,427,,,0,0,0,,,,,,
608,467,451,607,467,451,,,1,0,0,,,,,,
608,467,475,608,467,475,,,0,0,0,,,,,,
608,468,499,608,468,499,,,0,0,0,,,,,,
609,468,523,609,468,523,,,0,0,0,,,,,,
609,469,548,609,469,547,,,0,0,1,,,,,,
610,469,572,609,469,572,,,1,0,0,,,,,,
610,470,597,610,470,596,,,0,0,1,,,,,,
610,471,621,610,470,621,,,0,1,0,,,,,,
611,471,646,611,471,646,,,0,0,0,,,,,,
611,472,671,611,472,671,,,0,0,0,,,,,,
612,473,696,612,473,695,,,0,0,1,,,,,,
613,474,721,612,473,720,,,1,1,1,,,,,,
613,475,746,613,474,746,,,0,1,0,,,,,,
614,475,771,613,475,771,,,1,0,0,,,,,,
611,490,149,611,490,149,,,0,0,0,,,,,,
611,490,150,611,490,149,,,0,0,1,,,,,,
611,490,154,611,490,154,,,0,0,0,,,,,,
611,490,161,611,490,162,,,0,0,-1,,,,,,
611,490,171,611,490,171,,,0,0,0,,,,,,
611,490,184,611,490,185,,,0,0,-1,,,,,,
611,490,199,611,490,199,,,0,0,0,,,,,,
611,491,215,611,490,216,,,0,1,-1,,,,,,
611,491,233,611,490,233,,,0,1,0,,,,,,
612,491,253,611,491,253,,,1,0,0,,,,,,
612,491,273,611,491,273,,,1,0,0,,,,,,
612,491,294,612,491,294,,,0,0,0,,,,,,
612,492,315,612,491,315,,,0,1,0,,,,,,
612,492,337,612,492,337,,,0,0,0,,,,,,
612,492,360,612,492,359,,,0,0,1,,,,,,
613,493,383,613,492,382,,,0,1,1,,,,,,
613,493,406,613,493,405,,,0,0,1,,,,,,
613,493,429,613,493,429,,,0,0,0,,,,,,
614,494,453,613,494,452,,,1,0,1,,,,,,
614,494,477,614,494,476,,,0,0,1,,,,,,
614,495,501,614,495,500,,,0,0,1,,,,,,
615,495,525,615,495,524,,,0,0,1,,,,,,
615,496,549,615,496,549,,,0,0,0,,,,,,
616,496,573,615,496,573,,,1,0,0,,,,,,
616,497,598,616,497,598,,,0,0,0,,,,,,
616,498,623,616,497,622,,,0,1,1,,,,,,
617,498,647,617,498,647,,,0,0,0,,,,,,
617,499,672,617,499,672,,,0,0,0,,,,,,
618,500,697,618,500,697,,,0,0,0,,,,,,
619,500,722,618,500,722,,,1,0,0,,,,,,
619,501,747,619,501,747,,,0,0,0,,,,,,
620,502,772,619,502,772,,,1,0,0,,,,,,
617,518,155,617,518,155,,,0,0,0,,,,,,
617,518,156,617,518,155,,,0,0,1,,,,,,
617,518,160,617,518,160,,,0,0,0,,,,,,
617,518,167,617,518,168,,,0,0,-1,,,,,,
617,518,177,618,518,177,,,-1,0,0,,,,,,
617,518,189,618,518,190,,,-1,0,-1,,,,,,
618,518,203,618,518,203,,,0,0,0,,,,,,
618,518,220,618,518,220,,,0,0,0,,,,,,
618,518,237,618,518,237,,,0,0,0,,,,,,
618,518,256,618,518,256,,,0,0,0,,,,,,
618,519,276,618,519,276,,,0,0,0,,,,,,
618,519,297,618,519,297,,,0,0,0,,,,,,
618,519,318,618,519,318,,,0,0,0,,,,,,
619,519,340,618,519,340,,,1,0,0,,,,,,
619,520,362,619,520,362,,,0,0,0,,,,,,
619,520,385,619,520,385,,,0,0,0,,,,,,
619,520,408,619,520,408,,,0,0,0,,,,,,
620,521,431,619,520,431,,,1,1,0,,,,,,
620,521,455,620,521,454,,,0,0,1,,,,,,
620,522,478,620,521,478,,,0,1,0,,,,,,
621,522,502,621,522,502,,,0,0,0,,,,,,
621,522,526,621,522,526,,,0,0,0,,,,,,
621,523,551,621,523,550,,,0,0,1,,,,,,
622,523,575,622,523,575,,,0,0,0,,,,,,
622,524,599,622,524,599,,,0,0,0,,,,,,
623,525,624,623,524,624,,,0,1,0,,,,,,
623,525,649,623,525,648,,,0,0,1,,,,,,
624,526,673,624,526,673,,,0,0,0,,,,,,
624,527,698,624,527,698,,,0,0,0,,,,,,
625,527,723,625,527,723,,,0,0,0,,,,,,
625,528,748,625,528,748,,,0,0,0,,,,,,
626,529,773,626,529,773,,,0,0,0,,,,,,
624,545,162,624,545,162,,,0,0,0,,,,,,
624,545,163,624,545,162,,,0,0,1,,,,,,
624,545,167,624,545,166,,,0,0,1,,,,,,
624,545,173,624,545,174,,,0,0,-1,,,,,,
624,546,182,624,545,182,,,0,1,0,,,,,,
624,546,194,624,545,195,,,0,1,-1,,,,,,
624,546,208,624,545,208,,,0,1,0,,,,,,
624,546,224,624,545,225,,,0,1,-1,,,,,,
625,546,242,624,546,241,,,1,0,1,,,,,,
625,546,260,624,546,260,,,1,0,0,,,,,,
625,546,280,625,546,279,,,0,0,1,,,,,,
625,546,300,625,546,300,,,0,0,0,,,,,,
625,547,321,625,546,321,,,0,1,0,,,,,,
625,547,343,625,547,342,,,0,0,1,,,,,,
626,547,365,626,547,364,,,0,0,1,,,,,,
626,548,387,626,547,387,,,0,1,0,,,,,,
626,548,410,626,547,410,,,0,1,0,,,,,,
626,548,433,626,548,433,,,0,0,0,,,,,,
627,549,457,627,548,456,,,0,1,1,,,,,,
627,549,480,627,549,480,,,0,0,0,,,,,,
627,549,504,627,549,504,,,0,0,0,,,,,,
628,550,528,628,550,528,,,0,0,0,,,,,,
628,550,552,628,550,552,,,0,0,0,,,,,,
629,551,576,628,551,576,,,1,0,0,,,,,,
629,551,601,629,551,601,,,0,0,0,,,,,,
629,552,625,629,552,625,,,0,0,0,,,,,,
630,553,650,630,552,650,,,0,1,0,,,,,,
630,553,675,630,553,674,,,0,0,1,,,,,,
631,554,699,631,554,699,,,0,0,0,,,,,,
632,555,724,631,554,724,,,1,1,0,,,,,,
632,555,749,632,555,749,,,0,0,0,,,,,,
633,556,774,633,556,774,,,0,0,0,,,,,,
631,573,169,631,573,169,,,0,0,0,,,,,,
631,573,169,631,573,169,,,0,0,0,,,,,,
631,573,173,631,573,173,,,0,0,0,,,,,,
631,573,179,631,573,180,,,0,0,-1,,,,,,
631,573,188,631,573,188,,,0,0,0,,,,,,
631,574,200,631,573,201,,,0,1,-1,,,,,,
631,574,213,631,573,213,,,0,1,0,,,,,,
632,574,229,631,573,229,,,1,1,0,,,,,,
632,574,246,631,574,246,,,1,0,0,,,,,,
632,574,264,631,574,264,,,1,0,0,,,,,,
632,574,283,632,574,283,,,0,0,0,,,,,,
632,574,303,632,574,303,,,0,0,0,,,,,,
632,575,324,632,574,324,,,0,1,0,,,,,,
632,575,346,632,574,345,,,0,1,1,,,,,,
633,575,368,633,575,367,,,0,0,1,,,,,,
633,575,390,633,575,390,,,0,0,0,,,,,,
633,576,413,633,575,412,,,0,1,1,,,,,,
634,576,436,633,576,435,,,1,0,1,,,,,,
634,576,459,634,576,458,,,0,0,1,,,,,,
634,577,482,634,576,482,,,0,1,0,,,,,,
634,577,506,634,577,506,,,0,0,0,,,,,,
635,578,530,635,577,529,,,0,1,1,,,,,,
635,578,554,635,578,553,,,0,0,1,,,,,,
636,579,578,635,578,578,,,1,1,0,,,,,,
636,579,602,636,579,602,,,0,0,0,,,,,,
637,580,627,636,579,627,,,1,1,0,,,,,,
637,580,651,637,580,651,,,0,0,0,,,,,,
638,581,676,637,580,676,,,1,1,0,,,,,,
638,581,701,638,581,700,,,0,0,1,,,,,,
639,582,726,638,582,725,,,1,0,1,,,,,,
639,583,750,639,582,750,,,0,1,0,,,,,,
640,583,775,640,583,775,,,0,0,0,,,,,,
639,601,175,639,601,175,,,0,0,0,,,,,,
639,601,176,639,601,175,,,0,0,1,,,,,,
639,601,180,639,601,179,,,0,0,1,,,,,,
639,601,186,639,601,187,,,0,0,-1,,,,,,
639,601,194,639,601,194,,,0,0,0,,,,,,
639,602,205,639,601,206,,,0,1,-1,,,,,,
639,602,219,639,601,219,,,0,1,0,,,,,,
639,602,234,639,601,234,,,0,1,0,,,,,,
639,602,250,639,602,250,,,0,0,0,,,,,,
639,602,268,639,602,268,,,0,0,0,,,,,,
639,602,287,639,602,287,,,0,0,0,,,,,,
640,602,307,639,602,307,,,1,0,0,,,,,,
640,603,328,640,602,327,,,0,1,1,,,,,,
640,603,349,640,602,349,,,0,1,0,,,,,,
640,603,370,640,603,370,,,0,0,0,,,,,,
640,603,393,640,603,392,,,0,0,1,,,,,,
641,604,415,641,603,415,,,0,1,0,,,,,,
641,604,438,641,604,438,,,0,0,0,,,,,,
641,604,461,641,604,461,,,0,0,0,,,,,,
642,605,484,641,604,484,,,1,1,0,,,,,,
642,605,508,642,605,508,,,0,0,0,,,,,,
642,605,532,642,605,531,,,0,0,1,,,,,,
643,606,556,643,605,555,,,0,1,1,,,,,,
643,606,580,643,606,579,,,0,0,1,,,,,,
643,607,604,643,606,604,,,0,1,0,,,,,,
644,607,628,644,607,628,,,0,0,0,,,,,,
644,608,653,644,607,653,,,0,1,0,,,,,,
645,608,677,645,608,677,,,0,0,0,,,,,,
645,609,702,645,609,702,,,0,0,0,,,,,,
646,610,727,646,609,727,,,0,1,0,,,,,,
647,610,752,646,610,752,,,1,0,0,,,,,,
647,611,777,647,611,776,,,0,0,1,,,,,,
646,630,182,646,629,182,,,0,1,0,,,,,,
647,630,183,646,629,182,,,1,1,1,,,,,,
647,630,186,646,629,186,,,1,1,0,,,,,,
647,630,192,646,629,193,,,1,1,-1,,,,,,
647,630,200,647,629,200,,,0,1,0,,,,,,
647,630,211,647,629,212,,,0,1,-1,,,,,,
647,630,224,647,630,224,,,0,0,0,,,,,,
647,630,239,647,630,239,,,0,0,0,,,,,,
647,630,255,647,630,255,,,0,0,0,,,,,,
647,630,273,647,630,273,,,0,0,0,,,,,,
647,630,291,647,630,291,,,0,0,0,,,,,,
647,631,311,647,630,311,,,0,1,0,,,,,,
648,631,331,647,630,331,,,1,1,0,,,,,,
648,631,352,647,631,352,,,1,0,0,,,,,,
648,631,374,648,631,373,,,0,0,1,,,,,,
648,631,395,648,631,395,,,0,0,0,,,,,,
648,632,418,648,631,418,,,0,1,0,,,,,,
649,632,440,649,632,440,,,0,0,0,,,,,,
649,632,463,649,632,463,,,0,0,0,,,,,,
649,633,487,649,632,487,,,0,1,0,,,,,,
650,633,510,649,633,510,,,1,0,0,,,,,,
650,633,534,650,633,534,,,0,0,0,,,,,,
650,634,558,650,633,557,,,0,1,1,,,,,,
651,634,582,651,634,581,,,0,0,1,,,,,,
651,635,606,651,634,605,,,0,1,1,,,,,,
652,635,630,652,635,630,,,0,0,0,,,,,,
652,636,655,652,635,654,,,0,1,1,,,,,,
653,636,679,653,636,679,,,0,0,0,,,,,,
653,637,704,653,636,703,,,0,1,1,,,,,,
654,637,728,654,637,728,,,0,0,0,,,,,,
654,638,753,654,638,753,,,0,0,0,,,,,,
655,639,778,655,638,778,,,0,1,0,,,,,,
655,658,189,654,658,189,,,1,0,0,,,,,,
655,658,190,654,658,189,,,1,0,1,,,,,,
655,658,193,654,658,193,,,1,0,0,,,,,,
655,658,199,654,658,200,,,1,0,-1,,,,,,
655,658,207,655,658,207,,,0,0,0,,,,,,
655,658,217,655,658,218,,,0,0,-1,,,,,,
655,658,230,655,658,230,,,0,0,0,,,,,,
655,658,244,655,658,245,,,0,0,-1,,,,,,
655,658,260,655,658,260,,,0,0,0,,,,,,
655,659,277,655,658,277,,,0,1,0,,,,,,
655,659,295,655,659,295,,,0,0,0,,,,,,
655,659,315,655,659,315,,,0,0,0,,,,,,
656,659,335,655,659,334,,,1,0,1,,,,,,
656,659,355,656,659,355,,,0,0,0,,,,,,
656,659,377,656,659,376,,,0,0,1,,,,,,
656,660,398,656,659,398,,,0,1,0,,,,,,
657,660,421,656,660,420,,,1,0,1,,,,,,
657,660,443,657,660,443,,,0,0,0,,,,,,
657,661,466,657,660,466,,,0,1,0,,,,,,
657,661,489,657,660,489,,,0,1,0,,,,,,
658,661,512,657,661,512,,,1,0,0,,,,,,
658,662,536,658,661,536,,,0,1,0,,,,,,
658,662,560,658,662,559,,,0,0,1,,,,,,
659,662,584,659,662,583,,,0,0,1,,,,,,
659,663,608,659,663,607,,,0,0,1,,,,,,
660,663,632,660,663,631,,,0,0,1,,,,,,
660,664,656,660,663,656,,,0,1,0,,,,,,
661,664,681,661,664,680,,,0,0,1,,,,,,
661,665,705,661,664,705,,,0,1,0,,,,,,
662,665,730,662,665,730,,,0,0,0,,,,,,
662,666,755,662,666,755,,,0,0,0,,,,,,
663,667,779,663,666,779,,,0,1,0,,,,,,
663,686,196,663,686,196,,,0,0,0,,,,,,
663,686,197,663,686,196,,,0,0,1,,,,,,
663,686,200,663,686,200,,,0,0,0,,,,,,
663,686,205,663,686,206,,,0,0,-1,,,,,,
663,686,213,663,686,213,,,0,0,0,,,,,,
663,687,223,663,686,224,,,0,1,-1,,,,,,
663,687,235,663,686,235,,,0,1,0,,,,,,
663,687,249,663,686,250,,,0,1,-1,,,,,,
663,687,265,664,686,265,,,-1,1,0,,,,,,
664,687,282,664,687,282,,,0,0,0,,,,,,
664,687,300,664,687,300,,,0,0,0,,,,,,
664,687,319,664,687,319,,,0,0,0,,,,,,
664,687,338,664,687,338,,,0,0,0,,,,,,
664,688,359,664,687,359,,,0,1,0,,,,,,
664,688,380,665,687,380,,,-1,1,0,,,,,,
665,688,402,665,688,401,,,0,0,1,,,,,,
665,688,424,665,688,423,,,0,0,1,,,,,,
665,689,446,665,688,446,,,0,1,0,,,,,,
666,689,469,666,688,468,,,0,1,1,,,,,,
666,689,492,666,689,491,,,0,0,1,,,,,,
666,690,515,666,689,514,,,0,1,1,,,,,,
667,690,538,666,690,538,,,1,0,0,,,,,,
667,690,562,667,690,561,,,0,0,1,,,,,,
667,691,586,667,691,585,,,0,0,1,,,,,,
668,691,610,668,691,609,,,0,0,1,,,,,,
668,692,634,668,691,633,,,0,1,1,,,,,,
669,692,658,669,692,658,,,0,0,0,,,,,,
669,692,682,669,692,682,,,0,0,0,,,,,,
670,693,707,670,693,706,,,0,0,1,,,,,,
670,693,731,670,693,731,,,0,0,0,,,,,,
671,694,756,671,694,756,,,0,0,0,,,,,,
671,695,781,671,695,781,,,0,0,0,,,,,,
672,715,203,672,715,203,,,0,0,0,,,,,,
672,715,204,672,715,203,,,0,0,1,,,,,,
672,715,207,672,715,206,,,0,0,1,,,,,,
672,715,212,672,715,213,,,0,0,-1,,,,,,
672,715,220,672,715,220,,,0,0,0,,,,,,
672,715,229,672,715,230,,,0,0,-1,,,,,,
672,715,241,672,715,241,,,0,0,0,,,,,,
672,715,255,672,715,255,,,0,0,0,,,,,,
672,715,270,672,715,270,,,0,0,0,,,,,,
672,715,287,672,715,287,,,0,0,0,,,,,,
672,716,304,672,716,304,,,0,0,0,,,,,,
673,716,323,672,716,323,,,1,0,0,,,,,,
673,716,342,673,716,342,,,0,0,0,,,,,,
673,716,363,673,716,363,,,0,0,0,,,,,,
673,716,383,673,716,383,,,0,0,0,,,,,,
673,717,405,673,716,405,,,0,1,0,,,,,,
674,717,427,674,717,426,,,0,0,1,,,,,,
674,717,449,674,717,449,,,0,0,0,,,,,,
674,717,471,674,717,471,,,0,0,0,,,,,,
675,718,494,674,717,494,,,1,1,0,,,,,,
675,718,517,675,718,517,,,0,0,0,,,,,,
675,718,541,675,718,540,,,0,0,1,,,,,,
676,719,564,676,719,564,,,0,0,0,,,,,,
676,719,588,676,719,587,,,0,0,1,,,,,,
676,719,612,676,719,611,,,0,0,1,,,,,,
677,720,636,677,720,635,,,0,0,1,,,,,,
677,720,660,677,720,659,,,0,0,1,,,,,,
678,721,684,678,720,684,,,0,1,0,,,,,,
678,721,709,678,721,708,,,0,0,1,,,,,,
679,722,733,679,721,733,,,0,1,0,,,,,,
679,722,758,679,722,758,,,0,0,0,,,,,,
680,723,783,680,723,782,,,0,0,1,,,,,,
681,744,210,681,743,210,,,0,1,0,,,,,,
681,744,211,681,743,210,,,0,1,1,,,,,,
681,744,214,681,743,213,,,0,1,1,,,,,,
681,744,219,681,743,220,,,0,1,-1,,,,,,
681,744,226,681,743,226,,,0,1,0,,,,,,
681,744,236,681,743,236,,,0,1,0,,,,,,
681,744,247,681,744,247,,,0,0,0,,,,,,
681,744,260,681,744,261,,,0,0,-1,,,,,,
681,744,275,681,744,275,,,0,0,0,,,,,,
681,744,291,681,744,292,,,0,0,-1,,,,,,
682,744,309,681,744,309,,,1,0,0,,,,,,
682,744,327,681,744,327,,,1,0,0,,,,,,
682,745,346,682,744,346,,,0,1,0,,,,,,
682,745,366,682,744,366,,,0,1,0,,,,,,
682,745,387,682,745,387,,,0,0,0,,,,,,
682,745,408,682,745,408,,,0,0,0,,,,,,
683,745,430,683,745,429,,,0,0,1,,,,,,
683,746,452,683,745,452,,,0,1,0,,,,,,
683,746,474,683,746,474,,,0,0,0,,,,,,
684,746,497,683,746,497,,,1,0,0,,,,,,
684,746,520,684,746,519,,,0,0,1,,,,,,
684,747,543,684,747,543,,,0,0,0,,,,,,
685,747,566,685,747,566,,,0,0,0,,,,,,
685,748,590,685,747,590,,,0,1,0,,,,,,
685,748,614,685,748,613,,,0,0,1,,,,,,
686,748,638,686,748,637,,,0,0,1,,,,,,
686,749,662,686,748,661,,,0,1,1,,,,,,
687,749,686,687,749,686,,,0,0,0,,,,,,
687,750,710,687,749,710,,,0,1,0,,,,,,
688,750,735,688,750,735,,,0,0,0,,,,,,
688,751,759,688,750,759,,,0,1,0,,,,,,
689,751,784,689,751,784,,,0,0,0,,,,,,
690,772,218,690,772,217,,,0,0,1,,,,,,
690,772,218,690,772,217,,,0,0,1,,,,,,
690,772,221,690,772,221,,,0,0,0,,,,,,
690,772,226,690,772,227,,,0,0,-1,,,,,,
690,772,233,690,772,233,,,0,0,0,,,,,,
690,773,242,690,772,243,,,0,1,-1,,,,,,
690,773,253,691,772,253,,,-1,1,0,,,,,,
690,773,266,691,772,266,,,-1,1,0,,,,,,
691,773,281,691,772,280,,,0,1,1,,,,,,
691,773,297,691,773,297,,,0,0,0,,,,,,
691,773,314,691,773,313,,,0,0,1,,,,,,
691,773,332,691,773,332,,,0,0,0,,,,,,
691,773,351,691,773,350,,,0,0,1,,,,,,
691,773,370,691,773,370,,,0,0,0,,,,,,
692,774,391,692,773,390,,,0,1,1,,,,,,
692,774,412,692,774,411,,,0,0,1,,,,,,
692,774,433,692,774,433,,,0,0,0,,,,,,
692,774,455,692,774,455,,,0,0,0,,,,,,
693,775,477,693,774,477,,,0,1,0,,,,,,
693,775,500,693,775,500,,,0,0,0,,,,,,
693,775,522,693,775,522,,,0,0,0,,,,,,
693,775,546,693,775,545,,,0,0,1,,,,,,
694,776,569,694,776,569,,,0,0,0,,,,,,
694,776,592,694,776,592,,,0,0,0,,,,,,
695,776,616,695,776,616,,,0,0,0,,,,,,
695,777,640,695,776,639,,,0,1,1,,,,,,
695,777,664,696,777,663,,,-1,0,1,,,,,,
696,778,688,696,777,688,,,0,1,0,,,,,,
696,778,712,697,778,712,,,-1,0,0,,,,,,
697,779,737,697,778,736,,,0,1,1,,,,,,
697,779,761,698,779,761,,,-1,0,0,,,,,,
698,780,786,698,779,786,,,0,1,0,,,,,,
700,801,225,700,801,225,,,0,0,0,,,,,,
700,801,226,700,801,225,,,0,0,1,,,,,,
700,801,228,700,801,228,,,0,0,0,,,,,,
700,801,233,700,801,234,,,0,0,-1,,,,,,
700,801,240,700,801,239,,,0,0,1,,,,,,
700,801,249,700,801,249,,,0,0,0,,,,,,
700,801,259,700,801,259,,,0,0,0,,,,,,
700,801,272,700,801,272,,,0,0,0,,,,,,
700,802,286,700,801,286,,,0,1,0,,,,,,
700,802,302,700,801,302,,,0,1,0,,,,,,
700,802,318,700,802,318,,,0,0,0,,,,,,
701,802,336,700,802,336,,,1,0,0,,,,,,
701,802,355,701,802,355,,,0,0,0,,,,,,
701,802,374,701,802,374,,,0,0,0,,,,,,
701,802,395,701,802,394,,,0,0,1,,,,,,
701,803,415,701,802,415,,,0,1,0,,,,,,
702,803,437,702,803,436,,,0,0,1,,,,,,
702,803,458,702,803,458,,,0,0,0,,,,,,
702,803,480,702,803,480,,,0,0,0,,,,,,
702,804,503,702,803,503,,,0,1,0,,,,,,
703,804,525,703,804,525,,,0,0,0,,,,,,
703,804,548,703,804,548,,,0,0,0,,,,,,
703,804,571,703,804,571,,,0,0,0,,,,,,
704,805,595,704,804,595,,,0,1,0,,,,,,
704,805,618,704,805,618,,,0,0,0,,,,,,
705,806,642,705,805,642,,,0,1,0,,,,,,
705,806,666,705,806,666,,,0,0,0,,,,,,
705,806,690,706,806,690,,,-1,0,0,,,,,,
706,807,714,706,807,714,,,0,0,0,,,,,,
706,807,739,707,807,738,,,-1,0,1,,,,,,
707,808,763,707,807,763,,,0,1,0,,,,,,
707,808,788,708,808,787,,,-1,0,1,,,,,,
710,830,232,710,830,232,,,0,0,0,,,,,,
710,830,233,710,830,232,,,0,0,1,,,,,,
710,830,235,710,830,235,,,0,0,0,,,,,,
710,830,240,710,830,241,,,0,0,-1,,,,,,
710,830,246,710,830,246,,,0,0,0,,,,,,
710,830,255,710,830,256,,,0,0,-1,,,,,,
710,830,266,710,830,265,,,0,0,1,,,,,,
710,830,278,710,830,278,,,0,0,0,,,,,,
710,830,292,710,830,292,,,0,0,0,,,,,,
710,831,307,710,830,307,,,0,1,0,,,,,,
710,831,324,710,831,323,,,0,0,1,,,,,,
710,831,341,710,831,341,,,0,0,0,,,,,,
711,831,359,711,831,359,,,0,0,0,,,,,,
711,831,379,711,831,379,,,0,0,0,,,,,,
711,831,399,711,831,398,,,0,0,1,,,,,,
711,831,419,711,831,419,,,0,0,0,,,,,,
711,832,440,712,832,440,,,-1,0,0,,,,,,
712,832,462,712,832,461,,,0,0,1,,,,,,
712,832,483,712,832,483,,,0,0,0,,,,,,
712,832,506,712,832,506,,,0,0,0,,,,,,
713,833,528,713,832,528,,,0,1,0,,,,,,
713,833,551,713,833,551,,,0,0,0,,,,,,
713,833,574,713,833,574,,,0,0,0,,,,,,
714,834,597,713,833,597,,,1,1,0,,,,,,
714,834,621,714,834,621,,,0,0,0,,,,,,
714,834,644,714,834,644,,,0,0,0,,,,,,
715,835,668,715,834,668,,,0,1,0,,,,,,
715,835,692,715,835,692,,,0,0,0,,,,,,
716,835,716,716,835,716,,,0,0,0,,,,,,
716,836,741,716,835,740,,,0,1,1,,,,,,
717,836,765,717,836,765,,,0,0,0,,,,,,
717,837,789,717,836,789,,,0,1,0,,,,,,
720,859,240,720,859,239,,,0,0,1,,,,,,
720,859,240,720,859,239,,,0,0,1,,,,,,
720,859,243,720,859,242,,,0,0,1,,,,,,
720,859,247,720,859,248,,,0,0,-1,,,,,,
720,859,253,720,859,253,,,0,0,0,,,,,,
720,859,262,720,859,262,,,0,0,0,,,,,,
720,859,272,720,859,272,,,0,0,0,,,,,,
720,859,284,720,859,285,,,0,0,-1,,,,,,
720,859,298,720,859,298,,,0,0,0,,,,,,
720,860,313,720,859,313,,,0,1,0,,,,,,
720,860,329,721,860,329,,,-1,0,0,,,,,,
721,860,346,721,860,346,,,0,0,0,,,,,,
721,860,364,721,860,364,,,0,0,0,,,,,,
721,860,383,721,860,383,,,0,0,0,,,,,,
721,860,403,721,860,402,,,0,0,1,,,,,,
721,860,423,721,860,423,,,0,0,0,,,,,,
722,861,444,722,861,443,,,0,0,1,,,,,,
722,861,465,722,861,465,,,0,0,0,,,,,,
722,861,487,722,861,486,,,0,0,1,,,,,,
722,861,509,722,861,509,,,0,0,0,,,,,,
723,862,531,723,861,531,,,0,1,0,,,,,,
723,862,554,723,861,554,,,0,1,0,,,,,,
723,862,577,723,862,576,,,0,0,1,,,,,,
724,862,600,723,862,600,,,1,0,0,,,,,,
724,863,623,724,863,623,,,0,0,0,,,,,,
724,863,647,724,863,647,,,0,0,0,,,,,,
725,863,671,725,863,670,,,0,0,1,,,,,,
725,864,694,725,863,694,,,0,1,0,,,,,,
726,864,718,726,864,718,,,0,0,0,,,,,,
726,865,743,726,864,742,,,0,1,1,,,,,,
727,865,767,727,865,767,,,0,0,0,,,,,,
727,866,791,727,865,791,,,0,1,0,,,,,,
730,888,247,730,888,247,,,0,0,0,,,,,,
730,888,248,730,888,247,,,0,0,1,,,,,,
730,888,250,730,888,250,,,0,0,0,,,,,,
730,888,254,730,888,255,,,0,0,-1,,,,,,
730,888,260,730,888,260,,,0,0,0,,,,,,
730,888,269,730,888,269,,,0,0,0,,,,,,
730,888,278,730,888,278,,,0,0,0,,,,,,
730,888,290,730,888,291,,,0,0,-1,,,,,,
731,889,303,730,888,303,,,1,1,0,,,,,,
731,889,318,731,888,318,,,0,1,0,,,,,,
731,889,334,731,889,334,,,0,0,0,,,,,,
731,889,351,731,889,351,,,0,0,0,,,,,,
731,889,369,731,889,368,,,0,0,1,,,,,,
731,889,387,731,889,387,,,0,0,0,,,,,,
731,889,407,731,889,406,,,0,0,1,,,,,,
732,889,427,732,889,427,,,0,0,0,,,,,,
732,890,448,732,890,447,,,0,0,1,,,,,,
732,890,469,732,890,468,,,0,0,1,,,,,,
732,890,490,732,890,490,,,0,0,0,,,,,,
733,890,512,733,890,512,,,0,0,0,,,,,,
733,891,534,733,890,534,,,0,1,0,,,,,,
733,891,557,733,890,557,,,0,1,0,,,,,,
734,891,580,734,891,579,,,0,0,1,,,,,,
734,891,603,734,891,602,,,0,0,1,,,,,,
734,892,626,734,892,626,,,0,0,0,,,,,,
735,892,649,735,892,649,,,0,0,0,,,,,,
735,892,673,735,892,673,,,0,0,0,,,,,,
736,893,697,736,892,696,,,0,1,1,,,,,,
736,893,721,736,893,720,,,0,0,1,,,,,,
736,894,745,737,893,745,,,-1,1,0,,,,,,
737,894,769,737,894,769,,,0,0,0,,,,,,
737,894,793,738,894,793,,,-1,0,0,,,,,,
588,163,89,588,163,89,,,0,0,0,,,,,,
588,163,91,588,163,89,,,0,0,2,,,,,,
588,163,98,588,163,98,,,0,0,0,,,,,,
588,163,109,588,163,111,,,0,0,-2,,,,,,
589,163,124,589,163,124,,,0,0,0,,,,,,
589,163,142,589,163,142,,,0,0,0,,,,,,
589,164,161,589,164,161,,,0,0,0,,,,,,
589,164,182,589,164,182,,,0,0,0,,,,,,
589,165,203,589,165,203,,,0,0,0,,,,,,
589,165,225,589,165,225,,,0,0,0,,,,,,
589,166,248,589,166,248,,,0,0,0,,,,,,
589,167,271,589,167,271,,,0,0,0,,,,,,
590,168,294,590,168,294,,,0,0,0,,,,,,
590,169,318,590,169,318,,,0,0,0,,,,,,
590,170,342,590,170,342,,,0,0,0,,,,,,
590,171,366,590,171,366,,,0,0,0,,,,,,
591,172,390,591,172,390,,,0,0,0,,,,,,
591,173,415,591,173,414,,,0,0,1,,,,,,
591,175,439,591,175,439,,,0,0,0,,,,,,
592,176,464,591,176,463,,,1,0,1,,,,,,
592,178,488,592,178,488,,,0,0,0,,,,,,
592,179,513,592,179,513,,,0,0,0,,,,,,
593,181,538,593,181,538,,,0,0,0,,,,,,
593,183,563,593,182,563,,,0,1,0,,,,,,
594,184,588,594,184,588,,,0,0,0,,,,,,
594,186,613,594,186,613,,,0,0,0,,,,,,
595,188,638,595,188,638,,,0,0,0,,,,,,
595,190,663,595,190,663,,,0,0,0,,,,,,
596,192,689,596,192,689,,,0,0,0,,,,,,
596,195,714,596,194,714,,,0,1,0,,,,,,
597,197,739,597,197,739,,,0,0,0,,,,,,
598,199,765,597,199,764,,,1,0,1,,,,,,
589,164,89,588,163,89,,,1,1,0,,,,,,
589,164,91,588,163,89,,,1,1,2,,,,,,
589,164,98,588,163,98,,,1,1,0,,,,,,
589,164,109,588,163,111,,,1,1,-2,,,,,,
589,165,124,589,163,124,,,0,2,0,,,,,,
589,165,142,589,163,142,,,0,2,0,,,,,,
589,165,161,589,164,161,,,0,1,0,,,,,,
589,166,182,589,164,182,,,0,2,0,,,,,,
589,166,203,589,165,203,,,0,1,0,,,,,,
589,167,225,589,165,225,,,0,2,0,,,,,,
589,167,248,589,166,248,,,0,1,0,,,,,,
589,168,271,589,167,271,,,0,1,0,,,,,,
590,169,294,590,168,294,,,0,1,0,,,,,,
590,170,318,590,169,318,,,0,1,0,,,,,,
590,171,342,590,170,342,,,0,1,0,,,,,,
590,172,366,590,171,366,,,0,1,0,,,,,,
591,173,390,591,172,390,,,0,1,0,,,,,,
591,174,415,591,173,414,,,0,1,1,,,,,,
591,176,439,591,175,439,,,0,1,0,,,,,,
592,177,464,591,176,463,,,1,1,1,,,,,,
592,179,488,592,178,488,,,0,1,0,,,,,,
592,180,513,592,179,513,,,0,1,0,,,,,,
593,182,538,593,181,538,,,0,1,0,,,,,,
593,184,563,593,182,563,,,0,2,0,,,,,,
594,186,588,594,184,588,,,0,2,0,,,,,,
594,187,613,594,186,613,,,0,1,0,,,,,,
595,189,638,595,188,638,,,0,1,0,,,,,,
595,191,663,595,190,663,,,0,1,0,,,,,,
596,194,689,596,192,689,,,0,2,0,,,,,,
596,196,714,596,194,714,,,0,2,0,,,,,,
597,198,739,597,197,739,,,0,1,0,,,,,,
598,200,765,597,199,764,,,1,1,1,,,,,,
589,169,90,589,169,90,,,0,0,0,,,,,,
589,169,92,589,169,90,,,0,0,2,,,,,,
589,169,98,589,169,98,,,0,0,0,,,,,,
589,169,110,589,169,111,,,0,0,-1,,,,,,
589,169,125,589,169,125,,,0,0,0,,,,,,
589,170,142,589,169,143,,,0,1,-1,,,,,,
589,170,161,589,170,161,,,0,0,0,,,,,,
589,170,182,589,170,182,,,0,0,0,,,,,,
589,171,203,589,171,203,,,0,0,0,,,,,,
589,171,225,589,171,225,,,0,0,0,,,,,,
590,172,248,590,172,248,,,0,0,0,,,,,,
590,173,271,590,173,271,,,0,0,0,,,,,,
590,174,295,590,174,295,,,0,0,0,,,,,,
590,175,318,590,175,318,,,0,0,0,,,,,,
590,176,342,590,176,342,,,0,0,0,,,,,,
591,177,366,590,177,366,,,1,0,0,,,,,,
591,178,390,591,178,390,,,0,0,0,,,,,,
591,179,415,591,179,414,,,0,0,1,,,,,,
592,180,439,592,180,439,,,0,0,0,,,,,,
592,182,464,592,181,463,,,0,1,1,,,,,,
592,183,488,592,183,488,,,0,0,0,,,,,,
593,185,513,592,184,513,,,1,1,0,,,,,,
593,186,538,593,186,538,,,0,0,0,,,,,,
594,188,563,593,188,563,,,1,0,0,,,,,,
594,190,588,594,190,588,,,0,0,0,,,,,,
595,192,613,594,192,613,,,1,0,0,,,,,,
595,194,638,595,194,638,,,0,0,0,,,,,,
596,196,663,595,196,663,,,1,0,0,,,,,,
596,198,689,596,198,689,,,0,0,0,,,,,,
597,200,714,596,200,714,,,1,0,0,,,,,,
597,202,739,597,202,739,,,0,0,0,,,,,,
598,204,765,598,204,764,,,0,0,1,,,,,,
590,178,91,589,179,91,,,1,-1,0,,,,,,
590,178,93,589,179,91,,,1,-1,2,,,,,,
590,178,99,590,179,99,,,0,-1,0,,,,,,
590,178,111,590,179,112,,,0,-1,-1,,,,,,
590,178,125,590,179,126,,,0,-1,-1,,,,,,
590,178,143,590,180,144,,,0,-2,-1,,,,,,
590,179,162,590,180,162,,,0,-1,0,,,,,,
590,179,182,590,181,182,,,0,-2,0,,,,,,
590,179,204,590,181,203,,,0,-2,1,,,,,,
590,180,226,590,182,226,,,0,-2,0,,,,,,
590,181,248,590,182,248,,,0,-1,0,,,,,,
590,181,271,590,183,271,,,0,-2,0,,,,,,
591,182,295,591,184,295,,,0,-2,0,,,,,,
591,183,318,591,185,318,,,0,-2,0,,,,,,
591,184,342,591,186,342,,,0,-2,0,,,,,,
591,185,366,591,187,366,,,0,-2,0,,,,,,
592,186,391,592,188,390,,,0,-2,1,,,,,,
592,187,415,592,189,415,,,0,-2,0,,,,,,
592,188,439,592,190,439,,,0,-2,0,,,,,,
593,190,464,592,191,464,,,1,-1,0,,,,,,
593,191,489,593,192,488,,,0,-1,1,,,,,,
593,193,513,593,194,513,,,0,-1,0,,,,,,
594,194,538,594,195,538,,,0,-1,0,,,,,,
594,196,563,594,197,563,,,0,-1,0,,,,,,
595,197,588,595,199,588,,,0,-2,0,,,,,,
595,199,613,595,201,613,,,0,-2,0,,,,,,
596,201,638,596,203,638,,,0,-2,0,,,,,,
596,203,664,596,204,663,,,0,-1,1,,,,,,
597,205,689,597,206,689,,,0,-1,0,,,,,,
597,207,714,597,208,714,,,0,-1,0,,,,,,
598,209,739,598,210,739,,,0,-1,0,,,,,,
599,211,765,598,212,764,,,1,-1,1,,,,,,
590,190,93,590,190,93,,,0,0,0,,,,,,
590,190,94,590,190,93,,,0,0,1,,,,,,
591,190,101,591,190,101,,,0,0,0,,,,,,
591,190,112,591,190,114,,,0,0,-2,,,,,,
591,190,127,591,190,127,,,0,0,0,,,,,,
591,190,144,591,190,145,,,0,0,-1,,,,,,
591,191,163,591,191,163,,,0,0,0,,,,,,
591,191,183,591,191,183,,,0,0,0,,,,,,
591,192,204,591,192,204,,,0,0,0,,,,,,
591,192,226,591,192,226,,,0,0,0,,,,,,
591,193,249,591,193,249,,,0,0,0,,,,,,
591,193,272,591,193,272,,,0,0,0,,,,,,
592,194,295,592,194,295,,,0,0,0,,,,,,
592,195,319,592,195,319,,,0,0,0,,,,,,
592,196,343,592,196,343,,,0,0,0,,,,,,
592,197,367,592,197,367,,,0,0,0,,,,,,
593,198,391,593,198,391,,,0,0,0,,,,,,
593,199,415,593,199,415,,,0,0,0,,,,,,
593,200,440,593,200,440,,,0,0,0,,,,,,
594,201,464,593,201,464,,,1,0,0,,,,,,
594,202,489,594,202,489,,,0,0,0,,,,,,
594,204,514,594,203,513,,,0,1,1,,,,,,
595,205,538,595,205,538,,,0,0,0,,,,,,
595,207,563,595,206,563,,,0,1,0,,,,,,
596,208,588,596,208,588,,,0,0,0,,,,,,
596,210,613,596,210,613,,,0,0,0,,,,,,
597,212,639,597,212,639,,,0,0,0,,,,,,
597,214,664,597,213,664,,,0,1,0,,,,,,
598,215,689,598,215,689,,,0,0,0,,,,,,
598,217,714,598,217,714,,,0,0,0,,,,,,
599,219,740,599,219,740,,,0,0,0,,,,,,
600,221,765,599,221,765,,,1,0,0,,,,,,
592,205,95,591,206,95,,,1,-1,0,,,,,,
592,205,97,591,206,95,,,1,-1,2,,,,,,
592,205,103,592,206,103,,,0,-1,0,,,,,,
592,205,114,592,206,115,,,0,-1,-1,,,,,,
592,205,128,592,206,128,,,0,-1,0,,,,,,
592,206,145,592,207,146,,,0,-1,-1,,,,,,
592,206,164,592,207,164,,,0,-1,0,,,,,,
592,206,184,592,207,184,,,0,-1,0,,,,,,
592,207,205,592,208,205,,,0,-1,0,,,,,,
592,207,227,592,208,227,,,0,-1,0,,,,,,
593,208,250,592,209,250,,,1,-1,0,,,,,,
593,208,273,593,209,273,,,0,-1,0,,,,,,
593,209,296,593,210,296,,,0,-1,0,,,,,,
593,210,319,593,211,319,,,0,-1,0,,,,,,
593,210,343,593,212,343,,,0,-2,0,,,,,,
594,211,367,594,212,367,,,0,-1,0,,,,,,
594,212,391,594,213,391,,,0,-1,0,,,,,,
594,213,416,594,214,415,,,0,-1,1,,,,,,
595,214,440,594,215,440,,,1,-1,0,,,,,,
595,215,465,595,216,464,,,0,-1,1,,,,,,
595,217,489,595,217,489,,,0,0,0,,,,,,
596,218,514,596,219,514,,,0,-1,0,,,,,,
596,219,539,596,220,538,,,0,-1,1,,,,,,
597,221,564,597,222,563,,,0,-1,1,,,,,,
597,222,589,597,223,588,,,0,-1,1,,,,,,
597,224,614,598,225,613,,,-1,-1,1,,,,,,
598,225,639,598,226,639,,,0,-1,0,,,,,,
599,227,664,599,228,664,,,0,-1,0,,,,,,
599,229,689,599,230,689,,,0,-1,0,,,,,,
600,231,714,600,231,714,,,0,0,0,,,,,,
600,232,740,600,233,740,,,0,-1,0,,,,,,
601,234,765,601,235,765,,,0,-1,0,,,,,,
593,223,97,593,223,97,,,0,0,0,,,,,,
593,223,99,593,223,97,,,0,0,2,,,,,,
593,223,105,593,223,105,,,0,0,0,,,,,,
594,223,116,593,223,117,,,1,0,-1,,,,,,
594,223,130,594,223,130,,,0,0,0,,,,,,
594,223,147,594,223,147,,,0,0,0,,,,,,
594,224,165,594,224,165,,,0,0,0,,,,,,
594,224,185,594,224,185,,,0,0,0,,,,,,
594,224,206,594,224,206,,,0,0,0,,,,,,
594,225,228,594,224,228,,,0,1,0,,,,,,
594,225,251,594,225,251,,,0,0,0,,,,,,
594,226,273,594,225,274,,,0,1,-1,,,,,,
595,226,297,595,226,297,,,0,0,0,,,,,,
595,227,320,595,227,320,,,0,0,0,,,,,,
595,228,344,595,228,344,,,0,0,0,,,,,,
595,229,368,595,228,368,,,0,1,0,,,,,,
596,229,392,596,229,392,,,0,0,0,,,,,,
596,230,416,596,230,416,,,0,0,0,,,,,,
596,231,440,596,231,440,,,0,0,0,,,,,,
597,232,465,596,232,465,,,1,0,0,,,,,,
597,233,490,597,233,490,,,0,0,0,,,,,,
597,235,514,597,234,514,,,0,1,0,,,,,,
598,236,539,598,236,539,,,0,0,0,,,,,,
598,237,564,598,237,564,,,0,0,0,,,,,,
599,239,589,599,239,589,,,0,0,0,,,,,,
599,240,614,599,240,614,,,0,0,0,,,,,,
600,241,639,600,241,639,,,0,0,0,,,,,,
600,243,664,600,243,664,,,0,0,0,,,,,,
601,245,689,601,245,689,,,0,0,0,,,,,,
601,246,715,601,246,714,,,0,0,1,,,,,,
602,248,740,602,248,740,,,0,0,0,,,,,,
603,250,765,602,250,765,,,1,0,0,,,,,,
595,243,101,595,243,100,,,0,0,1,,,,,,
595,243,102,595,243,100,,,0,0,2,,,,,,
595,243,108,595,243,108,,,0,0,0,,,,,,
596,243,118,595,243,120,,,1,0,-2,,,,,,
596,243,132,596,243,132,,,0,0,0,,,,,,
596,243,149,596,244,149,,,0,-1,0,,,,,,
596,243,167,596,244,167,,,0,-1,0,,,,,,
596,244,187,596,244,187,,,0,0,0,,,,,,
596,244,208,596,244,207,,,0,0,1,,,,,,
596,244,229,596,245,229,,,0,-1,0,,,,,,
596,245,252,596,245,252,,,0,0,0,,,,,,
596,245,274,596,246,275,,,0,-1,-1,,,,,,
597,246,298,597,246,298,,,0,0,0,,,,,,
597,246,321,597,247,321,,,0,-1,0,,,,,,
597,247,345,597,248,345,,,0,-1,0,,,,,,
597,248,368,597,248,368,,,0,0,0,,,,,,
598,249,392,598,249,392,,,0,0,0,,,,,,
598,249,417,598,250,416,,,0,-1,1,,,,,,
598,250,441,598,251,441,,,0,-1,0,,,,,,
599,251,466,598,252,465,,,1,-1,1,,,,,,
599,252,490,599,253,490,,,0,-1,0,,,,,,
599,253,515,599,254,515,,,0,-1,0,,,,,,
600,255,540,600,255,539,,,0,0,1,,,,,,
600,256,564,600,256,564,,,0,0,0,,,,,,
601,257,589,601,258,589,,,0,-1,0,,,,,,
601,258,614,601,259,614,,,0,-1,0,,,,,,
602,260,639,602,260,639,,,0,0,0,,,,,,
602,261,665,602,262,664,,,0,-1,1,,,,,,
603,263,690,603,263,689,,,0,0,1,,,,,,
603,264,715,603,265,715,,,0,-1,0,,,,,,
604,266,740,604,266,740,,,0,0,0,,,,,,
605,267,766,604,268,765,,,1,-1,1,,,,,,
598,264,104,598,264,104,,,0,0,0,,,,,,
598,264,106,598,264,104,,,0,0,2,,,,,,
598,264,112,598,264,112,,,0,0,0,,,,,,
598,264,122,598,264,123,,,0,0,-1,,,,,,
598,264,135,598,264,135,,,0,0,0,,,,,,
598,264,151,598,264,152,,,0,0,-1,,,,,,
598,265,169,598,265,169,,,0,0,0,,,,,,
598,265,189,598,265,189,,,0,0,0,,,,,,
598,265,209,598,265,209,,,0,0,0,,,,,,
598,266,231,598,265,231,,,0,1,0,,,,,,
599,266,253,599,266,253,,,0,0,0,,,,,,
599,266,276,599,266,276,,,0,0,0,,,,,,
599,267,299,599,267,299,,,0,0,0,,,,,,
599,267,322,599,267,322,,,0,0,0,,,,,,
599,268,346,599,268,346,,,0,0,0,,,,,,
600,269,369,599,268,369,,,1,1,0,,,,,,
600,269,393,600,269,393,,,0,0,0,,,,,,
600,270,417,600,270,417,,,0,0,0,,,,,,
601,271,442,601,271,442,,,0,0,0,,,,,,
601,272,466,601,272,466,,,0,0,0,,,,,,
601,273,491,601,273,491,,,0,0,0,,,,,,
602,274,515,601,274,515,,,1,0,0,,,,,,
602,275,540,602,275,540,,,0,0,0,,,,,,
603,276,565,602,276,565,,,1,0,0,,,,,,
603,277,590,603,277,590,,,0,0,0,,,,,,
603,278,615,603,278,615,,,0,0,0,,,,,,
604,280,640,604,280,640,,,0,0,0,,,,,,
605,281,665,604,281,665,,,1,0,0,,,,,,
605,282,690,605,282,690,,,0,0,0,,,,,,
606,284,715,605,283,715,,,1,1,0,,,,,,
606,285,741,606,285,741,,,0,0,0,,,,,,
607,287,766,607,286,766,,,0,1,0,,,,,,
601,287,108,601,287,108,,,0,0,0,,,,,,
601,287,110,601,287,108,,,0,0,2,,,,,,
601,287,115,601,287,115,,,0,0,0,,,,,,
601,287,125,601,287,126,,,0,0,-1,,,,,,
601,287,138,601,287,138,,,0,0,0,,,,,,
601,287,154,601,287,154,,,0,0,0,,,,,,
601,287,172,601,288,171,,,0,-1,1,,,,,,
601,287,191,601,288,191,,,0,-1,0,,,,,,
601,288,211,601,288,211,,,0,0,0,,,,,,
601,288,233,601,288,232,,,0,0,1,,,,,,
601,288,255,602,289,254,,,-1,-1,1,,,,,,
602,289,277,602,289,277,,,0,0,0,,,,,,
602,289,300,602,290,300,,,0,-1,0,,,,,,
602,290,323,602,290,323,,,0,0,0,,,,,,
602,290,347,602,291,347,,,0,-1,0,,,,,,
602,291,370,602,291,370,,,0,0,0,,,,,,
603,292,394,603,292,394,,,0,0,0,,,,,,
603,292,418,603,292,418,,,0,0,0,,,,,,
603,293,443,603,293,443,,,0,0,0,,,,,,
604,294,467,603,294,467,,,1,0,0,,,,,,
604,295,491,604,295,491,,,0,0,0,,,,,,
604,296,516,604,296,516,,,0,0,0,,,,,,
605,297,541,605,297,541,,,0,0,0,,,,,,
605,298,566,605,298,565,,,0,0,1,,,,,,
606,299,591,606,299,590,,,0,0,1,,,,,,
606,300,615,606,300,615,,,0,0,0,,,,,,
607,301,640,607,301,640,,,0,0,0,,,,,,
607,302,666,607,302,665,,,0,0,1,,,,,,
608,303,691,608,304,690,,,0,-1,1,,,,,,
608,305,716,608,305,716,,,0,0,0,,,,,,
609,306,741,609,306,741,,,0,0,0,,,,,,
610,308,767,609,308,766,,,1,0,1,,,,,,
604,310,113,604,310,113,,,0,0,0,,,,,,
604,310,114,604,310,113,,,0,0,1,,,,,,
604,310,119,604,310,119,,,0,0,0,,,,,,
604,310,129,604,310,130,,,0,0,-1,,,,,,
604,310,141,604,310,141,,,0,0,0,,,,,,
604,311,157,604,310,157,,,0,1,0,,,,,,
604,311,174,604,311,174,,,0,0,0,,,,,,
604,311,193,604,311,193,,,0,0,0,,,,,,
604,311,213,604,311,213,,,0,0,0,,,,,,
604,312,235,604,311,234,,,0,1,1,,,,,,
605,312,256,605,312,256,,,0,0,0,,,,,,
605,312,279,605,312,278,,,0,0,1,,,,,,
605,313,301,605,313,301,,,0,0,0,,,,,,
605,313,324,605,313,324,,,0,0,0,,,,,,
605,314,348,605,314,348,,,0,0,0,,,,,,
606,314,371,605,314,371,,,1,0,0,,,,,,
606,315,395,606,315,395,,,0,0,0,,,,,,
606,316,419,606,315,419,,,0,1,0,,,,,,
606,316,444,606,316,444,,,0,0,0,,,,,,
607,317,468,606,317,468,,,1,0,0,,,,,,
607,318,492,607,318,492,,,0,0,0,,,,,,
608,319,517,607,318,517,,,1,1,0,,,,,,
608,319,542,608,319,542,,,0,0,0,,,,,,
608,320,566,608,320,566,,,0,0,0,,,,,,
609,321,591,609,321,591,,,0,0,0,,,,,,
609,322,616,609,322,616,,,0,0,0,,,,,,
610,323,641,610,323,641,,,0,0,0,,,,,,
610,325,666,610,324,666,,,0,1,0,,,,,,
611,326,691,611,326,691,,,0,0,0,,,,,,
611,327,717,611,327,716,,,0,0,1,,,,,,
612,328,742,612,328,742,,,0,0,0,,,,,,
613,330,767,612,329,767,,,1,1,0,,,,,,
607,335,117,607,335,117,,,0,0,0,,,,,,
607,335,119,607,335,117,,,0,0,2,,,,,,
607,335,124,607,335,124,,,0,0,0,,,,,,
607,335,133,607,335,134,,,0,0,-1,,,,,,
607,335,145,607,335,145,,,0,0,0,,,,,,
607,335,160,607,335,161,,,0,0,-1,,,,,,
608,335,177,607,335,177,,,1,0,0,,,,,,
608,335,196,607,335,196,,,1,0,0,,,,,,
608,336,216,608,336,215,,,0,0,1,,,,,,
608,336,237,608,336,236,,,0,0,1,,,,,,
608,336,258,608,336,258,,,0,0,0,,,,,,
608,337,280,608,337,280,,,0,0,0,,,,,,
608,337,303,608,337,303,,,0,0,0,,,,,,
609,337,326,608,338,326,,,1,-1,0,,,,,,
609,338,349,609,338,349,,,0,0,0,,,,,,
609,338,373,609,339,373,,,0,-1,0,,,,,,
609,339,396,609,339,396,,,0,0,0,,,,,,
610,340,420,609,340,420,,,1,0,0,,,,,,
610,340,445,610,340,445,,,0,0,0,,,,,,
610,341,469,610,341,469,,,0,0,0,,,,,,
611,342,493,611,342,493,,,0,0,0,,,,,,
611,342,518,611,342,517,,,0,0,1,,,,,,
611,343,542,611,343,542,,,0,0,0,,,,,,
612,344,567,612,344,567,,,0,0,0,,,,,,
612,345,592,612,345,592,,,0,0,0,,,,,,
613,346,617,613,346,617,,,0,0,0,,,,,,
613,347,642,613,347,642,,,0,0,0,,,,,,
614,348,667,614,348,667,,,0,0,0,,,,,,
614,349,692,614,349,692,,,0,0,0,,,,,,
615,350,717,615,350,717,,,0,0,0,,,,,,
616,351,742,615,351,742,,,1,0,0,,,,,,
616,353,768,616,353,767,,,0,0,1,,,,,,
611,360,122,611,360,122,,,0,0,0,,,,,,
611,360,124,611,360,122,,,0,0,2,,,,,,
611,360,129,611,360,129,,,0,0,0,,,,,,
611,360,137,611,360,139,,,0,0,-2,,,,,,
611,360,149,611,360,149,,,0,0,0,,,,,,
611,360,164,611,360,164,,,0,0,0,,,,,,
611,360,180,611,360,180,,,0,0,0,,,,,,
612,361,199,611,360,199,,,1,1,0,,,,,,
612,361,218,612,361,218,,,0,0,0,,,,,,
612,361,239,612,361,239,,,0,0,0,,,,,,
612,361,260,612,361,260,,,0,0,0,,,,,,
612,362,282,612,361,282,,,0,1,0,,,,,,
612,362,305,612,362,305,,,0,0,0,,,,,,
612,362,328,612,362,328,,,0,0,0,,,,,,
613,363,351,613,363,351,,,0,0,0,,,,,,
613,363,374,613,363,374,,,0,0,0,,,,,,
613,364,398,613,364,398,,,0,0,0,,,,,,
614,364,422,613,364,422,,,1,0,0,,,,,,
614,365,446,614,365,446,,,0,0,0,,,,,,
614,366,470,614,365,470,,,0,1,0,,,,,,
615,366,494,615,366,494,,,0,0,0,,,,,,
615,367,519,615,367,518,,,0,0,1,,,,,,
615,368,543,615,368,543,,,0,0,0,,,,,,
616,369,568,615,368,568,,,1,1,0,,,,,,
616,369,593,616,369,593,,,0,0,0,,,,,,
617,370,618,616,370,618,,,1,0,0,,,,,,
617,371,643,617,371,643,,,0,0,0,,,,,,
618,372,668,617,372,668,,,1,0,0,,,,,,
618,373,693,618,373,693,,,0,0,0,,,,,,
619,374,718,618,374,718,,,1,0,0,,,,,,
619,375,743,619,375,743,,,0,0,0,,,,,,
620,376,768,620,376,768,,,0,0,0,,,,,,
615,386,128,615,386,127,,,0,0,1,,,,,,
615,386,129,615,386,127,,,0,0,2,,,,,,
615,386,134,615,386,134,,,0,0,0,,,,,,
616,386,142,615,386,143,,,1,0,-1,,,,,,
616,386,153,615,386,153,,,1,0,0,,,,,,
616,386,168,615,386,168,,,1,0,0,,,,,,
616,386,184,615,386,184,,,1,0,0,,,,,,
616,386,202,616,386,202,,,0,0,0,,,,,,
616,386,221,616,387,221,,,0,-1,0,,,,,,
616,387,242,616,387,241,,,0,0,1,,,,,,
616,387,263,616,387,262,,,0,0,1,,,,,,
616,387,284,616,387,284,,,0,0,0,,,,,,
617,388,307,616,388,307,,,1,0,0,,,,,,
617,388,329,617,388,329,,,0,0,0,,,,,,
617,388,352,617,388,352,,,0,0,0,,,,,,
617,389,376,617,389,376,,,0,0,0,,,,,,
618,389,399,617,389,399,,,1,0,0,,,,,,
618,390,423,618,390,423,,,0,0,0,,,,,,
618,390,447,618,390,447,,,0,0,0,,,,,,
618,391,471,618,391,471,,,0,0,0,,,,,,
619,392,495,619,391,495,,,0,1,0,,,,,,
619,392,520,619,392,520,,,0,0,0,,,,,,
620,393,544,619,393,544,,,1,0,0,,,,,,
620,394,569,620,394,569,,,0,0,0,,,,,,
620,394,594,620,394,594,,,0,0,0,,,,,,
621,395,619,621,395,618,,,0,0,1,,,,,,
621,396,643,621,396,643,,,0,0,0,,,,,,
622,397,668,622,397,668,,,0,0,0,,,,,,
622,398,693,622,398,693,,,0,0,0,,,,,,
623,399,719,623,399,718,,,0,0,1,,,,,,
624,400,744,623,400,744,,,1,0,0,,,,,,
624,401,769,624,401,769,,,0,0,0,,,,,,
620,412,133,620,412,133,,,0,0,0,,,,,,
620,412,134,620,412,133,,,0,0,1,,,,,,
620,412,139,620,412,139,,,0,0,0,,,,,,
620,412,147,620,412,148,,,0,0,-1,,,,,,
620,412,158,620,412,158,,,0,0,0,,,,,,
620,412,172,620,412,173,,,0,0,-1,,,,,,
620,412,188,620,412,188,,,0,0,0,,,,,,
620,412,205,620,412,206,,,0,0,-1,,,,,,
621,413,224,621,413,224,,,0,0,0,,,,,,
621,413,244,621,413,244,,,0,0,0,,,,,,
621,413,265,621,413,265,,,0,0,0,,,,,,
621,413,287,621,413,287,,,0,0,0,,,,,,
621,414,309,621,414,309,,,0,0,0,,,,,,
621,414,331,621,414,331,,,0,0,0,,,,,,
622,414,354,622,414,354,,,0,0,0,,,,,,
622,415,377,622,414,377,,,0,1,0,,,,,,
622,415,401,622,415,401,,,0,0,0,,,,,,
622,416,425,622,415,424,,,0,1,1,,,,,,
623,416,448,623,416,448,,,0,0,0,,,,,,
623,417,473,623,416,472,,,0,1,1,,,,,,
623,417,497,623,417,497,,,0,0,0,,,,,,
624,418,521,623,418,521,,,1,0,0,,,,,,
624,419,546,624,419,546,,,0,0,0,,,,,,
625,419,570,624,419,570,,,1,0,0,,,,,,
625,420,595,625,420,595,,,0,0,0,,,,,,
626,421,620,625,421,619,,,1,0,1,,,,,,
626,422,644,626,422,644,,,0,0,0,,,,,,
627,422,669,626,422,669,,,1,0,0,,,,,,
627,423,694,627,423,694,,,0,0,0,,,,,,
628,424,719,627,424,719,,,1,0,0,,,,,,
628,425,745,628,425,745,,,0,0,0,,,,,,
629,426,770,628,426,770,,,1,0,0,,,,,,
625,438,139,625,438,139,,,0,0,0,,,,,,
625,438,140,625,438,139,,,0,0,1,,,,,,
625,438,145,625,438,144,,,0,0,1,,,,,,
625,438,152,625,438,153,,,0,0,-1,,,,,,
625,438,163,625,438,163,,,0,0,0,,,,,,
625,439,176,625,438,177,,,0,1,-1,,,,,,
625,439,192,625,439,192,,,0,0,0,,,,,,
625,439,209,625,439,209,,,0,0,0,,,,,,
626,439,228,626,439,227,,,0,0,1,,,,,,
626,439,247,626,439,247,,,0,0,0,,,,,,
626,439,268,626,439,268,,,0,0,0,,,,,,
626,440,289,626,440,289,,,0,0,0,,,,,,
626,440,311,626,440,311,,,0,0,0,,,,,,
626,440,333,626,440,333,,,0,0,0,,,,,,
627,441,356,627,440,356,,,0,1,0,,,,,,
627,441,379,627,441,379,,,0,0,0,,,,,,
627,441,403,627,441,402,,,0,0,1,,,,,,
627,442,426,627,442,426,,,0,0,0,,,,,,
628,442,450,628,442,450,,,0,0,0,,,,,,
628,443,474,628,443,474,,,0,0,0,,,,,,
628,443,498,628,443,498,,,0,0,0,,,,,,
629,444,522,629,444,522,,,0,0,0,,,,,,
629,445,547,629,445,547,,,0,0,0,,,,,,
630,445,571,629,445,571,,,1,0,0,,,,,,
630,446,596,630,446,596,,,0,0,0,,,,,,
631,447,621,630,447,620,,,1,0,1,,,,,,
631,447,645,631,448,645,,,0,-1,0,,,,,,
632,448,670,631,448,670,,,1,0,0,,,,,,
632,449,695,632,449,695,,,0,0,0,,,,,,
633,450,720,632,450,720,,,1,0,0,,,,,,
633,451,745,633,451,745,,,0,0,0,,,,,,
634,452,771,633,452,770,,,1,0,1,,,,,,
631,465,145,631,465,145,,,0,0,0,,,,,,
631,465,146,631,465,145,,,0,0,1,,,,,,
631,465,150,631,465,150,,,0,0,0,,,,,,
631,465,158,631,465,159,,,0,0,-1,,,,,,
631,465,168,631,465,168,,,0,0,0,,,,,,
631,465,181,631,465,182,,,0,0,-1,,,,,,
631,466,196,631,466,196,,,0,0,0,,,,,,
631,466,213,631,466,213,,,0,0,0,,,,,,
631,466,231,631,466,231,,,0,0,0,,,,,,
631,466,251,631,466,251,,,0,0,0,,,,,,
631,466,271,631,466,271,,,0,0,0,,,,,,
631,466,292,631,466,292,,,0,0,0,,,,,,
632,467,314,632,467,314,,,0,0,0,,,,,,
632,467,336,632,467,336,,,0,0,0,,,,,,
632,467,358,632,467,358,,,0,0,0,,,,,,
632,468,381,632,467,381,,,0,1,0,,,,,,
633,468,404,633,468,404,,,0,0,0,,,,,,
633,469,428,633,468,428,,,0,1,0,,,,,,
633,469,452,633,469,452,,,0,0,0,,,,,,
633,469,476,633,469,476,,,0,0,0,,,,,,
634,470,500,634,470,500,,,0,0,0,,,,,,
634,471,524,634,470,524,,,0,1,0,,,,,,
635,471,548,635,471,548,,,0,0,0,,,,,,
635,472,573,635,471,572,,,0,1,1,,,,,,
635,472,597,635,472,597,,,0,0,0,,,,,,
636,473,622,635,473,622,,,1,0,0,,,,,,
636,474,647,636,474,647,,,0,0,0,,,,,,
637,474,671,636,474,671,,,1,0,0,,,,,,
637,475,696,637,475,696,,,0,0,0,,,,,,
638,476,721,637,476,721,,,1,0,0,,,,,,
638,477,746,638,477,746,,,0,0,0,,,,,,
639,478,771,639,478,771,,,0,0,0,,,,,,
636,492,151,636,492,151,,,0,0,0,,,,,,
636,492,152,636,492,151,,,0,0,1,,,,,,
636,492,156,636,492,156,,,0,0,0,,,,,,
636,492,163,636,492,164,,,0,0,-1,,,,,,
636,492,173,637,492,173,,,-1,0,0,,,,,,
636,493,186,637,492,187,,,-1,1,-1,,,,,,
637,493,200,637,493,200,,,0,0,0,,,,,,
637,493,217,637,493,217,,,0,0,0,,,,,,
637,493,235,637,493,235,,,0,0,0,,,,,,
637,493,254,637,493,254,,,0,0,0,,,,,,
637,493,274,637,493,274,,,0,0,0,,,,,,
637,494,295,637,493,295,,,0,1,0,,,,,,
637,494,316,637,494,316,,,0,0,0,,,,,,
638,494,338,637,494,338,,,1,0,0,,,,,,
638,494,361,638,494,360,,,0,0,1,,,,,,
638,495,383,638,494,383,,,0,1,0,,,,,,
638,495,406,638,495,406,,,0,0,0,,,,,,
639,496,430,638,495,430,,,1,1,0,,,,,,
639,496,453,639,496,453,,,0,0,0,,,,,,
639,496,477,639,496,477,,,0,0,0,,,,,,
640,497,501,640,497,501,,,0,0,0,,,,,,
640,497,525,640,497,525,,,0,0,0,,,,,,
640,498,550,640,498,549,,,0,0,1,,,,,,
641,498,574,640,498,574,,,1,0,0,,,,,,
641,499,598,641,499,598,,,0,0,0,,,,,,
642,500,623,641,499,623,,,1,1,0,,,,,,
642,500,648,642,500,648,,,0,0,0,,,,,,
643,501,673,642,501,672,,,1,0,1,,,,,,
643,502,697,643,502,697,,,0,0,0,,,,,,
644,503,722,643,502,722,,,1,1,0,,,,,,
644,503,747,644,503,747,,,0,0,0,,,,,,
645,504,772,644,504,772,,,1,0,0,,,,,,
642,520,158,642,520,158,,,0,0,0,,,,,,
642,520,159,642,520,158,,,0,0,1,,,,,,
642,520,162,642,520,162,,,0,0,0,,,,,,
643,520,169,642,520,170,,,1,0,-1,,,,,,
643,520,179,643,520,179,,,0,0,0,,,,,,
643,520,191,643,520,192,,,0,0,-1,,,,,,
643,520,205,643,520,205,,,0,0,0,,,,,,
643,520,221,643,520,222,,,0,0,-1,,,,,,
643,520,239,643,520,239,,,0,0,0,,,,,,
643,520,258,643,520,258,,,0,0,0,,,,,,
643,521,277,643,521,277,,,0,0,0,,,,,,
643,521,298,643,521,298,,,0,0,0,,,,,,
643,521,319,643,521,319,,,0,0,0,,,,,,
644,521,341,643,521,341,,,1,0,0,,,,,,
644,522,363,644,522,363,,,0,0,0,,,,,,
644,522,386,644,522,386,,,0,0,0,,,,,,
644,522,409,644,522,409,,,0,0,0,,,,,,
645,523,432,644,522,432,,,1,1,0,,,,,,
645,523,455,645,523,455,,,0,0,0,,,,,,
645,524,479,645,523,479,,,0,1,0,,,,,,
646,524,503,646,524,503,,,0,0,0,,,,,,
646,524,527,646,524,527,,,0,0,0,,,,,,
646,525,551,646,525,551,,,0,0,0,,,,,,
647,526,575,646,525,575,,,1,1,0,,,,,,
647,526,600,647,526,600,,,0,0,0,,,,,,
648,527,624,647,526,624,,,1,1,0,,,,,,
648,527,649,648,527,649,,,0,0,0,,,,,,
649,528,674,648,528,674,,,1,0,0,,,,,,
649,529,699,649,529,699,,,0,0,0,,,,,,
650,529,723,649,529,723,,,1,0,0,,,,,,
650,530,748,650,530,748,,,0,0,0,,,,,,
651,531,774,650,531,773,,,1,0,1,,,,,,
649,547,164,649,547,164,,,0,0,0,,,,,,
649,547,165,649,547,164,,,0,0,1,,,,,,
649,547,169,649,547,168,,,0,0,1,,,,,,
649,547,175,649,547,176,,,0,0,-1,,,,,,
649,547,184,649,547,184,,,0,0,0,,,,,,
649,548,196,649,547,197,,,0,1,-1,,,,,,
649,548,210,649,547,210,,,0,1,0,,,,,,
649,548,226,649,547,226,,,0,1,0,,,,,,
649,548,243,649,548,243,,,0,0,0,,,,,,
649,548,261,649,548,261,,,0,0,0,,,,,,
650,548,281,649,548,280,,,1,0,1,,,,,,
650,548,301,649,548,301,,,1,0,0,,,,,,
650,549,322,650,548,322,,,0,1,0,,,,,,
650,549,344,650,549,343,,,0,0,1,,,,,,
650,549,366,650,549,365,,,0,0,1,,,,,,
651,549,388,650,549,388,,,1,0,0,,,,,,
651,550,411,651,549,411,,,0,1,0,,,,,,
651,550,434,651,550,434,,,0,0,0,,,,,,
651,551,457,651,550,457,,,0,1,0,,,,,,
652,551,481,652,551,481,,,0,0,0,,,,,,
652,551,505,652,551,505,,,0,0,0,,,,,,
652,552,529,652,552,528,,,0,0,1,,,,,,
653,552,553,653,552,552,,,0,0,1,,,,,,
653,553,577,653,553,577,,,0,0,0,,,,,,
654,553,601,653,553,601,,,1,0,0,,,,,,
654,554,626,654,554,626,,,0,0,0,,,,,,
655,555,650,654,554,650,,,1,1,0,,,,,,
655,555,675,655,555,675,,,0,0,0,,,,,,
656,556,700,655,556,700,,,1,0,0,,,,,,
656,556,725,656,556,724,,,0,0,1,,,,,,
657,557,750,656,557,749,,,1,0,1,,,,,,
657,558,775,657,558,774,,,0,0,1,,,,,,
656,575,171,656,575,171,,,0,0,0,,,,,,
656,575,171,656,575,171,,,0,0,0,,,,,,
656,575,175,656,575,175,,,0,0,0,,,,,,
656,575,181,656,575,182,,,0,0,-1,,,,,,
656,575,190,656,575,190,,,0,0,0,,,,,,
656,575,201,656,575,202,,,0,0,-1,,,,,,
656,575,215,656,575,215,,,0,0,0,,,,,,
656,576,230,656,575,231,,,0,1,-1,,,,,,
656,576,247,656,576,247,,,0,0,0,,,,,,
656,576,265,656,576,265,,,0,0,0,,,,,,
656,576,284,656,576,284,,,0,0,0,,,,,,
657,576,305,656,576,304,,,1,0,1,,,,,,
657,576,325,657,576,325,,,0,0,0,,,,,,
657,577,347,657,576,346,,,0,1,1,,,,,,
657,577,368,657,577,368,,,0,0,0,,,,,,
657,577,391,657,577,390,,,0,0,1,,,,,,
658,577,413,658,577,413,,,0,0,0,,,,,,
658,578,436,658,577,436,,,0,1,0,,,,,,
658,578,459,658,578,459,,,0,0,0,,,,,,
659,579,483,658,578,483,,,1,1,0,,,,,,
659,579,507,659,579,507,,,0,0,0,,,,,,
659,579,530,659,579,530,,,0,0,0,,,,,,
660,580,554,660,580,554,,,0,0,0,,,,,,
660,580,579,660,580,578,,,0,0,1,,,,,,
660,581,603,660,581,603,,,0,0,0,,,,,,
661,581,627,660,581,627,,,1,0,0,,,,,,
661,582,652,661,582,652,,,0,0,0,,,,,,
662,583,676,661,582,676,,,1,1,0,,,,,,
662,583,701,662,583,701,,,0,0,0,,,,,,
663,584,726,662,583,726,,,1,1,0,,,,,,
663,584,751,663,584,751,,,0,0,0,,,,,,
664,585,776,664,585,776,,,0,0,0,,,,,,
663,603,177,663,603,177,,,0,0,0,,,,,,
663,603,178,663,603,177,,,0,0,1,,,,,,
663,603,181,663,603,181,,,0,0,0,,,,,,
663,603,187,663,603,188,,,0,0,-1,,,,,,
663,603,196,663,603,196,,,0,0,0,,,,,,
663,603,207,663,603,208,,,0,0,-1,,,,,,
663,603,220,663,603,220,,,0,0,0,,,,,,
663,603,235,663,603,236,,,0,0,-1,,,,,,
663,604,252,663,604,251,,,0,0,1,,,,,,
663,604,269,663,604,269,,,0,0,0,,,,,,
664,604,288,663,604,288,,,1,0,0,,,,,,
664,604,308,663,604,308,,,1,0,0,,,,,,
664,604,329,664,604,328,,,0,0,1,,,,,,
664,605,350,664,604,349,,,0,1,1,,,,,,
664,605,371,664,605,371,,,0,0,0,,,,,,
665,605,393,664,605,393,,,1,0,0,,,,,,
665,605,416,665,605,416,,,0,0,0,,,,,,
665,606,439,665,605,438,,,0,1,1,,,,,,
665,606,462,665,606,461,,,0,0,1,,,,,,
666,606,485,665,606,485,,,1,0,0,,,,,,
666,607,509,666,607,509,,,0,0,0,,,,,,
666,607,532,666,607,532,,,0,0,0,,,,,,
667,608,556,667,607,556,,,0,1,0,,,,,,
667,608,580,667,608,580,,,0,0,0,,,,,,
668,609,605,667,608,604,,,1,1,1,,,,,,
668,609,629,668,609,629,,,0,0,0,,,,,,
668,610,653,668,609,653,,,0,1,0,,,,,,
669,610,678,669,610,678,,,0,0,0,,,,,,
669,611,703,669,610,702,,,0,1,1,,,,,,
670,611,727,670,611,727,,,0,0,0,,,,,,
670,612,752,670,612,752,,,0,0,0,,,,,,
671,613,777,671,612,777,,,0,1,0,,,,,,
670,631,184,670,631,184,,,0,0,0,,,,,,
670,631,185,670,631,184,,,0,0,1,,,,,,
670,631,188,670,631,188,,,0,0,0,,,,,,
670,631,194,670,631,195,,,0,0,-1,,,,,,
671,631,202,671,631,202,,,0,0,0,,,,,,
671,631,213,671,631,214,,,0,0,-1,,,,,,
671,632,226,671,632,226,,,0,0,0,,,,,,
671,632,240,671,632,241,,,0,0,-1,,,,,,
671,632,256,671,632,256,,,0,0,0,,,,,,
671,632,274,671,632,274,,,0,0,0,,,,,,
671,632,292,671,632,292,,,0,0,0,,,,,,
671,632,312,671,632,312,,,0,0,0,,,,,,
671,632,332,671,632,332,,,0,0,0,,,,,,
672,633,353,671,632,353,,,1,1,0,,,,,,
672,633,374,672,633,374,,,0,0,0,,,,,,
672,633,396,672,633,396,,,0,0,0,,,,,,
672,633,419,672,633,419,,,0,0,0,,,,,,
673,634,441,672,633,441,,,1,1,0,,,,,,
673,634,464,673,634,464,,,0,0,0,,,,,,
673,634,487,673,634,487,,,0,0,0,,,,,,
673,635,511,673,635,511,,,0,0,0,,,,,,
674,635,534,673,635,534,,,1,0,0,,,,,,
674,635,558,674,635,558,,,0,0,0,,,,,,
675,636,582,674,635,582,,,1,1,0,,,,,,
675,636,606,675,636,606,,,0,0,0,,,,,,
675,637,631,675,636,630,,,0,1,1,,,,,,
676,637,655,676,637,655,,,0,0,0,,,,,,
676,638,679,676,637,679,,,0,1,0,,,,,,
677,638,704,677,638,704,,,0,0,0,,,,,,
677,639,729,677,639,729,,,0,0,0,,,,,,
678,640,754,678,640,754,,,0,0,0,,,,,,
678,640,778,678,640,778,,,0,0,0,,,,,,
678,660,191,678,659,191,,,0,1,0,,,,,,
678,660,192,678,659,191,,,0,1,1,,,,,,
678,660,195,678,659,195,,,0,1,0,,,,,,
678,660,200,678,659,201,,,0,1,-1,,,,,,
678,660,208,678,659,208,,,0,1,0,,,,,,
678,660,219,678,659,220,,,0,1,-1,,,,,,
678,660,231,679,660,231,,,-1,0,0,,,,,,
679,660,245,679,660,246,,,0,0,-1,,,,,,
679,660,261,679,660,261,,,0,0,0,,,,,,
679,660,278,679,660,278,,,0,0,0,,,,,,
679,660,296,679,660,296,,,0,0,0,,,,,,
679,660,316,679,660,316,,,0,0,0,,,,,,
679,661,336,679,660,335,,,0,1,1,,,,,,
679,661,356,679,660,356,,,0,1,0,,,,,,
680,661,378,680,661,377,,,0,0,1,,,,,,
680,661,399,680,661,399,,,0,0,0,,,,,,
680,662,421,680,661,421,,,0,1,0,,,,,,
680,662,444,680,661,444,,,0,1,0,,,,,,
681,662,467,681,662,466,,,0,0,1,,,,,,
681,662,490,681,662,489,,,0,0,1,,,,,,
681,663,513,681,663,513,,,0,0,0,,,,,,
682,663,536,681,663,536,,,1,0,0,,,,,,
682,664,560,682,663,560,,,0,1,0,,,,,,
682,664,584,682,664,584,,,0,0,0,,,,,,
683,664,608,683,664,608,,,0,0,0,,,,,,
683,665,632,683,664,632,,,0,1,0,,,,,,
684,665,657,684,665,656,,,0,0,1,,,,,,
684,666,681,684,665,681,,,0,1,0,,,,,,
685,666,706,685,666,705,,,0,0,1,,,,,,
685,667,730,685,667,730,,,0,0,0,,,,,,
686,667,755,686,668,755,,,0,-1,0,,,,,,
686,668,780,686,668,780,,,0,0,0,,,,,,
686,688,198,686,688,198,,,0,0,0,,,,,,
686,688,199,686,688,198,,,0,0,1,,,,,,
686,688,202,686,688,202,,,0,0,0,,,,,,
686,688,207,686,688,208,,,0,0,-1,,,,,,
686,688,215,686,688,215,,,0,0,0,,,,,,
686,688,225,686,688,226,,,0,0,-1,,,,,,
687,688,237,687,688,237,,,0,0,0,,,,,,
687,688,251,687,688,251,,,0,0,0,,,,,,
687,688,266,687,688,266,,,0,0,0,,,,,,
687,688,283,687,688,283,,,0,0,0,,,,,,
687,689,301,687,689,301,,,0,0,0,,,,,,
687,689,320,687,689,320,,,0,0,0,,,,,,
687,689,339,687,689,339,,,0,0,0,,,,,,
687,689,360,687,689,360,,,0,0,0,,,,,,
688,689,381,688,689,381,,,0,0,0,,,,,,
688,690,402,688,689,402,,,0,1,0,,,,,,
688,690,424,688,690,424,,,0,0,0,,,,,,
688,690,447,688,690,446,,,0,0,1,,,,,,
689,690,469,689,690,469,,,0,0,0,,,,,,
689,691,492,689,690,492,,,0,1,0,,,,,,
689,691,515,689,691,515,,,0,0,0,,,,,,
690,691,539,689,691,538,,,1,0,1,,,,,,
690,692,562,690,692,562,,,0,0,0,,,,,,
690,692,586,690,692,586,,,0,0,0,,,,,,
691,693,610,691,693,610,,,0,0,0,,,,,,
691,693,634,691,693,634,,,0,0,0,,,,,,
692,693,658,692,693,658,,,0,0,0,,,,,,
692,694,683,692,693,682,,,0,1,1,,,,,,
693,694,707,693,694,707,,,0,0,0,,,,,,
693,695,732,693,695,732,,,0,0,0,,,,,,
694,696,757,694,696,757,,,0,0,0,,,,,,
694,696,781,694,696,781,,,0,0,0,,,,,,
695,716,205,694,716,205,,,1,0,0,,,,,,
695,716,206,694,716,205,,,1,0,1,,,,,,
695,716,208,695,716,208,,,0,0,0,,,,,,
695,716,214,695,716,215,,,0,0,-1,,,,,,
695,716,221,695,716,221,,,0,0,0,,,,,,
695,717,231,695,716,232,,,0,1,-1,,,,,,
695,717,243,695,716,242,,,0,1,1,,,,,,
695,717,256,695,716,256,,,0,1,0,,,,,,
695,717,271,695,716,271,,,0,1,0,,,,,,
695,717,288,695,717,288,,,0,0,0,,,,,,
695,717,305,695,717,305,,,0,0,0,,,,,,
696,717,324,695,717,324,,,1,0,0,,,,,,
696,717,343,695,717,343,,,1,0,0,,,,,,
696,718,363,696,717,363,,,0,1,0,,,,,,
696,718,384,696,717,384,,,0,1,0,,,,,,
696,718,406,696,718,405,,,0,0,1,,,,,,
697,718,427,696,718,427,,,1,0,0,,,,,,
697,718,449,697,718,449,,,0,0,0,,,,,,
697,719,472,697,718,472,,,0,1,0,,,,,,
697,719,495,697,719,494,,,0,0,1,,,,,,
698,719,518,697,719,517,,,1,0,1,,,,,,
698,720,541,698,720,541,,,0,0,0,,,,,,
698,720,565,698,720,564,,,0,0,1,,,,,,
699,720,588,699,720,588,,,0,0,0,,,,,,
699,721,612,699,721,612,,,0,0,0,,,,,,
700,721,636,700,721,636,,,0,0,0,,,,,,
700,722,660,700,721,660,,,0,1,0,,,,,,
700,722,685,701,722,684,,,-1,0,1,,,,,,
701,723,709,701,722,709,,,0,1,0,,,,,,
701,723,734,702,723,733,,,-1,0,1,,,,,,
702,724,758,702,724,758,,,0,0,0,,,,,,
702,724,783,703,724,783,,,-1,0,0,,,,,,
703,745,212,703,745,212,,,0,0,0,,,,,,
703,745,213,703,745,212,,,0,0,1,,,,,,
704,745,215,704,745,215,,,0,0,0,,,,,,
704,745,220,704,745,221,,,0,0,-1,,,,,,
704,745,228,704,745,228,,,0,0,0,,,,,,
704,745,237,704,745,238,,,0,0,-1,,,,,,
704,745,248,704,745,248,,,0,0,0,,,,,,
704,745,262,704,745,262,,,0,0,0,,,,,,
704,745,276,704,745,276,,,0,0,0,,,,,,
704,745,293,704,745,293,,,0,0,0,,,,,,
704,746,310,704,746,310,,,0,0,0,,,,,,
704,746,328,704,746,328,,,0,0,0,,,,,,
704,746,347,704,746,347,,,0,0,0,,,,,,
705,746,367,704,746,367,,,1,0,0,,,,,,
705,746,388,705,746,388,,,0,0,0,,,,,,
705,747,409,705,746,409,,,0,1,0,,,,,,
705,747,430,705,747,430,,,0,0,0,,,,,,
706,747,452,705,747,452,,,1,0,0,,,,,,
706,747,475,706,747,475,,,0,0,0,,,,,,
706,748,497,706,747,497,,,0,1,0,,,,,,
706,748,520,706,748,520,,,0,0,0,,,,,,
707,748,544,706,748,543,,,1,0,1,,,,,,
707,749,567,707,749,567,,,0,0,0,,,,,,
707,749,591,707,749,590,,,0,0,1,,,,,,
708,749,614,708,749,614,,,0,0,0,,,,,,
708,750,638,708,749,638,,,0,1,0,,,,,,
709,750,662,709,750,662,,,0,0,0,,,,,,
709,751,686,709,750,686,,,0,1,0,,,,,,
710,751,711,710,751,711,,,0,0,0,,,,,,
710,751,735,710,751,735,,,0,0,0,,,,,,
711,752,760,711,752,760,,,0,0,0,,,,,,
711,752,784,711,752,784,,,0,0,0,,,,,,
713,774,219,712,773,219,,,1,1,0,,,,,,
713,774,220,712,773,219,,,1,1,1,,,,,,
713,774,223,713,774,222,,,0,0,1,,,,,,
713,774,227,713,774,228,,,0,0,-1,,,,,,
713,774,234,713,774,234,,,0,0,0,,,,,,
713,774,243,713,774,244,,,0,0,-1,,,,,,
713,774,254,713,774,254,,,0,0,0,,,,,,
713,774,267,713,774,268,,,0,0,-1,,,,,,
713,774,282,713,774,281,,,0,0,1,,,,,,
713,774,298,713,774,298,,,0,0,0,,,,,,
713,774,315,713,774,314,,,0,0,1,,,,,,
713,774,333,713,774,333,,,0,0,0,,,,,,
713,775,352,713,774,351,,,0,1,1,,,,,,
714,775,371,713,774,371,,,1,1,0,,,,,,
714,775,392,714,775,391,,,0,0,1,,,,,,
714,775,412,714,775,412,,,0,0,0,,,,,,
714,775,434,714,775,433,,,0,0,1,,,,,,
714,776,456,714,775,455,,,0,1,1,,,,,,
715,776,478,715,776,478,,,0,0,0,,,,,,
715,776,500,715,776,500,,,0,0,0,,,,,,
715,776,523,715,776,523,,,0,0,0,,,,,,
716,777,546,715,777,546,,,1,0,0,,,,,,
716,777,569,716,777,569,,,0,0,0,,,,,,
716,777,593,716,777,593,,,0,0,0,,,,,,
717,778,616,717,777,616,,,0,1,0,,,,,,
717,778,640,717,778,640,,,0,0,0,,,,,,
718,779,664,718,778,664,,,0,1,0,,,,,,
718,779,688,718,779,688,,,0,0,0,,,,,,
718,779,713,719,779,713,,,-1,0,0,,,,,,
719,780,737,719,780,737,,,0,0,0,,,,,,
719,780,762,720,780,761,,,-1,0,1,,,,,,
720,781,786,720,781,786,,,0,0,0,,,,,,
722,802,226,722,802,226,,,0,0,0,,,,,,
722,802,227,722,802,226,,,0,0,1,,,,,,
722,803,230,722,803,230,,,0,0,0,,,,,,
722,803,234,722,803,235,,,0,0,-1,,,,,,
722,803,241,722,803,241,,,0,0,0,,,,,,
722,803,250,722,803,251,,,0,0,-1,,,,,,
722,803,261,722,803,261,,,0,0,0,,,,,,
722,803,273,722,803,274,,,0,0,-1,,,,,,
722,803,287,722,803,287,,,0,0,0,,,,,,
722,803,303,722,803,303,,,0,0,0,,,,,,
722,803,319,722,803,319,,,0,0,0,,,,,,
723,803,337,722,803,337,,,1,0,0,,,,,,
723,803,356,723,803,356,,,0,0,0,,,,,,
723,804,375,723,803,375,,,0,1,0,,,,,,
723,804,395,723,804,395,,,0,0,0,,,,,,
723,804,416,723,804,416,,,0,0,0,,,,,,
724,804,437,724,804,437,,,0,0,0,,,,,,
724,804,459,724,804,459,,,0,0,0,,,,,,
724,805,481,724,805,481,,,0,0,0,,,,,,
724,805,503,724,805,503,,,0,0,0,,,,,,
725,805,526,725,805,526,,,0,0,0,,,,,,
725,805,549,725,805,549,,,0,0,0,,,,,,
725,806,572,725,806,572,,,0,0,0,,,,,,
726,806,595,725,806,595,,,1,0,0,,,,,,
726,806,619,726,806,619,,,0,0,0,,,,,,
726,807,643,726,806,642,,,0,1,1,,,,,,
727,807,666,727,807,666,,,0,0,0,,,,,,
727,808,691,727,807,690,,,0,1,1,,,,,,
728,808,715,728,808,715,,,0,0,0,,,,,,
728,808,739,728,808,739,,,0,0,0,,,,,,
729,809,763,729,809,763,,,0,0,0,,,,,,
729,809,788,729,809,788,,,0,0,0,,,,,,
731,831,234,731,831,233,,,0,0,1,,,,,,
731,831,234,731,831,233,,,0,0,1,,,,,,
731,831,237,731,831,237,,,0,0,0,,,,,,
731,831,241,731,831,242,,,0,0,-1,,,,,,
731,831,248,731,831,248,,,0,0,0,,,,,,
731,831,256,731,831,257,,,0,0,-1,,,,,,
732,832,267,731,831,267,,,1,1,0,,,,,,
732,832,279,731,831,280,,,1,1,-1,,,,,,
732,832,293,731,832,293,,,1,0,0,,,,,,
732,832,308,731,832,308,,,1,0,0,,,,,,
732,832,324,732,832,324,,,0,0,0,,,,,,
732,832,342,732,832,342,,,0,0,0,,,,,,
732,832,360,732,832,360,,,0,0,0,,,,,,
732,832,379,732,832,379,,,0,0,0,,,,,,
733,833,399,732,832,399,,,1,1,0,,,,,,
733,833,420,733,832,419,,,0,1,1,,,,,,
733,833,441,733,833,440,,,0,0,1,,,,,,
733,833,462,733,833,462,,,0,0,0,,,,,,
734,833,484,733,833,484,,,1,0,0,,,,,,
734,834,506,734,833,506,,,0,1,0,,,,,,
734,834,529,734,834,529,,,0,0,0,,,,,,
734,834,551,734,834,551,,,0,0,0,,,,,,
735,834,575,734,834,574,,,1,0,1,,,,,,
735,835,598,735,834,598,,,0,1,0,,,,,,
735,835,621,735,835,621,,,0,0,0,,,,,,
736,835,645,736,835,645,,,0,0,0,,,,,,
736,836,669,736,836,668,,,0,0,1,,,,,,
737,836,693,737,836,692,,,0,0,1,,,,,,
737,837,717,737,836,717,,,0,1,0,,,,,,
738,837,741,738,837,741,,,0,0,0,,,,,,
738,838,765,738,837,765,,,0,1,0,,,,,,
739,838,790,739,838,789,,,0,0,1,,,,,,
741,860,241,741,860,241,,,0,0,0,,,,,,
741,860,242,741,860,241,,,0,0,1,,,,,,
741,860,244,741,860,244,,,0,0,0,,,,,,
741,860,248,741,860,249,,,0,0,-1,,,,,,
741,860,255,741,860,255,,,0,0,0,,,,,,
741,860,263,741,860,264,,,0,0,-1,,,,,,
741,860,273,741,860,273,,,0,0,0,,,,,,
741,861,285,741,860,286,,,0,1,-1,,,,,,
741,861,299,741,861,299,,,0,0,0,,,,,,
742,861,314,741,861,314,,,1,0,0,,,,,,
742,861,330,742,861,330,,,0,0,0,,,,,,
742,861,347,742,861,347,,,0,0,0,,,,,,
742,861,365,742,861,365,,,0,0,0,,,,,,
742,861,384,742,861,384,,,0,0,0,,,,,,
742,861,403,742,861,403,,,0,0,0,,,,,,
743,862,424,742,861,423,,,1,1,1,,,,,,
743,862,444,743,862,444,,,0,0,0,,,,,,
743,862,466,743,862,465,,,0,0,1,,,,,,
743,862,487,743,862,487,,,0,0,0,,,,,,
744,862,509,743,862,509,,,1,0,0,,,,,,
744,863,532,744,863,532,,,0,0,0,,,,,,
744,863,554,744,863,554,,,0,0,0,,,,,,
744,863,577,744,863,577,,,0,0,0,,,,,,
745,864,600,744,863,600,,,1,1,0,,,,,,
745,864,624,745,864,624,,,0,0,0,,,,,,
746,864,647,745,864,647,,,1,0,0,,,,,,
746,865,671,746,865,671,,,0,0,0,,,,,,
746,865,695,746,865,695,,,0,0,0,,,,,,
747,865,719,747,865,719,,,0,0,0,,,,,,
747,866,743,747,865,743,,,0,1,0,,,,,,
748,866,767,748,866,767,,,0,0,0,,,,,,
748,867,792,748,866,791,,,0,1,1,,,,,,
751,889,248,751,889,248,,,0,0,0,,,,,,
751,889,249,751,889,248,,,0,0,1,,,,,,
751,889,251,751,889,251,,,0,0,0,,,,,,
751,889,255,751,889,256,,,0,0,-1,,,,,,
751,889,262,751,889,262,,,0,0,0,,,,,,
751,889,270,751,889,270,,,0,0,0,,,,,,
751,889,280,751,889,279,,,0,0,1,,,,,,
751,890,291,751,889,292,,,0,1,-1,,,,,,
752,890,304,751,890,304,,,1,0,0,,,,,,
752,890,319,751,890,319,,,1,0,0,,,,,,
752,890,335,752,890,335,,,0,0,0,,,,,,
752,890,352,752,890,352,,,0,0,0,,,,,,
752,890,370,752,890,369,,,0,0,1,,,,,,
752,890,388,752,890,388,,,0,0,0,,,,,,
752,890,408,752,890,407,,,0,0,1,,,,,,
753,891,428,752,890,427,,,1,1,1,,,,,,
753,891,448,753,891,448,,,0,0,0,,,,,,
753,891,469,753,891,469,,,0,0,0,,,,,,
753,891,491,753,891,490,,,0,0,1,,,,,,
754,891,513,753,891,512,,,1,0,1,,,,,,
754,892,535,754,892,535,,,0,0,0,,,,,,
754,892,557,754,892,557,,,0,0,0,,,,,,
755,892,580,754,892,580,,,1,0,0,,,,,,
755,893,603,754,892,603,,,1,1,0,,,,,,
755,893,626,755,893,626,,,0,0,0,,,,,,
756,893,650,755,893,650,,,1,0,0,,,,,,
756,894,673,756,893,673,,,0,1,0,,,,,,
756,894,697,756,893,697,,,0,1,0,,,,,,
757,894,721,757,894,721,,,0,0,0,,,,,,
757,895,745,757,894,745,,,0,1,0,,,,,,
758,895,769,758,895,769,,,0,0,0,,,,,,
758,895,794,758,895,793,,,0,0,1,,,,,,
616,170,93,616,170,93,,,0,0,0,,,,,,
616,170,95,616,170,93,,,0,0,2,,,,,,
616,171,102,616,170,101,,,0,1,1,,,,,,
616,171,113,616,170,114,,,0,1,-1,,,,,,
616,171,127,616,171,127,,,0,0,0,,,,,,
616,171,144,616,171,145,,,0,0,-1,,,,,,
617,171,163,617,171,163,,,0,0,0,,,,,,
617,172,183,617,172,184,,,0,0,-1,,,,,,
617,172,205,617,172,205,,,0,0,0,,,,,,
617,173,227,617,173,227,,,0,0,0,,,,,,
617,174,249,617,173,249,,,0,1,0,,,,,,
617,174,272,617,174,272,,,0,0,0,,,,,,
617,175,295,617,175,295,,,0,0,0,,,,,,
618,176,319,617,176,319,,,1,0,0,,,,,,
618,177,343,618,177,343,,,0,0,0,,,,,,
618,178,367,618,178,367,,,0,0,0,,,,,,
618,179,391,618,179,391,,,0,0,0,,,,,,
619,180,415,618,180,415,,,1,0,0,,,,,,
619,182,440,619,182,439,,,0,0,1,,,,,,
619,183,464,619,183,464,,,0,0,0,,,,,,
620,185,489,619,185,489,,,1,0,0,,,,,,
620,186,514,620,186,513,,,0,0,1,,,,,,
620,188,539,620,188,538,,,0,0,1,,,,,,
621,189,563,621,189,563,,,0,0,0,,,,,,
621,191,588,621,191,588,,,0,0,0,,,,,,
622,193,613,622,193,613,,,0,0,0,,,,,,
622,195,639,622,195,638,,,0,0,1,,,,,,
623,197,664,623,196,663,,,0,1,1,,,,,,
623,199,689,623,198,689,,,0,1,0,,,,,,
624,201,714,624,201,714,,,0,0,0,,,,,,
624,203,740,624,203,739,,,0,0,1,,,,,,
625,205,765,625,205,765,,,0,0,0,,,,,,
616,172,93,616,170,93,,,0,2,0,,,,,,
616,172,95,616,170,93,,,0,2,2,,,,,,
616,172,102,616,170,101,,,0,2,1,,,,,,
616,172,113,616,170,114,,,0,2,-1,,,,,,
617,172,127,616,171,127,,,1,1,0,,,,,,
617,172,144,616,171,145,,,1,1,-1,,,,,,
617,173,163,617,171,163,,,0,2,0,,,,,,
617,173,184,617,172,184,,,0,1,0,,,,,,
617,174,205,617,172,205,,,0,2,0,,,,,,
617,174,227,617,173,227,,,0,1,0,,,,,,
617,175,249,617,173,249,,,0,2,0,,,,,,
617,176,272,617,174,272,,,0,2,0,,,,,,
618,176,295,617,175,295,,,1,1,0,,,,,,
618,177,319,617,176,319,,,1,1,0,,,,,,
618,178,343,618,177,343,,,0,1,0,,,,,,
618,179,367,618,178,367,,,0,1,0,,,,,,
618,180,391,618,179,391,,,0,1,0,,,,,,
619,182,415,618,180,415,,,1,2,0,,,,,,
619,183,440,619,182,439,,,0,1,1,,,,,,
619,184,464,619,183,464,,,0,1,0,,,,,,
620,186,489,619,185,489,,,1,1,0,,,,,,
620,187,514,620,186,513,,,0,1,1,,,,,,
621,189,539,620,188,538,,,1,1,1,,,,,,
621,191,563,621,189,563,,,0,2,0,,,,,,
621,192,588,621,191,588,,,0,1,0,,,,,,
622,194,614,622,193,613,,,0,1,1,,,,,,
622,196,639,622,195,638,,,0,1,1,,,,,,
623,198,664,623,196,663,,,0,2,1,,,,,,
623,200,689,623,198,689,,,0,2,0,,,,,,
624,202,714,624,201,714,,,0,1,0,,,,,,
625,204,740,624,203,739,,,1,1,1,,,,,,
625,206,765,625,205,765,,,0,1,0,,,,,,
617,176,94,617,176,94,,,0,0,0,,,,,,
617,176,96,617,176,94,,,0,0,2,,,,,,
617,176,102,617,176,102,,,0,0,0,,,,,,
617,177,113,617,176,115,,,0,1,-2,,,,,,
617,177,128,617,176,128,,,0,1,0,,,,,,
617,177,145,617,177,145,,,0,0,0,,,,,,
617,177,164,617,177,163,,,0,0,1,,,,,,
617,178,184,617,178,184,,,0,0,0,,,,,,
617,178,205,617,178,205,,,0,0,0,,,,,,
617,179,227,617,179,227,,,0,0,0,,,,,,
617,179,249,617,179,249,,,0,0,0,,,,,,
618,180,272,617,180,272,,,1,0,0,,,,,,
618,181,296,618,181,296,,,0,0,0,,,,,,
618,182,319,618,182,319,,,0,0,0,,,,,,
618,183,343,618,183,343,,,0,0,0,,,,,,
619,184,367,618,184,367,,,1,0,0,,,,,,
619,185,391,619,185,391,,,0,0,0,,,,,,
619,186,415,619,186,415,,,0,0,0,,,,,,
619,187,440,619,187,440,,,0,0,0,,,,,,
620,189,464,619,188,464,,,1,1,0,,,,,,
620,190,489,620,190,489,,,0,0,0,,,,,,
620,191,514,620,191,513,,,0,0,1,,,,,,
621,193,539,621,193,538,,,0,0,1,,,,,,
621,195,564,621,194,563,,,0,1,1,,,,,,
622,196,589,621,196,588,,,1,0,1,,,,,,
622,198,614,622,198,613,,,0,0,1,,,,,,
623,200,639,622,200,638,,,1,0,1,,,,,,
623,202,664,623,202,664,,,0,0,0,,,,,,
624,204,689,623,204,689,,,1,0,0,,,,,,
624,206,714,624,206,714,,,0,0,0,,,,,,
625,208,740,624,208,739,,,1,0,1,,,,,,
625,210,765,625,210,765,,,0,0,0,,,,,,
617,185,95,617,186,95,,,0,-1,0,,,,,,
617,185,97,617,186,95,,,0,-1,2,,,,,,
617,185,103,617,186,103,,,0,-1,0,,,,,,
617,185,114,617,186,116,,,0,-1,-2,,,,,,
617,185,128,617,186,128,,,0,-1,0,,,,,,
618,185,145,617,187,146,,,1,-2,-1,,,,,,
618,186,164,617,187,164,,,1,-1,0,,,,,,
618,186,184,617,188,184,,,1,-2,0,,,,,,
618,186,205,618,188,205,,,0,-2,0,,,,,,
618,187,227,618,189,227,,,0,-2,0,,,,,,
618,188,250,618,189,250,,,0,-1,0,,,,,,
618,188,273,618,190,273,,,0,-2,0,,,,,,
618,189,296,618,190,296,,,0,-1,0,,,,,,
619,190,319,618,191,319,,,1,-1,0,,,,,,
619,191,343,619,192,343,,,0,-1,0,,,,,,
619,192,367,619,193,367,,,0,-1,0,,,,,,
619,193,391,619,194,391,,,0,-1,0,,,,,,
620,194,416,620,195,415,,,0,-1,1,,,,,,
620,195,440,620,196,440,,,0,-1,0,,,,,,
620,196,465,620,197,464,,,0,-1,1,,,,,,
621,198,489,620,199,489,,,1,-1,0,,,,,,
621,199,514,621,200,514,,,0,-1,0,,,,,,
621,201,539,621,202,538,,,0,-1,1,,,,,,
622,202,564,622,203,563,,,0,-1,1,,,,,,
622,204,589,622,205,588,,,0,-1,1,,,,,,
623,205,614,623,207,613,,,0,-2,1,,,,,,
623,207,639,623,209,639,,,0,-2,0,,,,,,
624,209,664,624,210,664,,,0,-1,0,,,,,,
624,211,689,624,212,689,,,0,-1,0,,,,,,
625,213,714,625,214,714,,,0,-1,0,,,,,,
625,215,740,625,216,739,,,0,-1,1,,,,,,
626,217,765,626,218,765,,,0,-1,0,,,,,,
618,196,97,618,196,97,,,0,0,0,,,,,,
618,196,98,618,196,97,,,0,0,1,,,,,,
618,196,105,618,196,104,,,0,0,1,,,,,,
618,197,115,618,196,117,,,0,1,-2,,,,,,
618,197,129,618,196,129,,,0,1,0,,,,,,
618,197,146,618,197,147,,,0,0,-1,,,,,,
619,197,165,618,197,165,,,1,0,0,,,,,,
619,198,185,618,198,185,,,1,0,0,,,,,,
619,198,206,619,198,206,,,0,0,0,,,,,,
619,198,228,619,199,228,,,0,-1,0,,,,,,
619,199,250,619,199,250,,,0,0,0,,,,,,
619,200,273,619,200,273,,,0,0,0,,,,,,
619,200,296,619,200,296,,,0,0,0,,,,,,
620,201,320,619,201,320,,,1,0,0,,,,,,
620,202,344,620,202,344,,,0,0,0,,,,,,
620,203,368,620,203,368,,,0,0,0,,,,,,
620,204,392,620,204,392,,,0,0,0,,,,,,
621,205,416,620,205,416,,,1,0,0,,,,,,
621,206,440,621,206,440,,,0,0,0,,,,,,
621,207,465,621,207,465,,,0,0,0,,,,,,
622,209,489,621,208,489,,,1,1,0,,,,,,
622,210,514,622,209,514,,,0,1,0,,,,,,
622,211,539,622,211,539,,,0,0,0,,,,,,
623,213,564,623,212,563,,,0,1,1,,,,,,
623,214,589,623,214,588,,,0,0,1,,,,,,
624,216,614,624,216,614,,,0,0,0,,,,,,
624,218,639,624,218,639,,,0,0,0,,,,,,
625,219,664,625,219,664,,,0,0,0,,,,,,
625,221,689,625,221,689,,,0,0,0,,,,,,
626,223,715,626,223,714,,,0,0,1,,,,,,
626,225,740,626,225,740,,,0,0,0,,,,,,
627,227,765,627,227,765,,,0,0,0,,,,,,
620,211,99,619,212,99,,,1,-1,0,,,,,,
620,211,100,619,212,99,,,1,-1,1,,,,,,
620,211,107,619,212,106,,,1,-1,1,,,,,,
620,211,117,619,212,118,,,1,-1,-1,,,,,,
620,211,131,620,212,131,,,0,-1,0,,,,,,
620,212,148,620,213,148,,,0,-1,0,,,,,,
620,212,166,620,213,166,,,0,-1,0,,,,,,
620,212,186,620,213,186,,,0,-1,0,,,,,,
620,213,207,620,214,207,,,0,-1,0,,,,,,
620,213,229,620,214,229,,,0,-1,0,,,,,,
620,214,251,620,215,251,,,0,-1,0,,,,,,
620,214,274,620,215,274,,,0,-1,0,,,,,,
621,215,297,621,216,297,,,0,-1,0,,,,,,
621,216,320,621,216,320,,,0,0,0,,,,,,
621,216,344,621,217,344,,,0,-1,0,,,,,,
621,217,368,621,218,368,,,0,-1,0,,,,,,
622,218,392,622,219,392,,,0,-1,0,,,,,,
622,219,416,622,220,416,,,0,-1,0,,,,,,
622,220,441,622,221,440,,,0,-1,1,,,,,,
622,221,465,622,222,465,,,0,-1,0,,,,,,
623,222,490,623,223,490,,,0,-1,0,,,,,,
623,224,515,623,224,514,,,0,0,1,,,,,,
624,225,539,624,226,539,,,0,-1,0,,,,,,
624,226,564,624,227,564,,,0,-1,0,,,,,,
624,228,589,625,229,589,,,-1,-1,0,,,,,,
625,229,614,625,230,614,,,0,-1,0,,,,,,
625,231,639,625,232,639,,,0,-1,0,,,,,,
626,232,664,626,233,664,,,0,-1,0,,,,,,
626,234,690,626,235,689,,,0,-1,1,,,,,,
627,236,715,627,237,714,,,0,-1,1,,,,,,
628,238,740,627,239,740,,,1,-1,0,,,,,,
628,240,766,628,240,765,,,0,0,1,,,,,,
621,228,101,621,228,101,,,0,0,0,,,,,,
621,228,103,621,228,101,,,0,0,2,,,,,,
621,228,109,621,228,108,,,0,0,1,,,,,,
621,228,119,621,228,120,,,0,0,-1,,,,,,
621,229,133,621,228,133,,,0,1,0,,,,,,
621,229,149,621,229,150,,,0,0,-1,,,,,,
621,229,168,621,229,167,,,0,0,1,,,,,,
621,229,187,621,229,187,,,0,0,0,,,,,,
622,230,208,621,229,208,,,1,1,0,,,,,,
622,230,230,621,230,230,,,1,0,0,,,,,,
622,231,252,621,230,252,,,1,1,0,,,,,,
622,231,275,622,231,275,,,0,0,0,,,,,,
622,232,298,622,231,298,,,0,1,0,,,,,,
622,232,321,622,232,321,,,0,0,0,,,,,,
623,233,345,622,233,345,,,1,0,0,,,,,,
623,234,369,623,234,369,,,0,0,0,,,,,,
623,235,393,623,234,393,,,0,1,0,,,,,,
623,236,417,623,235,417,,,0,1,0,,,,,,
624,237,441,623,236,441,,,1,1,0,,,,,,
624,238,466,624,237,465,,,0,1,1,,,,,,
624,239,490,624,238,490,,,0,1,0,,,,,,
625,240,515,625,239,515,,,0,1,0,,,,,,
625,241,540,625,241,539,,,0,0,1,,,,,,
626,242,565,626,242,564,,,0,0,1,,,,,,
626,244,589,626,244,589,,,0,0,0,,,,,,
627,245,615,626,245,614,,,1,0,1,,,,,,
627,247,640,627,246,639,,,0,1,1,,,,,,
627,248,665,627,248,664,,,0,0,1,,,,,,
628,250,690,628,250,689,,,0,0,1,,,,,,
629,251,715,628,251,715,,,1,0,0,,,,,,
629,253,740,629,253,740,,,0,0,0,,,,,,
630,255,766,629,254,766,,,1,1,0,,,,,,
623,248,104,623,248,104,,,0,0,0,,,,,,
623,248,106,623,248,104,,,0,0,2,,,,,,
623,248,112,623,248,111,,,0,0,1,,,,,,
623,248,122,623,248,123,,,0,0,-1,,,,,,
623,248,135,623,248,135,,,0,0,0,,,,,,
623,248,151,623,249,152,,,0,-1,-1,,,,,,
623,248,169,623,249,169,,,0,-1,0,,,,,,
623,249,189,623,249,189,,,0,0,0,,,,,,
623,249,210,623,249,209,,,0,0,1,,,,,,
624,249,231,623,250,231,,,1,-1,0,,,,,,
624,250,253,623,250,253,,,1,0,0,,,,,,
624,250,276,624,251,276,,,0,-1,0,,,,,,
624,251,299,624,251,299,,,0,0,0,,,,,,
624,251,322,624,252,322,,,0,-1,0,,,,,,
625,252,346,624,253,345,,,1,-1,1,,,,,,
625,253,369,625,253,369,,,0,0,0,,,,,,
625,253,393,625,254,393,,,0,-1,0,,,,,,
625,254,417,625,255,417,,,0,-1,0,,,,,,
626,255,442,625,256,441,,,1,-1,1,,,,,,
626,256,466,626,257,466,,,0,-1,0,,,,,,
626,257,491,626,258,491,,,0,-1,0,,,,,,
627,258,515,627,259,515,,,0,-1,0,,,,,,
627,259,540,627,260,540,,,0,-1,0,,,,,,
628,260,565,627,261,565,,,1,-1,0,,,,,,
628,262,590,628,262,590,,,0,0,0,,,,,,
628,263,615,628,264,615,,,0,-1,0,,,,,,
629,264,640,629,265,640,,,0,-1,0,,,,,,
629,266,665,629,266,665,,,0,0,0,,,,,,
630,267,690,630,268,690,,,0,-1,0,,,,,,
630,269,716,630,269,715,,,0,0,1,,,,,,
631,270,741,631,271,741,,,0,-1,0,,,,,,
632,272,766,631,272,766,,,1,0,0,,,,,,
625,269,108,625,268,107,,,0,1,1,,,,,,
625,269,109,625,268,107,,,0,1,2,,,,,,
625,269,115,625,268,115,,,0,1,0,,,,,,
625,269,125,625,268,126,,,0,1,-1,,,,,,
625,269,138,625,268,137,,,0,1,1,,,,,,
625,269,153,625,269,154,,,0,0,-1,,,,,,
626,269,171,625,269,171,,,1,0,0,,,,,,
626,269,191,625,269,191,,,1,0,0,,,,,,
626,270,211,625,269,211,,,1,1,0,,,,,,
626,270,232,625,270,232,,,1,0,0,,,,,,
626,270,254,626,270,254,,,0,0,0,,,,,,
626,271,277,626,271,277,,,0,0,0,,,,,,
626,271,300,626,271,300,,,0,0,0,,,,,,
627,272,323,626,272,323,,,1,0,0,,,,,,
627,273,346,626,272,346,,,1,1,0,,,,,,
627,273,370,627,273,370,,,0,0,0,,,,,,
627,274,394,627,274,394,,,0,0,0,,,,,,
628,275,418,627,274,418,,,1,1,0,,,,,,
628,275,442,628,275,442,,,0,0,0,,,,,,
628,276,467,628,276,467,,,0,0,0,,,,,,
629,277,491,628,277,491,,,1,0,0,,,,,,
629,278,516,629,278,516,,,0,0,0,,,,,,
629,279,541,629,279,540,,,0,0,1,,,,,,
630,280,566,629,280,565,,,1,0,1,,,,,,
630,282,590,630,281,590,,,0,1,0,,,,,,
631,283,615,630,282,615,,,1,1,0,,,,,,
631,284,640,631,284,640,,,0,0,0,,,,,,
632,285,666,631,285,665,,,1,0,1,,,,,,
632,287,691,632,286,690,,,0,1,1,,,,,,
633,288,716,632,288,716,,,1,0,0,,,,,,
633,289,741,633,289,741,,,0,0,0,,,,,,
634,291,767,634,291,766,,,0,0,1,,,,,,
628,291,112,628,291,111,,,0,0,1,,,,,,
628,291,113,628,291,111,,,0,0,2,,,,,,
628,291,118,628,291,118,,,0,0,0,,,,,,
628,291,128,628,291,129,,,0,0,-1,,,,,,
628,291,141,628,291,140,,,0,0,1,,,,,,
628,291,156,628,291,157,,,0,0,-1,,,,,,
628,291,174,628,292,173,,,0,-1,1,,,,,,
628,292,193,628,292,193,,,0,0,0,,,,,,
628,292,213,628,292,213,,,0,0,0,,,,,,
628,292,234,628,292,234,,,0,0,0,,,,,,
629,293,256,629,293,256,,,0,0,0,,,,,,
629,293,278,629,293,278,,,0,0,0,,,,,,
629,293,301,629,294,301,,,0,-1,0,,,,,,
629,294,324,629,294,324,,,0,0,0,,,,,,
629,294,348,629,295,347,,,0,-1,1,,,,,,
630,295,371,629,295,371,,,1,0,0,,,,,,
630,296,395,630,296,395,,,0,0,0,,,,,,
630,296,419,630,297,419,,,0,-1,0,,,,,,
631,297,443,630,297,443,,,1,0,0,,,,,,
631,298,468,631,298,467,,,0,0,1,,,,,,
631,299,492,631,299,492,,,0,0,0,,,,,,
632,300,517,631,300,516,,,1,0,1,,,,,,
632,301,541,632,301,541,,,0,0,0,,,,,,
632,302,566,632,302,566,,,0,0,0,,,,,,
633,303,591,633,303,591,,,0,0,0,,,,,,
633,304,616,633,304,616,,,0,0,0,,,,,,
634,305,641,634,305,641,,,0,0,0,,,,,,
634,306,666,634,306,666,,,0,0,0,,,,,,
635,307,691,635,308,691,,,0,-1,0,,,,,,
635,309,716,635,309,716,,,0,0,0,,,,,,
636,310,742,636,310,742,,,0,0,0,,,,,,
636,311,767,636,312,767,,,0,-1,0,,,,,,
631,314,116,631,314,116,,,0,0,0,,,,,,
631,314,117,631,314,116,,,0,0,1,,,,,,
631,314,122,631,314,122,,,0,0,0,,,,,,
631,314,132,631,314,133,,,0,0,-1,,,,,,
631,314,144,631,314,144,,,0,0,0,,,,,,
631,314,159,631,314,160,,,0,0,-1,,,,,,
631,315,176,631,315,176,,,0,0,0,,,,,,
631,315,195,631,315,195,,,0,0,0,,,,,,
631,315,215,631,315,215,,,0,0,0,,,,,,
631,315,236,631,315,236,,,0,0,0,,,,,,
632,316,258,632,316,257,,,0,0,1,,,,,,
632,316,280,632,316,280,,,0,0,0,,,,,,
632,317,302,632,316,302,,,0,1,0,,,,,,
632,317,325,632,317,325,,,0,0,0,,,,,,
632,317,349,632,317,349,,,0,0,0,,,,,,
633,318,372,632,318,372,,,1,0,0,,,,,,
633,319,396,633,319,396,,,0,0,0,,,,,,
633,319,420,633,319,420,,,0,0,0,,,,,,
633,320,444,633,320,444,,,0,0,0,,,,,,
634,321,469,633,320,468,,,1,1,1,,,,,,
634,321,493,634,321,493,,,0,0,0,,,,,,
635,322,518,634,322,517,,,1,0,1,,,,,,
635,323,542,635,323,542,,,0,0,0,,,,,,
635,324,567,635,324,567,,,0,0,0,,,,,,
636,325,592,636,325,591,,,0,0,1,,,,,,
636,326,617,636,326,616,,,0,0,1,,,,,,
637,327,642,637,327,641,,,0,0,1,,,,,,
637,328,667,637,328,666,,,0,0,1,,,,,,
638,329,692,638,329,691,,,0,0,1,,,,,,
638,331,717,638,330,717,,,0,1,0,,,,,,
639,332,742,639,332,742,,,0,0,0,,,,,,
639,333,767,639,333,767,,,0,0,0,,,,,,
634,338,120,634,338,120,,,0,0,0,,,,,,
634,338,122,634,338,120,,,0,0,2,,,,,,
634,338,127,634,338,127,,,0,0,0,,,,,,
634,338,136,634,338,137,,,0,0,-1,,,,,,
634,338,148,634,338,147,,,0,0,1,,,,,,
634,339,162,634,339,163,,,0,0,-1,,,,,,
634,339,179,634,339,179,,,0,0,0,,,,,,
635,339,198,634,339,198,,,1,0,0,,,,,,
635,339,217,635,339,217,,,0,0,0,,,,,,
635,339,238,635,339,238,,,0,0,0,,,,,,
635,340,260,635,340,259,,,0,0,1,,,,,,
635,340,282,635,340,281,,,0,0,1,,,,,,
635,341,304,635,341,304,,,0,0,0,,,,,,
636,341,327,635,341,327,,,1,0,0,,,,,,
636,341,350,636,341,350,,,0,0,0,,,,,,
636,342,374,636,342,373,,,0,0,1,,,,,,
636,342,397,636,343,397,,,0,-1,0,,,,,,
637,343,421,636,343,421,,,1,0,0,,,,,,
637,344,445,637,344,445,,,0,0,0,,,,,,
637,344,470,637,344,469,,,0,0,1,,,,,,
637,345,494,637,345,494,,,0,0,0,,,,,,
638,346,518,638,346,518,,,0,0,0,,,,,,
638,347,543,638,347,543,,,0,0,0,,,,,,
639,348,568,638,347,567,,,1,1,1,,,,,,
639,348,592,639,348,592,,,0,0,0,,,,,,
640,349,617,639,349,617,,,1,0,0,,,,,,
640,350,642,640,350,642,,,0,0,0,,,,,,
641,351,667,640,351,667,,,1,0,0,,,,,,
641,352,692,641,353,692,,,0,-1,0,,,,,,
642,354,718,641,354,717,,,1,0,1,,,,,,
642,355,743,642,355,743,,,0,0,0,,,,,,
643,356,768,643,356,768,,,0,0,0,,,,,,
638,363,125,638,363,125,,,0,0,0,,,,,,
638,363,127,638,363,125,,,0,0,2,,,,,,
638,363,131,638,363,131,,,0,0,0,,,,,,
638,363,140,638,363,141,,,0,0,-1,,,,,,
638,363,152,638,363,151,,,0,0,1,,,,,,
638,363,166,638,363,166,,,0,0,0,,,,,,
638,364,182,638,363,182,,,0,1,0,,,,,,
638,364,201,638,363,201,,,0,1,0,,,,,,
638,364,220,638,364,220,,,0,0,0,,,,,,
639,364,240,638,364,240,,,1,0,0,,,,,,
639,365,262,639,364,261,,,0,1,1,,,,,,
639,365,283,639,365,283,,,0,0,0,,,,,,
639,365,306,639,365,306,,,0,0,0,,,,,,
639,366,329,639,365,329,,,0,1,0,,,,,,
639,366,352,639,366,352,,,0,0,0,,,,,,
640,367,375,639,366,375,,,1,1,0,,,,,,
640,367,399,640,367,398,,,0,0,1,,,,,,
640,368,422,640,367,422,,,0,1,0,,,,,,
641,368,446,640,368,446,,,1,0,0,,,,,,
641,369,471,641,369,470,,,0,0,1,,,,,,
641,369,495,641,369,495,,,0,0,0,,,,,,
642,370,519,641,370,519,,,1,0,0,,,,,,
642,371,544,642,371,544,,,0,0,0,,,,,,
642,372,569,642,371,568,,,0,1,1,,,,,,
643,373,593,642,372,593,,,1,1,0,,,,,,
643,373,618,643,373,618,,,0,0,0,,,,,,
644,374,643,643,374,643,,,1,0,0,,,,,,
644,375,668,644,375,668,,,0,0,0,,,,,,
645,376,693,644,376,693,,,1,0,0,,,,,,
645,377,718,645,377,718,,,0,0,0,,,,,,
646,378,743,645,378,743,,,1,0,0,,,,,,
646,379,769,646,379,768,,,0,0,1,,,,,,
642,389,131,642,389,130,,,0,0,1,,,,,,
642,389,132,642,389,130,,,0,0,2,,,,,,
642,389,136,642,389,136,,,0,0,0,,,,,,
642,389,144,642,389,146,,,0,0,-2,,,,,,
642,389,156,642,389,156,,,0,0,0,,,,,,
642,389,170,642,389,171,,,0,0,-1,,,,,,
642,389,186,642,389,186,,,0,0,0,,,,,,
642,389,204,642,389,204,,,0,0,0,,,,,,
642,389,223,642,389,222,,,0,0,1,,,,,,
643,390,243,643,390,243,,,0,0,0,,,,,,
643,390,264,643,390,264,,,0,0,0,,,,,,
643,390,286,643,390,286,,,0,0,0,,,,,,
643,391,308,643,391,308,,,0,0,0,,,,,,
643,391,330,643,391,330,,,0,0,0,,,,,,
644,391,353,643,391,353,,,1,0,0,,,,,,
644,392,377,644,392,376,,,0,0,1,,,,,,
644,392,400,644,392,400,,,0,0,0,,,,,,
644,393,424,644,393,424,,,0,0,0,,,,,,
645,393,448,644,393,447,,,1,0,1,,,,,,
645,394,472,645,394,472,,,0,0,0,,,,,,
645,394,496,645,394,496,,,0,0,0,,,,,,
646,395,520,645,395,520,,,1,0,0,,,,,,
646,396,545,646,396,545,,,0,0,0,,,,,,
646,397,570,646,397,569,,,0,0,1,,,,,,
647,397,594,647,397,594,,,0,0,0,,,,,,
647,398,619,647,398,619,,,0,0,0,,,,,,
648,399,644,647,399,644,,,1,0,0,,,,,,
648,400,669,648,400,669,,,0,0,0,,,,,,
649,401,694,648,401,694,,,1,0,0,,,,,,
649,402,719,649,402,719,,,0,0,0,,,,,,
650,403,744,649,403,744,,,1,0,0,,,,,,
650,404,769,650,404,769,,,0,0,0,,,,,,
647,415,136,646,415,136,,,1,0,0,,,,,,
647,415,137,646,415,136,,,1,0,1,,,,,,
647,415,142,646,415,141,,,1,0,1,,,,,,
647,415,149,646,415,151,,,1,0,-2,,,,,,
647,415,160,646,415,160,,,1,0,0,,,,,,
647,415,174,646,415,175,,,1,0,-1,,,,,,
647,415,190,646,415,190,,,1,0,0,,,,,,
647,415,207,646,415,207,,,1,0,0,,,,,,
647,415,226,647,415,225,,,0,0,1,,,,,,
647,416,246,647,415,246,,,0,1,0,,,,,,
647,416,267,647,416,266,,,0,0,1,,,,,,
647,416,288,647,416,288,,,0,0,0,,,,,,
648,416,310,647,416,310,,,1,0,0,,,,,,
648,417,332,647,416,332,,,1,1,0,,,,,,
648,417,355,648,417,355,,,0,0,0,,,,,,
648,417,378,648,417,378,,,0,0,0,,,,,,
648,418,402,648,418,402,,,0,0,0,,,,,,
649,418,425,648,418,425,,,1,0,0,,,,,,
649,419,449,649,419,449,,,0,0,0,,,,,,
649,419,473,649,419,473,,,0,0,0,,,,,,
650,420,497,649,420,497,,,1,0,0,,,,,,
650,421,522,650,420,522,,,0,1,0,,,,,,
650,421,546,650,421,546,,,0,0,0,,,,,,
651,422,571,651,422,571,,,0,0,0,,,,,,
651,423,595,651,423,595,,,0,0,0,,,,,,
652,423,620,651,423,620,,,1,0,0,,,,,,
652,424,645,652,424,644,,,0,0,1,,,,,,
653,425,670,652,425,669,,,1,0,1,,,,,,
653,426,695,653,426,694,,,0,0,1,,,,,,
654,427,720,653,427,719,,,1,0,1,,,,,,
654,428,745,654,428,745,,,0,0,0,,,,,,
655,429,770,654,429,770,,,1,0,0,,,,,,
651,441,142,651,441,141,,,0,0,1,,,,,,
651,441,143,651,441,141,,,0,0,2,,,,,,
651,441,147,651,441,147,,,0,0,0,,,,,,
651,441,154,651,441,156,,,0,0,-2,,,,,,
651,441,165,651,441,165,,,0,0,0,,,,,,
651,441,178,651,441,179,,,0,0,-1,,,,,,
652,441,194,651,441,194,,,1,0,0,,,,,,
652,441,211,651,441,211,,,1,0,0,,,,,,
652,442,229,652,442,229,,,0,0,0,,,,,,
652,442,249,652,442,249,,,0,0,0,,,,,,
652,442,269,652,442,269,,,0,0,0,,,,,,
652,442,290,652,442,290,,,0,0,0,,,,,,
652,443,312,652,443,312,,,0,0,0,,,,,,
653,443,334,652,443,334,,,1,0,0,,,,,,
653,443,357,653,443,357,,,0,0,0,,,,,,
653,444,380,653,443,380,,,0,1,0,,,,,,
653,444,403,653,444,403,,,0,0,0,,,,,,
654,445,427,653,444,427,,,1,1,0,,,,,,
654,445,451,654,445,450,,,0,0,1,,,,,,
654,445,475,654,445,474,,,0,0,1,,,,,,
654,446,499,654,446,499,,,0,0,0,,,,,,
655,447,523,655,446,523,,,0,1,0,,,,,,
655,447,547,655,447,547,,,0,0,0,,,,,,
656,448,572,655,448,572,,,1,0,0,,,,,,
656,449,596,656,448,596,,,0,1,0,,,,,,
656,449,621,656,449,621,,,0,0,0,,,,,,
657,450,646,657,450,646,,,0,0,0,,,,,,
657,451,671,657,451,670,,,0,0,1,,,,,,
658,452,696,658,451,695,,,0,1,1,,,,,,
658,452,721,658,452,720,,,0,0,1,,,,,,
659,453,746,659,453,745,,,0,0,1,,,,,,
660,454,771,659,454,771,,,1,0,0,,,,,,
656,468,148,657,467,147,,,-1,1,1,,,,,,
656,468,149,657,467,147,,,-1,1,2,,,,,,
656,468,153,657,467,152,,,-1,1,1,,,,,,
657,468,160,657,467,161,,,0,1,-1,,,,,,
657,468,170,657,467,170,,,0,1,0,,,,,,
657,468,183,657,468,184,,,0,0,-1,,,,,,
657,468,198,657,468,198,,,0,0,0,,,,,,
657,468,214,657,468,215,,,0,0,-1,,,,,,
657,468,233,657,468,232,,,0,0,1,,,,,,
657,468,252,657,468,252,,,0,0,0,,,,,,
657,469,272,657,468,272,,,0,1,0,,,,,,
657,469,293,657,469,293,,,0,0,0,,,,,,
657,469,315,658,469,315,,,-1,0,0,,,,,,
658,469,337,658,469,337,,,0,0,0,,,,,,
658,470,359,658,469,359,,,0,1,0,,,,,,
658,470,382,658,470,382,,,0,0,0,,,,,,
658,471,405,658,470,405,,,0,1,0,,,,,,
659,471,429,658,471,428,,,1,0,1,,,,,,
659,471,452,659,471,452,,,0,0,0,,,,,,
659,472,476,659,472,476,,,0,0,0,,,,,,
660,472,500,660,472,500,,,0,0,0,,,,,,
660,473,524,660,473,524,,,0,0,0,,,,,,
660,474,549,660,473,548,,,0,1,1,,,,,,
661,474,573,660,474,573,,,1,0,0,,,,,,
661,475,598,661,474,597,,,0,1,1,,,,,,
662,475,622,661,475,622,,,1,0,0,,,,,,
662,476,647,662,476,647,,,0,0,0,,,,,,
663,477,672,662,477,672,,,1,0,0,,,,,,
663,478,697,663,477,696,,,0,1,1,,,,,,
664,478,722,663,478,721,,,1,0,1,,,,,,
664,479,747,664,479,746,,,0,0,1,,,,,,
665,480,772,664,480,771,,,1,0,1,,,,,,
662,495,154,662,494,153,,,0,1,1,,,,,,
662,495,155,662,494,153,,,0,1,2,,,,,,
662,495,158,662,494,158,,,0,1,0,,,,,,
662,495,165,662,494,167,,,0,1,-2,,,,,,
662,495,175,662,494,175,,,0,1,0,,,,,,
662,495,188,662,495,189,,,0,0,-1,,,,,,
662,495,202,662,495,202,,,0,0,0,,,,,,
662,495,219,662,495,219,,,0,0,0,,,,,,
662,495,236,662,495,236,,,0,0,0,,,,,,
663,495,255,662,495,255,,,1,0,0,,,,,,
663,496,275,662,495,275,,,1,1,0,,,,,,
663,496,296,663,496,296,,,0,0,0,,,,,,
663,496,317,663,496,317,,,0,0,0,,,,,,
663,496,339,663,496,339,,,0,0,0,,,,,,
663,497,362,663,496,361,,,0,1,1,,,,,,
664,497,384,663,497,384,,,1,0,0,,,,,,
664,497,407,664,497,407,,,0,0,0,,,,,,
664,498,431,664,498,430,,,0,0,1,,,,,,
664,498,454,664,498,454,,,0,0,0,,,,,,
665,499,478,665,498,478,,,0,1,0,,,,,,
665,499,502,665,499,502,,,0,0,0,,,,,,
665,500,526,665,499,526,,,0,1,0,,,,,,
666,500,550,666,500,550,,,0,0,0,,,,,,
666,501,574,666,500,574,,,0,1,0,,,,,,
667,501,599,666,501,599,,,1,0,0,,,,,,
667,502,624,667,502,623,,,0,0,1,,,,,,
667,503,648,667,503,648,,,0,0,0,,,,,,
668,503,673,668,503,673,,,0,0,0,,,,,,
668,504,698,668,504,697,,,0,0,1,,,,,,
669,505,723,669,505,722,,,0,0,1,,,,,,
670,506,748,669,505,747,,,1,1,1,,,,,,
670,506,773,670,506,772,,,0,0,1,,,,,,
668,522,160,668,522,160,,,0,0,0,,,,,,
668,522,161,668,522,160,,,0,0,1,,,,,,
668,522,165,668,522,164,,,0,0,1,,,,,,
668,522,171,668,522,172,,,0,0,-1,,,,,,
668,522,181,668,522,181,,,0,0,0,,,,,,
668,522,193,668,522,194,,,0,0,-1,,,,,,
668,522,207,668,522,207,,,0,0,0,,,,,,
668,522,223,668,522,223,,,0,0,0,,,,,,
668,522,240,668,522,240,,,0,0,0,,,,,,
668,523,259,668,522,259,,,0,1,0,,,,,,
669,523,279,668,523,278,,,1,0,1,,,,,,
669,523,299,668,523,299,,,1,0,0,,,,,,
669,523,320,668,523,320,,,1,0,0,,,,,,
669,524,342,669,523,342,,,0,1,0,,,,,,
669,524,364,669,524,364,,,0,0,0,,,,,,
669,524,387,669,524,386,,,0,0,1,,,,,,
670,525,409,669,524,409,,,1,1,0,,,,,,
670,525,433,670,525,432,,,0,0,1,,,,,,
670,525,456,670,525,456,,,0,0,0,,,,,,
671,526,480,670,525,479,,,1,1,1,,,,,,
671,526,503,671,526,503,,,0,0,0,,,,,,
671,527,527,671,526,527,,,0,1,0,,,,,,
672,527,552,671,527,551,,,1,0,1,,,,,,
672,528,576,672,527,576,,,0,1,0,,,,,,
672,528,600,672,528,600,,,0,0,0,,,,,,
673,529,625,673,528,625,,,0,1,0,,,,,,
673,529,649,673,529,649,,,0,0,0,,,,,,
674,530,674,674,530,674,,,0,0,0,,,,,,
674,531,699,674,531,699,,,0,0,0,,,,,,
675,531,724,675,531,723,,,0,0,1,,,,,,
675,532,749,675,532,748,,,0,0,1,,,,,,
676,533,774,676,533,773,,,0,0,1,,,,,,
674,549,166,674,549,166,,,0,0,0,,,,,,
674,549,167,674,549,166,,,0,0,1,,,,,,
674,549,171,674,549,170,,,0,0,1,,,,,,
674,549,177,674,549,178,,,0,0,-1,,,,,,
674,550,186,674,549,186,,,0,1,0,,,,,,
674,550,198,674,549,199,,,0,1,-1,,,,,,
674,550,212,674,549,211,,,0,1,1,,,,,,
674,550,227,674,549,228,,,0,1,-1,,,,,,
674,550,244,674,550,244,,,0,0,0,,,,,,
675,550,263,674,550,263,,,1,0,0,,,,,,
675,550,282,674,550,282,,,1,0,0,,,,,,
675,550,302,675,550,302,,,0,0,0,,,,,,
675,551,323,675,550,323,,,0,1,0,,,,,,
675,551,345,675,551,344,,,0,0,1,,,,,,
675,551,367,675,551,366,,,0,0,1,,,,,,
676,552,389,676,551,389,,,0,1,0,,,,,,
676,552,412,676,551,411,,,0,1,1,,,,,,
676,552,435,676,552,434,,,0,0,1,,,,,,
676,553,458,676,552,458,,,0,1,0,,,,,,
677,553,482,677,553,481,,,0,0,1,,,,,,
677,553,505,677,553,505,,,0,0,0,,,,,,
677,554,529,677,554,529,,,0,0,0,,,,,,
678,554,553,678,554,553,,,0,0,0,,,,,,
678,555,577,678,555,577,,,0,0,0,,,,,,
679,555,602,678,555,602,,,1,0,0,,,,,,
679,556,626,679,556,626,,,0,0,0,,,,,,
679,557,651,679,556,651,,,0,1,0,,,,,,
680,557,675,680,557,675,,,0,0,0,,,,,,
680,558,700,680,558,700,,,0,0,0,,,,,,
681,558,725,681,558,725,,,0,0,0,,,,,,
681,559,750,681,559,750,,,0,0,0,,,,,,
682,560,775,682,560,775,,,0,0,0,,,,,,
681,577,173,681,577,173,,,0,0,0,,,,,,
681,577,174,681,577,173,,,0,0,1,,,,,,
681,577,177,681,577,177,,,0,0,0,,,,,,
681,577,183,681,577,184,,,0,0,-1,,,,,,
681,577,192,681,577,192,,,0,0,0,,,,,,
681,577,203,681,577,204,,,0,0,-1,,,,,,
681,577,217,681,577,216,,,0,0,1,,,,,,
681,577,232,681,577,232,,,0,0,0,,,,,,
681,578,249,681,578,248,,,0,0,1,,,,,,
681,578,267,681,578,267,,,0,0,0,,,,,,
681,578,286,681,578,285,,,0,0,1,,,,,,
681,578,306,681,578,305,,,0,0,1,,,,,,
682,578,326,682,578,326,,,0,0,0,,,,,,
682,579,348,682,578,347,,,0,1,1,,,,,,
682,579,369,682,579,369,,,0,0,0,,,,,,
682,579,392,682,579,391,,,0,0,1,,,,,,
682,579,414,683,579,414,,,-1,0,0,,,,,,
683,580,437,683,579,437,,,0,1,0,,,,,,
683,580,460,683,580,460,,,0,0,0,,,,,,
683,580,484,683,580,483,,,0,0,1,,,,,,
684,581,507,684,581,507,,,0,0,0,,,,,,
684,581,531,684,581,531,,,0,0,0,,,,,,
684,582,555,684,582,555,,,0,0,0,,,,,,
685,582,579,684,582,579,,,1,0,0,,,,,,
685,583,603,685,583,603,,,0,0,0,,,,,,
686,583,628,685,583,628,,,1,0,0,,,,,,
686,584,652,686,584,652,,,0,0,0,,,,,,
686,584,677,686,584,677,,,0,0,0,,,,,,
687,585,702,687,585,701,,,0,0,1,,,,,,
687,586,726,687,585,726,,,0,1,0,,,,,,
688,586,751,688,586,751,,,0,0,0,,,,,,
688,587,776,688,587,776,,,0,0,0,,,,,,
687,605,179,687,605,179,,,0,0,0,,,,,,
687,605,180,687,605,179,,,0,0,1,,,,,,
688,605,183,687,605,183,,,1,0,0,,,,,,
688,605,189,687,605,190,,,1,0,-1,,,,,,
688,605,198,688,605,198,,,0,0,0,,,,,,
688,605,209,688,605,210,,,0,0,-1,,,,,,
688,605,222,688,605,222,,,0,0,0,,,,,,
688,605,237,688,605,237,,,0,0,0,,,,,,
688,605,253,688,605,253,,,0,0,0,,,,,,
688,606,271,688,605,271,,,0,1,0,,,,,,
688,606,290,688,606,289,,,0,0,1,,,,,,
688,606,309,688,606,309,,,0,0,0,,,,,,
688,606,330,688,606,329,,,0,0,1,,,,,,
689,606,351,689,606,350,,,0,0,1,,,,,,
689,607,372,689,606,372,,,0,1,0,,,,,,
689,607,394,689,606,394,,,0,1,0,,,,,,
689,607,417,689,607,416,,,0,0,1,,,,,,
690,607,439,690,607,439,,,0,0,0,,,,,,
690,608,462,690,608,462,,,0,0,0,,,,,,
690,608,486,690,608,486,,,0,0,0,,,,,,
690,609,509,690,608,509,,,0,1,0,,,,,,
691,609,533,691,609,533,,,0,0,0,,,,,,
691,609,557,691,609,556,,,0,0,1,,,,,,
692,610,581,691,610,580,,,1,0,1,,,,,,
692,610,605,692,610,605,,,0,0,0,,,,,,
692,611,629,692,611,629,,,0,0,0,,,,,,
693,611,654,693,611,654,,,0,0,0,,,,,,
693,612,678,693,612,678,,,0,0,0,,,,,,
694,612,703,694,612,703,,,0,0,0,,,,,,
694,613,728,694,613,727,,,0,0,1,,,,,,
695,614,753,695,613,752,,,0,1,1,,,,,,
695,614,777,695,614,777,,,0,0,0,,,,,,
695,633,186,694,633,186,,,1,0,0,,,,,,
695,633,187,694,633,186,,,1,0,1,,,,,,
695,633,190,694,633,190,,,1,0,0,,,,,,
695,633,196,694,633,197,,,1,0,-1,,,,,,
695,633,204,695,633,204,,,0,0,0,,,,,,
695,633,214,695,633,215,,,0,0,-1,,,,,,
695,633,227,695,633,227,,,0,0,0,,,,,,
695,633,242,695,633,242,,,0,0,0,,,,,,
695,633,258,695,633,257,,,0,0,1,,,,,,
695,634,275,695,633,275,,,0,1,0,,,,,,
695,634,293,695,634,293,,,0,0,0,,,,,,
695,634,313,695,634,313,,,0,0,0,,,,,,
696,634,333,695,634,333,,,1,0,0,,,,,,
696,634,354,696,634,354,,,0,0,0,,,,,,
696,635,375,696,634,375,,,0,1,0,,,,,,
696,635,397,696,634,397,,,0,1,0,,,,,,
696,635,419,696,635,419,,,0,0,0,,,,,,
697,635,442,697,635,442,,,0,0,0,,,,,,
697,636,465,697,636,465,,,0,0,0,,,,,,
697,636,488,697,636,488,,,0,0,0,,,,,,
698,636,511,697,636,511,,,1,0,0,,,,,,
698,637,535,698,636,535,,,0,1,0,,,,,,
698,637,559,698,637,558,,,0,0,1,,,,,,
699,638,583,698,637,582,,,1,1,1,,,,,,
699,638,607,699,638,606,,,0,0,1,,,,,,
699,639,631,699,638,631,,,0,1,0,,,,,,
700,639,655,700,639,655,,,0,0,0,,,,,,
700,640,680,700,639,680,,,0,1,0,,,,,,
701,640,704,701,640,704,,,0,0,0,,,,,,
701,641,729,701,640,729,,,0,1,0,,,,,,
702,641,754,702,641,754,,,0,0,0,,,,,,
702,642,779,702,642,778,,,0,0,1,,,,,,
702,661,193,702,661,193,,,0,0,0,,,,,,
702,661,194,702,661,193,,,0,0,1,,,,,,
702,661,197,702,661,196,,,0,0,1,,,,,,
702,661,202,702,661,203,,,0,0,-1,,,,,,
702,661,210,702,661,210,,,0,0,0,,,,,,
702,661,220,702,661,221,,,0,0,-1,,,,,,
702,661,233,702,661,233,,,0,0,0,,,,,,
702,662,247,702,661,247,,,0,1,0,,,,,,
703,662,262,703,661,262,,,0,1,0,,,,,,
703,662,279,703,662,280,,,0,0,-1,,,,,,
703,662,298,703,662,297,,,0,0,1,,,,,,
703,662,317,703,662,317,,,0,0,0,,,,,,
703,662,337,703,662,336,,,0,0,1,,,,,,
703,662,357,703,662,357,,,0,0,0,,,,,,
704,663,378,704,662,378,,,0,1,0,,,,,,
704,663,400,704,663,400,,,0,0,0,,,,,,
704,663,422,704,663,422,,,0,0,0,,,,,,
704,663,445,704,663,444,,,0,0,1,,,,,,
704,664,467,705,664,467,,,-1,0,0,,,,,,
705,664,490,705,664,490,,,0,0,0,,,,,,
705,664,514,705,664,513,,,0,0,1,,,,,,
705,665,537,705,664,537,,,0,1,0,,,,,,
706,665,561,706,665,560,,,0,0,1,,,,,,
706,666,585,706,665,584,,,0,1,1,,,,,,
707,666,609,706,666,608,,,1,0,1,,,,,,
707,667,633,707,666,632,,,0,1,1,,,,,,
707,667,657,707,667,657,,,0,0,0,,,,,,
708,667,682,708,667,681,,,0,0,1,,,,,,
708,668,706,708,668,706,,,0,0,0,,,,,,
709,669,731,709,668,730,,,0,1,1,,,,,,
709,669,755,709,669,755,,,0,0,0,,,,,,
710,670,780,710,670,780,,,0,0,0,,,,,,
710,689,200,710,689,200,,,0,0,0,,,,,,
710,689,200,710,689,200,,,0,0,0,,,,,,
710,690,203,710,689,203,,,0,1,0,,,,,,
710,690,209,710,689,210,,,0,1,-1,,,,,,
710,690,216,710,689,216,,,0,1,0,,,,,,
710,690,226,710,689,227,,,0,1,-1,,,,,,
710,690,238,710,689,238,,,0,1,0,,,,,,
710,690,252,710,689,253,,,0,1,-1,,,,,,
710,690,267,710,690,267,,,0,0,0,,,,,,
711,690,284,710,690,284,,,1,0,0,,,,,,
711,690,302,711,690,302,,,0,0,0,,,,,,
711,690,321,711,690,321,,,0,0,0,,,,,,
711,691,340,711,690,340,,,0,1,0,,,,,,
711,691,361,711,690,361,,,0,1,0,,,,,,
711,691,382,711,691,382,,,0,0,0,,,,,,
712,691,403,711,691,403,,,1,0,0,,,,,,
712,691,425,712,691,425,,,0,0,0,,,,,,
712,692,447,712,691,447,,,0,1,0,,,,,,
712,692,470,712,692,470,,,0,0,0,,,,,,
713,692,493,712,692,493,,,1,0,0,,,,,,
713,693,516,713,692,516,,,0,1,0,,,,,,
713,693,539,713,693,539,,,0,0,0,,,,,,
714,693,563,713,693,562,,,1,0,1,,,,,,
714,694,587,714,694,586,,,0,0,1,,,,,,
714,694,611,714,694,610,,,0,0,1,,,,,,
715,695,635,715,694,634,,,0,1,1,,,,,,
715,695,659,715,695,658,,,0,0,1,,,,,,
716,696,683,716,695,683,,,0,1,0,,,,,,
716,696,708,716,696,707,,,0,0,1,,,,,,
716,697,732,717,696,732,,,-1,1,0,,,,,,
717,697,757,717,697,757,,,0,0,0,,,,,,
717,698,782,718,698,781,,,-1,0,1,,,,,,
718,718,207,718,718,206,,,0,0,1,,,,,,
718,718,207,718,718,206,,,0,0,1,,,,,,
718,718,210,718,718,210,,,0,0,0,,,,,,
718,718,215,718,718,216,,,0,0,-1,,,,,,
718,718,223,718,718,223,,,0,0,0,,,,,,
718,718,232,718,718,233,,,0,0,-1,,,,,,
718,718,244,718,718,244,,,0,0,0,,,,,,
718,718,257,718,718,258,,,0,0,-1,,,,,,
719,718,272,718,718,272,,,1,0,0,,,,,,
719,718,289,719,718,289,,,0,0,0,,,,,,
719,719,306,719,719,306,,,0,0,0,,,,,,
719,719,325,719,719,325,,,0,0,0,,,,,,
719,719,344,719,719,344,,,0,0,0,,,,,,
719,719,364,719,719,364,,,0,0,0,,,,,,
719,719,385,719,719,385,,,0,0,0,,,,,,
720,720,406,720,719,406,,,0,1,0,,,,,,
720,720,428,720,720,428,,,0,0,0,,,,,,
720,720,450,720,720,450,,,0,0,0,,,,,,
720,720,473,720,720,472,,,0,0,1,,,,,,
721,721,495,721,720,495,,,0,1,0,,,,,,
721,721,518,721,721,518,,,0,0,0,,,,,,
721,721,542,721,721,541,,,0,0,1,,,,,,
722,722,565,721,721,565,,,1,1,0,,,,,,
722,722,589,722,722,588,,,0,0,1,,,,,,
722,722,613,722,722,612,,,0,0,1,,,,,,
723,723,637,723,722,636,,,0,1,1,,,,,,
723,723,661,723,723,660,,,0,0,1,,,,,,
724,724,685,724,723,685,,,0,1,0,,,,,,
724,724,709,724,724,709,,,0,0,0,,,,,,
725,725,734,725,724,734,,,0,1,0,,,,,,
725,725,759,725,725,758,,,0,0,1,,,,,,
726,726,783,726,726,783,,,0,0,0,,,,,,
727,746,214,726,746,213,,,1,0,1,,,,,,
727,746,214,726,746,213,,,1,0,1,,,,,,
727,746,217,727,746,217,,,0,0,0,,,,,,
727,747,222,727,746,223,,,0,1,-1,,,,,,
727,747,229,727,746,229,,,0,1,0,,,,,,
727,747,238,727,746,239,,,0,1,-1,,,,,,
727,747,250,727,746,249,,,0,1,1,,,,,,
727,747,263,727,746,263,,,0,1,0,,,,,,
727,747,278,727,746,277,,,0,1,1,,,,,,
727,747,294,727,747,294,,,0,0,0,,,,,,
727,747,311,727,747,311,,,0,0,0,,,,,,
727,747,329,727,747,329,,,0,0,0,,,,,,
727,747,348,727,747,348,,,0,0,0,,,,,,
728,748,368,727,747,368,,,1,1,0,,,,,,
728,748,389,728,747,389,,,0,1,0,,,,,,
728,748,410,728,748,410,,,0,0,0,,,,,,
728,748,431,728,748,431,,,0,0,0,,,,,,
728,748,453,728,748,453,,,0,0,0,,,,,,
729,749,475,729,748,475,,,0,1,0,,,,,,
729,749,498,729,749,498,,,0,0,0,,,,,,
729,749,521,729,749,521,,,0,0,0,,,,,,
730,750,544,729,749,544,,,1,1,0,,,,,,
730,750,567,730,750,567,,,0,0,0,,,,,,
730,750,591,730,750,591,,,0,0,0,,,,,,
731,751,615,731,750,614,,,0,1,1,,,,,,
731,751,639,731,751,638,,,0,0,1,,,,,,
731,752,663,732,751,662,,,-1,1,1,,,,,,
732,752,687,732,752,687,,,0,0,0,,,,,,
732,752,711,733,752,711,,,-1,0,0,,,,,,
733,753,736,733,753,736,,,0,0,0,,,,,,
733,753,760,734,753,760,,,-1,0,0,,,,,,
734,754,785,734,754,785,,,0,0,0,,,,,,
735,775,221,735,775,220,,,0,0,1,,,,,,
735,775,221,735,775,220,,,0,0,1,,,,,,
735,775,224,735,775,224,,,0,0,0,,,,,,
735,775,229,735,775,230,,,0,0,-1,,,,,,
735,775,236,735,775,236,,,0,0,0,,,,,,
735,775,245,735,775,245,,,0,0,0,,,,,,
735,775,256,735,775,255,,,0,0,1,,,,,,
736,775,269,735,775,269,,,1,0,0,,,,,,
736,775,283,735,775,283,,,1,0,0,,,,,,
736,776,299,736,775,299,,,0,1,0,,,,,,
736,776,316,736,776,315,,,0,0,1,,,,,,
736,776,334,736,776,334,,,0,0,0,,,,,,
736,776,352,736,776,352,,,0,0,0,,,,,,
736,776,372,736,776,372,,,0,0,0,,,,,,
736,776,392,736,776,392,,,0,0,0,,,,,,
737,777,413,737,776,413,,,0,1,0,,,,,,
737,777,435,737,777,434,,,0,0,1,,,,,,
737,777,456,737,777,456,,,0,0,0,,,,,,
737,777,478,737,777,478,,,0,0,0,,,,,,
738,778,501,738,777,501,,,0,1,0,,,,,,
738,778,524,738,778,523,,,0,0,1,,,,,,
738,778,547,738,778,546,,,0,0,1,,,,,,
739,778,570,738,778,570,,,1,0,0,,,,,,
739,779,593,739,778,593,,,0,1,0,,,,,,
739,779,617,739,779,617,,,0,0,0,,,,,,
740,780,641,740,779,640,,,0,1,1,,,,,,
740,780,665,740,780,664,,,0,0,1,,,,,,
741,780,689,741,780,689,,,0,0,0,,,,,,
741,781,713,741,781,713,,,0,0,0,,,,,,
741,781,738,742,781,737,,,-1,0,1,,,,,,
742,782,762,742,782,762,,,0,0,0,,,,,,
742,782,787,743,782,786,,,-1,0,1,,,,,,
744,804,228,744,803,228,,,0,1,0,,,,,,
744,804,229,744,803,228,,,0,1,1,,,,,,
744,804,231,744,804,231,,,0,0,0,,,,,,
744,804,236,744,804,237,,,0,0,-1,,,,,,
744,804,242,744,804,242,,,0,0,0,,,,,,
744,804,251,744,804,252,,,0,0,-1,,,,,,
744,804,262,744,804,262,,,0,0,0,,,,,,
744,804,274,744,804,275,,,0,0,-1,,,,,,
745,804,288,744,804,288,,,1,0,0,,,,,,
745,804,304,744,804,304,,,1,0,0,,,,,,
745,804,321,745,804,320,,,0,0,1,,,,,,
745,805,338,745,804,338,,,0,1,0,,,,,,
745,805,357,745,804,357,,,0,1,0,,,,,,
745,805,376,745,804,376,,,0,1,0,,,,,,
745,805,396,745,805,396,,,0,0,0,,,,,,
746,805,417,746,805,417,,,0,0,0,,,,,,
746,805,438,746,805,438,,,0,0,0,,,,,,
746,806,460,746,805,459,,,0,1,1,,,,,,
746,806,481,746,806,481,,,0,0,0,,,,,,
747,806,504,747,806,504,,,0,0,0,,,,,,
747,806,526,747,806,526,,,0,0,0,,,,,,
747,807,549,747,806,549,,,0,1,0,,,,,,
748,807,572,747,807,572,,,1,0,0,,,,,,
748,807,596,748,807,596,,,0,0,0,,,,,,
748,808,619,748,807,619,,,0,1,0,,,,,,
749,808,643,749,808,643,,,0,0,0,,,,,,
749,809,667,749,808,666,,,0,1,1,,,,,,
749,809,691,750,809,691,,,-1,0,0,,,,,,
750,809,715,750,809,715,,,0,0,0,,,,,,
750,810,739,750,810,739,,,0,0,0,,,,,,
751,810,764,751,810,763,,,0,0,1,,,,,,
751,811,788,751,811,788,,,0,0,0,,,,,,
753,833,235,753,832,235,,,0,1,0,,,,,,
753,833,236,753,832,235,,,0,1,1,,,,,,
753,833,238,753,832,238,,,0,1,0,,,,,,
753,833,243,753,832,243,,,0,1,0,,,,,,
754,833,249,753,832,249,,,1,1,0,,,,,,
754,833,258,753,832,258,,,1,1,0,,,,,,
754,833,268,753,832,268,,,1,1,0,,,,,,
754,833,280,753,833,281,,,1,0,-1,,,,,,
754,833,294,753,833,294,,,1,0,0,,,,,,
754,833,309,754,833,310,,,0,0,-1,,,,,,
754,833,326,754,833,325,,,0,0,1,,,,,,
754,833,343,754,833,343,,,0,0,0,,,,,,
754,833,361,754,833,361,,,0,0,0,,,,,,
754,834,380,754,833,380,,,0,1,0,,,,,,
755,834,400,754,833,400,,,1,1,0,,,,,,
755,834,421,755,834,420,,,0,0,1,,,,,,
755,834,441,755,834,441,,,0,0,0,,,,,,
755,834,463,755,834,463,,,0,0,0,,,,,,
756,835,485,755,834,484,,,1,1,1,,,,,,
756,835,507,756,835,507,,,0,0,0,,,,,,
756,835,529,756,835,529,,,0,0,0,,,,,,
756,835,552,756,835,552,,,0,0,0,,,,,,
757,836,575,756,835,575,,,1,1,0,,,,,,
757,836,598,757,836,598,,,0,0,0,,,,,,
757,836,622,757,836,622,,,0,0,0,,,,,,
758,837,645,758,836,645,,,0,1,0,,,,,,
758,837,669,758,837,669,,,0,0,0,,,,,,
759,838,693,759,837,693,,,0,1,0,,,,,,
759,838,717,759,838,717,,,0,0,0,,,,,,
759,838,741,760,838,741,,,-1,0,0,,,,,,
760,839,766,760,839,765,,,0,0,1,,,,,,
760,839,790,760,839,790,,,0,0,0,,,,,,
763,862,242,763,861,242,,,0,1,0,,,,,,
763,862,243,763,861,242,,,0,1,1,,,,,,
763,862,245,763,861,245,,,0,1,0,,,,,,
763,862,250,763,861,250,,,0,1,0,,,,,,
763,862,256,763,861,256,,,0,1,0,,,,,,
763,862,264,763,861,265,,,0,1,-1,,,,,,
763,862,274,763,861,274,,,0,1,0,,,,,,
763,862,286,763,861,287,,,0,1,-1,,,,,,
763,862,300,763,862,300,,,0,0,0,,,,,,
763,862,315,763,862,315,,,0,0,0,,,,,,
763,862,331,764,862,331,,,-1,0,0,,,,,,
764,862,348,764,862,348,,,0,0,0,,,,,,
764,862,366,764,862,366,,,0,0,0,,,,,,
764,862,385,764,862,385,,,0,0,0,,,,,,
764,863,404,764,862,404,,,0,1,0,,,,,,
764,863,424,764,862,424,,,0,1,0,,,,,,
765,863,445,765,863,445,,,0,0,0,,,,,,
765,863,466,765,863,466,,,0,0,0,,,,,,
765,863,488,765,863,488,,,0,0,0,,,,,,
765,864,510,765,863,510,,,0,1,0,,,,,,
766,864,532,766,864,532,,,0,0,0,,,,,,
766,864,555,766,864,555,,,0,0,0,,,,,,
766,865,578,766,864,577,,,0,1,1,,,,,,
767,865,601,766,864,601,,,1,1,0,,,,,,
767,865,624,767,865,624,,,0,0,0,,,,,,
767,866,648,767,865,648,,,0,1,0,,,,,,
768,866,671,768,866,671,,,0,0,0,,,,,,
768,866,695,768,866,695,,,0,0,0,,,,,,
768,867,719,769,866,719,,,-1,1,0,,,,,,
769,867,743,769,867,743,,,0,0,0,,,,,,
769,867,768,769,867,767,,,0,0,1,,,,,,
770,868,792,770,868,792,,,0,0,0,,,,,,
773,891,250,772,890,250,,,1,1,0,,,,,,
773,891,250,772,890,250,,,1,1,0,,,,,,
773,891,253,773,890,252,,,0,1,1,,,,,,
773,891,257,773,890,257,,,0,1,0,,,,,,
773,891,263,773,890,263,,,0,1,0,,,,,,
773,891,271,773,890,272,,,0,1,-1,,,,,,
773,891,281,773,890,281,,,0,1,0,,,,,,
773,891,292,773,890,293,,,0,1,-1,,,,,,
773,891,306,773,891,305,,,0,0,1,,,,,,
773,891,320,773,891,320,,,0,0,0,,,,,,
773,891,336,773,891,336,,,0,0,0,,,,,,
773,891,353,773,891,353,,,0,0,0,,,,,,
774,891,370,773,891,370,,,1,0,0,,,,,,
774,891,389,773,891,389,,,1,0,0,,,,,,
774,892,408,774,891,408,,,0,1,0,,,,,,
774,892,428,774,891,428,,,0,1,0,,,,,,
774,892,449,774,892,449,,,0,0,0,,,,,,
774,892,470,774,892,470,,,0,0,0,,,,,,
775,892,491,775,892,491,,,0,0,0,,,,,,
775,893,513,775,892,513,,,0,1,0,,,,,,
775,893,535,775,893,535,,,0,0,0,,,,,,
776,893,558,775,893,558,,,1,0,0,,,,,,
776,893,581,776,893,580,,,0,0,1,,,,,,
776,894,604,776,893,603,,,0,1,1,,,,,,
777,894,627,776,894,627,,,1,0,0,,,,,,
777,894,650,777,894,650,,,0,0,0,,,,,,
777,895,674,777,894,674,,,0,1,0,,,,,,
778,895,698,778,895,697,,,0,0,1,,,,,,
778,895,722,778,895,721,,,0,0,1,,,,,,
779,896,746,778,895,745,,,1,1,1,,,,,,
779,896,770,779,896,769,,,0,0,1,,,,,,
779,897,794,779,896,794,,,0,1,0,,,,,,
644,178,98,644,178,98,,,0,0,0,,,,,,
644,178,99,644,178,98,,,0,0,1,,,,,,
644,178,105,644,178,105,,,0,0,0,,,,,,
644,178,116,644,178,117,,,0,0,-1,,,,,,
644,179,130,644,179,130,,,0,0,0,,,,,,
644,179,147,644,179,147,,,0,0,0,,,,,,
645,179,165,645,179,165,,,0,0,0,,,,,,
645,180,185,645,179,186,,,0,1,-1,,,,,,
645,180,207,645,180,207,,,0,0,0,,,,,,
645,181,228,645,180,229,,,0,1,-1,,,,,,
645,181,251,645,181,251,,,0,0,0,,,,,,
645,182,273,645,182,274,,,0,0,-1,,,,,,
645,183,297,645,183,297,,,0,0,0,,,,,,
646,184,320,645,183,320,,,1,1,0,,,,,,
646,184,344,646,184,344,,,0,0,0,,,,,,
646,185,368,646,185,368,,,0,0,0,,,,,,
646,187,392,646,187,392,,,0,0,0,,,,,,
647,188,416,646,188,416,,,1,0,0,,,,,,
647,189,440,647,189,440,,,0,0,0,,,,,,
647,190,465,647,190,465,,,0,0,0,,,,,,
647,192,490,647,192,490,,,0,0,0,,,,,,
648,193,514,647,193,514,,,1,0,0,,,,,,
648,195,539,648,195,539,,,0,0,0,,,,,,
649,196,564,648,196,564,,,1,0,0,,,,,,
649,198,589,649,198,589,,,0,0,0,,,,,,
649,200,614,649,200,614,,,0,0,0,,,,,,
650,202,639,650,202,639,,,0,0,0,,,,,,
650,203,664,650,203,664,,,0,0,0,,,,,,
651,205,689,651,205,689,,,0,0,0,,,,,,
651,207,715,651,207,714,,,0,0,1,,,,,,
652,210,740,652,210,740,,,0,0,0,,,,,,
653,212,765,652,212,765,,,1,0,0,,,,,,
644,179,98,644,178,98,,,0,1,0,,,,,,
644,179,99,644,178,98,,,0,1,1,,,,,,
644,179,106,644,178,105,,,0,1,1,,,,,,
644,180,116,644,178,117,,,0,2,-1,,,,,,
644,180,130,644,179,130,,,0,1,0,,,,,,
645,180,147,644,179,147,,,1,1,0,,,,,,
645,180,166,645,179,165,,,0,1,1,,,,,,
645,181,186,645,179,186,,,0,2,0,,,,,,
645,181,207,645,180,207,,,0,1,0,,,,,,
645,182,228,645,180,229,,,0,2,-1,,,,,,
645,182,251,645,181,251,,,0,1,0,,,,,,
645,183,274,645,182,274,,,0,1,0,,,,,,
645,184,297,645,183,297,,,0,1,0,,,,,,
646,185,320,645,183,320,,,1,2,0,,,,,,
646,186,344,646,184,344,,,0,2,0,,,,,,
646,187,368,646,185,368,,,0,2,0,,,,,,
646,188,392,646,187,392,,,0,1,0,,,,,,
647,189,416,646,188,416,,,1,1,0,,,,,,
647,190,441,647,189,440,,,0,1,1,,,,,,
647,191,465,647,190,465,,,0,1,0,,,,,,
648,193,490,647,192,490,,,1,1,0,,,,,,
648,194,514,647,193,514,,,1,1,0,,,,,,
648,196,539,648,195,539,,,0,1,0,,,,,,
649,197,564,648,196,564,,,1,1,0,,,,,,
649,199,589,649,198,589,,,0,1,0,,,,,,
650,201,614,649,200,614,,,1,1,0,,,,,,
650,203,639,650,202,639,,,0,1,0,,,,,,
651,205,664,650,203,664,,,1,2,0,,,,,,
651,206,689,651,205,689,,,0,1,0,,,,,,
652,208,715,651,207,714,,,1,1,1,,,,,,
652,211,740,652,210,740,,,0,1,0,,,,,,
653,213,765,652,212,765,,,1,1,0,,,,,,
645,184,98,645,184,98,,,0,0,0,,,,,,
645,184,100,645,184,98,,,0,0,2,,,,,,
645,184,106,645,184,106,,,0,0,0,,,,,,
645,184,117,645,184,118,,,0,0,-1,,,,,,
645,184,131,645,184,131,,,0,0,0,,,,,,
645,184,147,645,184,148,,,0,0,-1,,,,,,
645,185,166,645,185,166,,,0,0,0,,,,,,
645,185,186,645,185,186,,,0,0,0,,,,,,
645,186,207,645,186,207,,,0,0,0,,,,,,
645,186,229,645,186,229,,,0,0,0,,,,,,
645,187,251,645,187,251,,,0,0,0,,,,,,
646,187,274,645,187,274,,,1,0,0,,,,,,
646,188,297,646,188,297,,,0,0,0,,,,,,
646,189,320,646,189,320,,,0,0,0,,,,,,
646,190,344,646,190,344,,,0,0,0,,,,,,
646,191,368,646,191,368,,,0,0,0,,,,,,
647,192,392,647,192,392,,,0,0,0,,,,,,
647,193,416,647,193,416,,,0,0,0,,,,,,
647,194,441,647,194,441,,,0,0,0,,,,,,
648,196,465,647,195,465,,,1,1,0,,,,,,
648,197,490,648,197,490,,,0,0,0,,,,,,
648,198,514,648,198,514,,,0,0,0,,,,,,
649,200,539,649,200,539,,,0,0,0,,,,,,
649,201,564,649,201,564,,,0,0,0,,,,,,
649,203,589,649,203,589,,,0,0,0,,,,,,
650,205,614,649,205,614,,,1,0,0,,,,,,
650,207,639,650,207,639,,,0,0,0,,,,,,
651,208,664,650,208,664,,,1,0,0,,,,,,
651,210,690,651,210,690,,,0,0,0,,,,,,
652,212,715,651,212,715,,,1,0,0,,,,,,
652,214,740,652,214,740,,,0,0,0,,,,,,
653,216,765,653,216,765,,,0,0,0,,,,,,
645,192,99,645,193,99,,,0,-1,0,,,,,,
645,192,101,645,193,99,,,0,-1,2,,,,,,
645,192,107,645,193,107,,,0,-1,0,,,,,,
645,192,117,645,193,119,,,0,-1,-2,,,,,,
645,192,131,645,193,131,,,0,-1,0,,,,,,
645,192,148,645,194,149,,,0,-2,-1,,,,,,
645,193,166,645,194,166,,,0,-1,0,,,,,,
646,193,186,645,195,187,,,1,-2,-1,,,,,,
646,193,207,646,195,207,,,0,-2,0,,,,,,
646,194,229,646,196,229,,,0,-2,0,,,,,,
646,195,251,646,196,251,,,0,-1,0,,,,,,
646,195,274,646,197,274,,,0,-2,0,,,,,,
646,196,297,646,197,297,,,0,-1,0,,,,,,
646,197,321,646,198,321,,,0,-1,0,,,,,,
647,198,344,647,199,344,,,0,-1,0,,,,,,
647,198,368,647,200,368,,,0,-2,0,,,,,,
647,199,392,647,201,392,,,0,-2,0,,,,,,
647,201,416,647,202,416,,,0,-1,0,,,,,,
648,202,441,648,203,441,,,0,-1,0,,,,,,
648,203,465,648,204,465,,,0,-1,0,,,,,,
648,204,490,648,206,490,,,0,-2,0,,,,,,
649,206,515,649,207,514,,,0,-1,1,,,,,,
649,207,539,649,208,539,,,0,-1,0,,,,,,
650,209,564,649,210,564,,,1,-1,0,,,,,,
650,210,589,650,211,589,,,0,-1,0,,,,,,
650,212,614,650,213,614,,,0,-1,0,,,,,,
651,213,639,651,215,639,,,0,-2,0,,,,,,
651,215,664,651,217,664,,,0,-2,0,,,,,,
652,217,690,652,218,690,,,0,-1,0,,,,,,
652,219,715,652,220,715,,,0,-1,0,,,,,,
653,221,740,653,222,740,,,0,-1,0,,,,,,
654,223,766,653,224,765,,,1,-1,1,,,,,,
646,203,101,646,203,101,,,0,0,0,,,,,,
646,203,102,646,203,101,,,0,0,1,,,,,,
646,203,108,646,203,108,,,0,0,0,,,,,,
646,203,119,646,203,120,,,0,0,-1,,,,,,
646,203,132,646,203,132,,,0,0,0,,,,,,
646,204,149,646,203,149,,,0,1,0,,,,,,
646,204,167,646,204,167,,,0,0,0,,,,,,
646,204,187,646,204,187,,,0,0,0,,,,,,
647,205,208,647,205,208,,,0,0,0,,,,,,
647,205,230,647,205,230,,,0,0,0,,,,,,
647,206,252,647,206,252,,,0,0,0,,,,,,
647,206,274,647,206,275,,,0,0,-1,,,,,,
647,207,298,647,207,298,,,0,0,0,,,,,,
647,208,321,647,207,321,,,0,1,0,,,,,,
648,208,345,648,208,345,,,0,0,0,,,,,,
648,209,368,648,209,369,,,0,0,-1,,,,,,
648,210,393,648,210,393,,,0,0,0,,,,,,
648,211,417,648,211,417,,,0,0,0,,,,,,
649,212,441,649,212,441,,,0,0,0,,,,,,
649,214,466,649,213,465,,,0,1,1,,,,,,
649,215,490,649,215,490,,,0,0,0,,,,,,
650,216,515,649,216,515,,,1,0,0,,,,,,
650,217,540,650,217,540,,,0,0,0,,,,,,
650,219,564,650,218,564,,,0,1,0,,,,,,
651,220,589,651,220,589,,,0,0,0,,,,,,
651,222,614,651,222,614,,,0,0,0,,,,,,
652,224,640,652,224,640,,,0,0,0,,,,,,
652,225,665,652,225,665,,,0,0,0,,,,,,
653,227,690,653,227,690,,,0,0,0,,,,,,
653,229,715,653,229,715,,,0,0,0,,,,,,
654,231,740,654,231,740,,,0,0,0,,,,,,
654,233,766,654,233,765,,,0,0,1,,,,,,
647,217,103,647,218,103,,,0,-1,0,,,,,,
647,217,104,647,218,103,,,0,-1,1,,,,,,
647,217,110,647,218,110,,,0,-1,0,,,,,,
647,217,120,647,218,122,,,0,-1,-2,,,,,,
647,218,134,647,218,134,,,0,0,0,,,,,,
647,218,150,647,219,151,,,0,-1,-1,,,,,,
648,218,168,647,219,168,,,1,-1,0,,,,,,
648,218,188,647,219,188,,,1,-1,0,,,,,,
648,219,209,648,220,209,,,0,-1,0,,,,,,
648,219,230,648,220,230,,,0,-1,0,,,,,,
648,220,252,648,221,252,,,0,-1,0,,,,,,
648,220,275,648,221,275,,,0,-1,0,,,,,,
648,221,298,648,222,298,,,0,-1,0,,,,,,
649,222,322,648,222,322,,,1,0,0,,,,,,
649,222,345,649,223,345,,,0,-1,0,,,,,,
649,223,369,649,224,369,,,0,-1,0,,,,,,
649,224,393,649,225,393,,,0,-1,0,,,,,,
650,225,417,649,226,417,,,1,-1,0,,,,,,
650,226,441,650,227,441,,,0,-1,0,,,,,,
650,227,466,650,228,466,,,0,-1,0,,,,,,
650,228,490,650,229,490,,,0,-1,0,,,,,,
651,229,515,651,230,515,,,0,-1,0,,,,,,
651,231,540,651,231,540,,,0,0,0,,,,,,
652,232,565,652,233,564,,,0,-1,1,,,,,,
652,233,590,652,234,589,,,0,-1,1,,,,,,
652,235,615,652,236,614,,,0,-1,1,,,,,,
653,236,640,653,238,640,,,0,-2,0,,,,,,
653,238,665,653,239,665,,,0,-1,0,,,,,,
654,240,690,654,241,690,,,0,-1,0,,,,,,
654,241,715,654,242,715,,,0,-1,0,,,,,,
655,243,741,655,244,740,,,0,-1,1,,,,,,
656,245,766,655,246,766,,,1,-1,0,,,,,,
649,234,105,649,234,105,,,0,0,0,,,,,,
649,234,107,649,234,105,,,0,0,2,,,,,,
649,234,112,649,234,112,,,0,0,0,,,,,,
649,234,122,649,234,124,,,0,0,-2,,,,,,
649,234,136,649,234,136,,,0,0,0,,,,,,
649,234,152,649,234,153,,,0,0,-1,,,,,,
649,235,170,649,235,170,,,0,0,0,,,,,,
649,235,189,649,235,190,,,0,0,-1,,,,,,
649,235,210,649,235,210,,,0,0,0,,,,,,
649,236,231,649,235,231,,,0,1,0,,,,,,
649,236,253,649,236,253,,,0,0,0,,,,,,
650,237,276,649,236,276,,,1,1,0,,,,,,
650,237,299,650,237,299,,,0,0,0,,,,,,
650,238,322,650,238,322,,,0,0,0,,,,,,
650,239,346,650,239,346,,,0,0,0,,,,,,
650,239,370,650,239,370,,,0,0,0,,,,,,
651,240,394,651,240,394,,,0,0,0,,,,,,
651,241,418,651,241,418,,,0,0,0,,,,,,
651,242,442,651,242,442,,,0,0,0,,,,,,
652,243,466,651,243,466,,,1,0,0,,,,,,
652,244,491,652,244,491,,,0,0,0,,,,,,
652,245,516,652,245,515,,,0,0,1,,,,,,
653,246,540,653,246,540,,,0,0,0,,,,,,
653,248,565,653,247,565,,,0,1,0,,,,,,
654,249,590,654,249,590,,,0,0,0,,,,,,
654,250,615,654,250,615,,,0,0,0,,,,,,
654,252,640,654,252,640,,,0,0,0,,,,,,
655,253,665,654,253,665,,,1,0,0,,,,,,
655,255,690,655,255,690,,,0,0,0,,,,,,
656,256,716,655,256,715,,,1,0,1,,,,,,
656,258,741,656,258,741,,,0,0,0,,,,,,
657,260,766,657,259,766,,,0,1,0,,,,,,
651,253,108,651,253,108,,,0,0,0,,,,,,
651,253,110,651,253,108,,,0,0,2,,,,,,
651,253,115,651,253,115,,,0,0,0,,,,,,
651,253,125,651,253,126,,,0,0,-1,,,,,,
651,253,138,651,253,138,,,0,0,0,,,,,,
651,253,154,651,254,155,,,0,-1,-1,,,,,,
651,253,171,651,254,172,,,0,-1,-1,,,,,,
651,254,191,651,254,191,,,0,0,0,,,,,,
651,254,211,651,254,211,,,0,0,0,,,,,,
651,254,233,651,255,233,,,0,-1,0,,,,,,
651,255,254,651,255,254,,,0,0,0,,,,,,
651,255,277,651,256,277,,,0,-1,0,,,,,,
652,256,300,652,256,300,,,0,0,0,,,,,,
652,256,323,652,257,323,,,0,-1,0,,,,,,
652,257,347,652,258,346,,,0,-1,1,,,,,,
652,258,370,652,258,370,,,0,0,0,,,,,,
653,259,394,653,259,394,,,0,0,0,,,,,,
653,259,418,653,260,418,,,0,-1,0,,,,,,
653,260,443,653,261,442,,,0,-1,1,,,,,,
653,261,467,653,262,467,,,0,-1,0,,,,,,
654,262,491,654,263,491,,,0,-1,0,,,,,,
654,263,516,654,264,516,,,0,-1,0,,,,,,
655,264,541,655,265,540,,,0,-1,1,,,,,,
655,265,566,655,266,565,,,0,-1,1,,,,,,
655,267,590,655,267,590,,,0,0,0,,,,,,
656,268,615,655,268,615,,,1,0,0,,,,,,
656,269,640,656,270,640,,,0,-1,0,,,,,,
657,271,666,656,271,665,,,1,0,1,,,,,,
657,272,691,657,273,690,,,0,-1,1,,,,,,
658,273,716,657,274,716,,,1,-1,0,,,,,,
658,275,741,658,276,741,,,0,-1,0,,,,,,
659,277,767,659,277,766,,,0,0,1,,,,,,
653,273,111,653,273,111,,,0,0,0,,,,,,
653,273,113,653,273,111,,,0,0,2,,,,,,
653,273,118,653,273,118,,,0,0,0,,,,,,
653,273,128,653,273,129,,,0,0,-1,,,,,,
653,273,140,653,273,140,,,0,0,0,,,,,,
653,274,156,653,273,157,,,0,1,-1,,,,,,
653,274,174,653,274,174,,,0,0,0,,,,,,
653,274,193,653,274,193,,,0,0,0,,,,,,
653,274,213,653,274,213,,,0,0,0,,,,,,
653,275,234,653,274,234,,,0,1,0,,,,,,
653,275,256,653,275,256,,,0,0,0,,,,,,
654,276,278,653,275,278,,,1,1,0,,,,,,
654,276,301,654,276,301,,,0,0,0,,,,,,
654,277,324,654,276,324,,,0,1,0,,,,,,
654,277,347,654,277,347,,,0,0,0,,,,,,
654,278,371,654,278,371,,,0,0,0,,,,,,
655,279,395,655,279,395,,,0,0,0,,,,,,
655,279,419,655,279,419,,,0,0,0,,,,,,
655,280,443,655,280,443,,,0,0,0,,,,,,
656,281,468,655,281,467,,,1,0,1,,,,,,
656,282,492,656,282,492,,,0,0,0,,,,,,
656,283,517,656,283,516,,,0,0,1,,,,,,
657,284,541,657,284,541,,,0,0,0,,,,,,
657,285,566,657,285,566,,,0,0,0,,,,,,
657,286,591,657,286,591,,,0,0,0,,,,,,
658,287,616,657,287,616,,,1,0,0,,,,,,
658,288,641,658,288,641,,,0,0,0,,,,,,
659,290,666,658,289,666,,,1,1,0,,,,,,
659,291,691,659,291,691,,,0,0,0,,,,,,
660,292,716,659,292,716,,,1,0,0,,,,,,
660,294,742,660,294,742,,,0,0,0,,,,,,
661,295,767,661,295,767,,,0,0,0,,,,,,
655,295,115,655,295,115,,,0,0,0,,,,,,
655,295,117,655,295,115,,,0,0,2,,,,,,
655,295,122,655,295,122,,,0,0,0,,,,,,
655,295,131,655,295,132,,,0,0,-1,,,,,,
655,295,143,655,295,143,,,0,0,0,,,,,,
655,295,159,655,296,159,,,0,-1,0,,,,,,
656,296,176,655,296,176,,,1,0,0,,,,,,
656,296,195,655,296,195,,,1,0,0,,,,,,
656,296,215,656,296,215,,,0,0,0,,,,,,
656,296,236,656,297,236,,,0,-1,0,,,,,,
656,297,257,656,297,257,,,0,0,0,,,,,,
656,297,280,656,297,280,,,0,0,0,,,,,,
656,298,302,656,298,302,,,0,0,0,,,,,,
657,298,325,656,298,325,,,1,0,0,,,,,,
657,299,349,657,299,348,,,0,0,1,,,,,,
657,299,372,657,300,372,,,0,-1,0,,,,,,
657,300,396,657,301,396,,,0,-1,0,,,,,,
657,301,420,657,301,420,,,0,0,0,,,,,,
658,301,444,658,302,444,,,0,-1,0,,,,,,
658,302,468,658,302,468,,,0,0,0,,,,,,
658,303,493,658,303,493,,,0,0,0,,,,,,
659,304,517,659,304,517,,,0,0,0,,,,,,
659,305,542,659,305,542,,,0,0,0,,,,,,
660,306,567,659,306,566,,,1,0,1,,,,,,
660,307,592,660,307,591,,,0,0,1,,,,,,
660,308,617,660,308,616,,,0,0,1,,,,,,
661,309,641,661,309,641,,,0,0,0,,,,,,
661,310,667,661,310,666,,,0,0,1,,,,,,
662,311,692,662,312,691,,,0,-1,1,,,,,,
662,313,717,662,313,717,,,0,0,0,,,,,,
663,314,742,663,315,742,,,0,-1,0,,,,,,
663,315,767,663,316,767,,,0,-1,0,,,,,,
658,318,119,658,318,119,,,0,0,0,,,,,,
658,318,121,658,318,119,,,0,0,2,,,,,,
658,318,126,658,318,126,,,0,0,0,,,,,,
658,318,134,658,318,136,,,0,0,-2,,,,,,
658,318,147,658,318,147,,,0,0,0,,,,,,
658,318,161,658,318,162,,,0,0,-1,,,,,,
658,319,178,658,319,178,,,0,0,0,,,,,,
658,319,197,658,319,197,,,0,0,0,,,,,,
659,319,217,659,319,217,,,0,0,0,,,,,,
659,319,238,659,319,238,,,0,0,0,,,,,,
659,320,259,659,320,259,,,0,0,0,,,,,,
659,320,281,659,320,281,,,0,0,0,,,,,,
659,320,304,659,320,304,,,0,0,0,,,,,,
659,321,327,659,320,327,,,0,1,0,,,,,,
660,321,350,660,321,350,,,0,0,0,,,,,,
660,322,373,660,322,373,,,0,0,0,,,,,,
660,323,397,660,323,397,,,0,0,0,,,,,,
660,323,421,660,323,421,,,0,0,0,,,,,,
661,324,445,661,324,445,,,0,0,0,,,,,,
661,325,469,661,324,469,,,0,1,0,,,,,,
661,325,494,661,325,494,,,0,0,0,,,,,,
662,326,518,661,326,518,,,1,0,0,,,,,,
662,327,543,662,327,543,,,0,0,0,,,,,,
662,328,567,662,328,567,,,0,0,0,,,,,,
663,329,592,663,329,592,,,0,0,0,,,,,,
663,330,617,663,330,617,,,0,0,0,,,,,,
664,331,642,664,331,642,,,0,0,0,,,,,,
664,332,667,664,332,667,,,0,0,0,,,,,,
665,333,692,665,333,692,,,0,0,0,,,,,,
665,334,717,665,334,717,,,0,0,0,,,,,,
666,336,743,666,336,743,,,0,0,0,,,,,,
666,337,768,666,337,768,,,0,0,0,,,,,,
661,342,124,661,342,123,,,0,0,1,,,,,,
661,342,125,661,342,123,,,0,0,2,,,,,,
661,342,130,661,342,130,,,0,0,0,,,,,,
661,342,138,661,342,140,,,0,0,-2,,,,,,
661,342,150,661,342,150,,,0,0,0,,,,,,
662,342,165,661,342,165,,,1,0,0,,,,,,
662,342,181,661,343,181,,,1,-1,0,,,,,,
662,343,200,661,343,200,,,1,0,0,,,,,,
662,343,219,662,343,219,,,0,0,0,,,,,,
662,343,240,662,343,240,,,0,0,0,,,,,,
662,343,261,662,344,261,,,0,-1,0,,,,,,
662,344,283,662,344,283,,,0,0,0,,,,,,
662,344,305,662,344,305,,,0,0,0,,,,,,
663,345,328,662,344,328,,,1,1,0,,,,,,
663,345,351,663,345,351,,,0,0,0,,,,,,
663,346,375,663,345,374,,,0,1,1,,,,,,
663,346,398,663,346,398,,,0,0,0,,,,,,
664,347,422,663,347,422,,,1,0,0,,,,,,
664,347,446,664,348,446,,,0,-1,0,,,,,,
664,348,470,664,348,470,,,0,0,0,,,,,,
664,349,495,664,349,495,,,0,0,0,,,,,,
665,349,519,665,349,519,,,0,0,0,,,,,,
665,350,544,665,350,544,,,0,0,0,,,,,,
666,351,568,665,351,568,,,1,0,0,,,,,,
666,352,593,666,352,593,,,0,0,0,,,,,,
666,353,618,666,353,618,,,0,0,0,,,,,,
667,354,643,667,354,643,,,0,0,0,,,,,,
667,355,668,667,355,668,,,0,0,0,,,,,,
668,356,693,668,356,693,,,0,0,0,,,,,,
668,357,718,668,357,718,,,0,0,0,,,,,,
669,358,743,669,359,743,,,0,-1,0,,,,,,
669,359,768,669,360,768,,,0,-1,0,,,,,,
665,367,128,665,367,128,,,0,0,0,,,,,,
665,367,130,665,367,128,,,0,0,2,,,,,,
665,367,134,665,367,134,,,0,0,0,,,,,,
665,367,143,665,367,144,,,0,0,-1,,,,,,
665,367,154,665,367,154,,,0,0,0,,,,,,
665,367,168,665,367,169,,,0,0,-1,,,,,,
665,367,184,665,367,184,,,0,0,0,,,,,,
665,367,202,665,367,203,,,0,0,-1,,,,,,
665,367,222,665,367,222,,,0,0,0,,,,,,
665,368,242,665,367,242,,,0,1,0,,,,,,
666,368,263,666,368,263,,,0,0,0,,,,,,
666,368,285,666,368,285,,,0,0,0,,,,,,
666,369,307,666,369,307,,,0,0,0,,,,,,
666,369,330,666,369,330,,,0,0,0,,,,,,
666,369,353,666,369,353,,,0,0,0,,,,,,
667,370,376,666,369,376,,,1,1,0,,,,,,
667,370,399,667,370,399,,,0,0,0,,,,,,
667,371,423,667,371,423,,,0,0,0,,,,,,
667,372,447,667,372,447,,,0,0,0,,,,,,
668,372,471,667,372,471,,,1,0,0,,,,,,
668,373,496,668,373,496,,,0,0,0,,,,,,
668,374,520,668,373,520,,,0,1,0,,,,,,
669,374,545,669,374,545,,,0,0,0,,,,,,
669,375,569,669,375,569,,,0,0,0,,,,,,
669,376,594,669,376,594,,,0,0,0,,,,,,
670,377,619,669,377,619,,,1,0,0,,,,,,
670,378,644,670,378,644,,,0,0,0,,,,,,
671,379,669,670,379,669,,,1,0,0,,,,,,
671,380,694,671,380,694,,,0,0,0,,,,,,
672,381,719,671,381,719,,,1,0,0,,,,,,
672,382,744,672,382,744,,,0,0,0,,,,,,
673,383,769,673,383,769,,,0,0,0,,,,,,
669,392,134,669,392,133,,,0,0,1,,,,,,
669,392,135,669,392,133,,,0,0,2,,,,,,
669,392,139,669,392,139,,,0,0,0,,,,,,
669,392,147,669,392,148,,,0,0,-1,,,,,,
669,392,158,669,392,158,,,0,0,0,,,,,,
669,392,172,669,392,173,,,0,0,-1,,,,,,
669,392,188,669,392,188,,,0,0,0,,,,,,
669,392,206,669,392,206,,,0,0,0,,,,,,
669,393,224,669,392,224,,,0,1,0,,,,,,
669,393,244,669,393,245,,,0,0,-1,,,,,,
669,393,265,670,393,265,,,-1,0,0,,,,,,
670,393,287,670,393,287,,,0,0,0,,,,,,
670,394,309,670,394,309,,,0,0,0,,,,,,
670,394,331,670,394,331,,,0,0,0,,,,,,
670,394,354,670,394,354,,,0,0,0,,,,,,
670,395,378,670,395,377,,,0,0,1,,,,,,
671,395,401,671,395,401,,,0,0,0,,,,,,
671,396,425,671,396,424,,,0,0,1,,,,,,
671,396,449,671,397,448,,,0,-1,1,,,,,,
672,397,473,671,397,472,,,1,0,1,,,,,,
672,398,497,672,398,497,,,0,0,0,,,,,,
672,398,521,672,398,521,,,0,0,0,,,,,,
673,399,546,673,399,546,,,0,0,0,,,,,,
673,400,570,673,400,570,,,0,0,0,,,,,,
673,400,595,673,401,595,,,0,-1,0,,,,,,
674,401,620,673,401,619,,,1,0,1,,,,,,
674,402,644,674,402,644,,,0,0,0,,,,,,
675,403,669,674,403,669,,,1,0,0,,,,,,
675,404,694,675,404,694,,,0,0,0,,,,,,
676,405,719,675,405,719,,,1,0,0,,,,,,
676,406,745,676,406,744,,,0,0,1,,,,,,
677,407,770,677,407,769,,,0,0,1,,,,,,
673,418,139,673,418,139,,,0,0,0,,,,,,
673,418,140,673,418,139,,,0,0,1,,,,,,
673,418,144,673,418,144,,,0,0,0,,,,,,
673,418,152,673,418,153,,,0,0,-1,,,,,,
673,418,163,673,418,163,,,0,0,0,,,,,,
673,418,176,673,418,177,,,0,0,-1,,,,,,
673,418,192,673,418,192,,,0,0,0,,,,,,
673,418,209,673,418,209,,,0,0,0,,,,,,
673,418,227,673,418,227,,,0,0,0,,,,,,
674,418,247,673,418,247,,,1,0,0,,,,,,
674,419,268,674,419,268,,,0,0,0,,,,,,
674,419,289,674,419,289,,,0,0,0,,,,,,
674,419,311,674,419,311,,,0,0,0,,,,,,
674,420,333,674,419,333,,,0,1,0,,,,,,
674,420,356,674,420,356,,,0,0,0,,,,,,
675,420,379,674,420,379,,,1,0,0,,,,,,
675,421,403,675,421,403,,,0,0,0,,,,,,
675,421,426,675,421,426,,,0,0,0,,,,,,
675,422,450,675,422,450,,,0,0,0,,,,,,
676,422,474,675,422,474,,,1,0,0,,,,,,
676,423,498,676,423,498,,,0,0,0,,,,,,
676,424,522,676,423,522,,,0,1,0,,,,,,
677,424,547,677,424,547,,,0,0,0,,,,,,
677,425,571,677,425,571,,,0,0,0,,,,,,
678,426,596,678,426,596,,,0,0,0,,,,,,
678,426,621,678,426,620,,,0,0,1,,,,,,
678,427,645,678,427,645,,,0,0,0,,,,,,
679,428,670,678,428,670,,,1,0,0,,,,,,
679,429,695,679,429,695,,,0,0,0,,,,,,
680,430,720,679,430,720,,,1,0,0,,,,,,
680,431,745,680,431,745,,,0,0,0,,,,,,
681,432,771,681,432,770,,,0,0,1,,,,,,
678,444,144,678,444,144,,,0,0,0,,,,,,
678,444,145,678,444,144,,,0,0,1,,,,,,
678,444,150,678,444,149,,,0,0,1,,,,,,
678,444,157,678,444,158,,,0,0,-1,,,,,,
678,444,167,678,444,167,,,0,0,0,,,,,,
678,444,180,678,444,181,,,0,0,-1,,,,,,
678,444,195,678,444,196,,,0,0,-1,,,,,,
678,444,212,678,444,213,,,0,0,-1,,,,,,
678,444,231,678,444,230,,,0,0,1,,,,,,
678,445,250,678,444,250,,,0,1,0,,,,,,
678,445,271,678,445,270,,,0,0,1,,,,,,
678,445,292,678,445,292,,,0,0,0,,,,,,
679,445,313,679,445,313,,,0,0,0,,,,,,
679,446,336,679,445,335,,,0,1,1,,,,,,
679,446,358,679,446,358,,,0,0,0,,,,,,
679,446,381,679,446,381,,,0,0,0,,,,,,
680,447,404,679,447,404,,,1,0,0,,,,,,
680,447,428,679,447,428,,,1,0,0,,,,,,
680,448,451,680,448,451,,,0,0,0,,,,,,
680,448,475,680,448,475,,,0,0,0,,,,,,
681,449,499,681,449,499,,,0,0,0,,,,,,
681,449,524,681,449,523,,,0,0,1,,,,,,
681,450,548,681,450,548,,,0,0,0,,,,,,
682,451,572,682,450,572,,,0,1,0,,,,,,
682,451,597,682,451,597,,,0,0,0,,,,,,
683,452,622,682,452,621,,,1,0,1,,,,,,
683,453,646,683,453,646,,,0,0,0,,,,,,
683,453,671,683,453,671,,,0,0,0,,,,,,
684,454,696,684,454,696,,,0,0,0,,,,,,
684,455,721,684,455,721,,,0,0,0,,,,,,
685,456,746,685,456,746,,,0,0,0,,,,,,
686,457,771,685,457,771,,,1,0,0,,,,,,
683,470,150,683,470,150,,,0,0,0,,,,,,
683,470,151,683,470,150,,,0,0,1,,,,,,
683,470,155,683,470,155,,,0,0,0,,,,,,
683,470,162,683,470,163,,,0,0,-1,,,,,,
683,470,172,683,470,172,,,0,0,0,,,,,,
683,470,185,683,470,186,,,0,0,-1,,,,,,
683,471,200,683,471,200,,,0,0,0,,,,,,
683,471,216,683,471,217,,,0,0,-1,,,,,,
683,471,234,683,471,234,,,0,0,0,,,,,,
683,471,253,683,471,253,,,0,0,0,,,,,,
683,471,273,683,471,273,,,0,0,0,,,,,,
683,471,294,683,471,294,,,0,0,0,,,,,,
684,472,316,684,472,316,,,0,0,0,,,,,,
684,472,338,684,472,338,,,0,0,0,,,,,,
684,472,360,684,472,360,,,0,0,0,,,,,,
684,473,383,684,472,383,,,0,1,0,,,,,,
684,473,406,684,473,406,,,0,0,0,,,,,,
685,474,429,684,473,429,,,1,1,0,,,,,,
685,474,453,685,474,453,,,0,0,0,,,,,,
685,474,477,685,474,477,,,0,0,0,,,,,,
686,475,501,686,475,501,,,0,0,0,,,,,,
686,475,525,686,475,525,,,0,0,0,,,,,,
686,476,549,686,476,549,,,0,0,0,,,,,,
687,477,574,686,476,573,,,1,1,1,,,,,,
687,477,598,687,477,598,,,0,0,0,,,,,,
687,478,623,687,478,623,,,0,0,0,,,,,,
688,479,648,688,479,648,,,0,0,0,,,,,,
688,479,672,688,479,672,,,0,0,0,,,,,,
689,480,697,689,480,697,,,0,0,0,,,,,,
689,481,722,689,481,722,,,0,0,0,,,,,,
690,482,747,690,482,747,,,0,0,0,,,,,,
690,483,772,690,482,772,,,0,1,0,,,,,,
688,497,156,688,497,156,,,0,0,0,,,,,,
688,497,157,688,497,156,,,0,0,1,,,,,,
688,497,161,688,497,161,,,0,0,0,,,,,,
688,497,168,688,497,169,,,0,0,-1,,,,,,
688,497,177,688,497,177,,,0,0,0,,,,,,
688,497,190,688,497,191,,,0,0,-1,,,,,,
688,497,204,688,497,204,,,0,0,0,,,,,,
688,497,220,688,497,221,,,0,0,-1,,,,,,
688,498,238,688,498,238,,,0,0,0,,,,,,
688,498,257,688,498,257,,,0,0,0,,,,,,
689,498,277,688,498,276,,,1,0,1,,,,,,
689,498,297,688,498,297,,,1,0,0,,,,,,
689,499,318,689,499,318,,,0,0,0,,,,,,
689,499,340,689,499,340,,,0,0,0,,,,,,
689,499,363,689,499,362,,,0,0,1,,,,,,
689,499,385,689,499,385,,,0,0,0,,,,,,
690,500,408,689,500,408,,,1,0,0,,,,,,
690,500,431,690,500,431,,,0,0,0,,,,,,
690,501,455,690,501,455,,,0,0,0,,,,,,
691,501,479,690,501,478,,,1,0,1,,,,,,
691,502,502,691,501,502,,,0,1,0,,,,,,
691,502,526,691,502,526,,,0,0,0,,,,,,
692,503,551,691,502,550,,,1,1,1,,,,,,
692,503,575,692,503,575,,,0,0,0,,,,,,
692,504,599,692,503,599,,,0,1,0,,,,,,
693,504,624,693,504,624,,,0,0,0,,,,,,
693,505,649,693,505,649,,,0,0,0,,,,,,
694,506,673,694,506,673,,,0,0,0,,,,,,
694,506,698,694,506,698,,,0,0,0,,,,,,
695,507,723,695,507,723,,,0,0,0,,,,,,
695,508,748,695,508,748,,,0,0,0,,,,,,
696,509,773,696,508,773,,,0,1,0,,,,,,
694,524,162,694,524,162,,,0,0,0,,,,,,
694,524,163,694,524,162,,,0,0,1,,,,,,
694,524,167,694,524,167,,,0,0,0,,,,,,
694,524,173,694,524,175,,,0,0,-2,,,,,,
694,524,183,694,524,183,,,0,0,0,,,,,,
694,524,195,694,524,196,,,0,0,-1,,,,,,
694,524,209,694,524,209,,,0,0,0,,,,,,
694,525,224,694,524,225,,,0,1,-1,,,,,,
694,525,242,694,525,242,,,0,0,0,,,,,,
694,525,260,694,525,261,,,0,0,-1,,,,,,
694,525,280,694,525,280,,,0,0,0,,,,,,
694,525,300,694,525,300,,,0,0,0,,,,,,
694,526,321,694,526,321,,,0,0,0,,,,,,
695,526,343,694,526,343,,,1,0,0,,,,,,
695,526,365,695,526,365,,,0,0,0,,,,,,
695,526,387,695,526,387,,,0,0,0,,,,,,
695,527,410,695,527,410,,,0,0,0,,,,,,
696,527,433,695,527,433,,,1,0,0,,,,,,
696,528,457,696,528,457,,,0,0,0,,,,,,
696,528,480,696,528,480,,,0,0,0,,,,,,
696,528,504,696,528,504,,,0,0,0,,,,,,
697,529,528,696,528,528,,,1,1,0,,,,,,
697,529,552,697,529,552,,,0,0,0,,,,,,
697,530,576,697,529,576,,,0,1,0,,,,,,
698,530,601,698,530,601,,,0,0,0,,,,,,
698,531,625,698,531,625,,,0,0,0,,,,,,
699,532,650,699,532,650,,,0,0,0,,,,,,
699,532,675,699,532,674,,,0,0,1,,,,,,
700,533,699,700,533,699,,,0,0,0,,,,,,
700,534,724,700,533,724,,,0,1,0,,,,,,
701,534,749,701,534,749,,,0,0,0,,,,,,
701,535,774,701,535,774,,,0,0,0,,,,,,
699,552,168,700,551,168,,,-1,1,0,,,,,,
699,552,169,700,551,168,,,-1,1,1,,,,,,
699,552,173,700,551,173,,,-1,1,0,,,,,,
700,552,179,700,551,180,,,0,1,-1,,,,,,
700,552,188,700,551,188,,,0,1,0,,,,,,
700,552,200,700,551,201,,,0,1,-1,,,,,,
700,552,213,700,551,213,,,0,1,0,,,,,,
700,552,229,700,552,229,,,0,0,0,,,,,,
700,552,246,700,552,246,,,0,0,0,,,,,,
700,552,264,700,552,264,,,0,0,0,,,,,,
700,552,283,700,552,283,,,0,0,0,,,,,,
700,553,303,700,552,303,,,0,1,0,,,,,,
700,553,324,700,553,324,,,0,0,0,,,,,,
701,553,346,700,553,345,,,1,0,1,,,,,,
701,553,368,701,553,367,,,0,0,1,,,,,,
701,554,390,701,553,390,,,0,1,0,,,,,,
701,554,413,701,554,412,,,0,0,1,,,,,,
701,554,436,701,554,435,,,0,0,1,,,,,,
702,555,459,702,555,459,,,0,0,0,,,,,,
702,555,482,702,555,482,,,0,0,0,,,,,,
702,556,506,702,555,506,,,0,1,0,,,,,,
703,556,530,702,556,530,,,1,0,0,,,,,,
703,556,554,703,556,554,,,0,0,0,,,,,,
703,557,578,703,557,578,,,0,0,0,,,,,,
704,557,602,704,557,602,,,0,0,0,,,,,,
704,558,627,704,558,627,,,0,0,0,,,,,,
705,559,651,705,559,651,,,0,0,0,,,,,,
705,559,676,705,559,676,,,0,0,0,,,,,,
706,560,701,706,560,700,,,0,0,1,,,,,,
706,561,726,706,560,725,,,0,1,1,,,,,,
707,561,750,707,561,750,,,0,0,0,,,,,,
707,562,775,707,562,775,,,0,0,0,,,,,,
706,579,175,706,579,175,,,0,0,0,,,,,,
706,579,176,706,579,175,,,0,0,1,,,,,,
706,579,179,706,579,179,,,0,0,0,,,,,,
706,579,185,706,579,186,,,0,0,-1,,,,,,
706,579,194,706,579,194,,,0,0,0,,,,,,
706,579,205,706,579,206,,,0,0,-1,,,,,,
706,579,218,706,579,218,,,0,0,0,,,,,,
706,580,233,706,579,234,,,0,1,-1,,,,,,
706,580,250,706,580,250,,,0,0,0,,,,,,
706,580,268,706,580,268,,,0,0,0,,,,,,
706,580,287,706,580,287,,,0,0,0,,,,,,
707,580,307,706,580,307,,,1,0,0,,,,,,
707,580,327,707,580,327,,,0,0,0,,,,,,
707,581,349,707,580,348,,,0,1,1,,,,,,
707,581,370,707,581,370,,,0,0,0,,,,,,
707,581,392,707,581,392,,,0,0,0,,,,,,
708,581,415,708,581,415,,,0,0,0,,,,,,
708,582,438,708,581,438,,,0,1,0,,,,,,
708,582,461,708,582,461,,,0,0,0,,,,,,
708,583,484,708,582,484,,,0,1,0,,,,,,
709,583,508,709,583,508,,,0,0,0,,,,,,
709,583,532,709,583,532,,,0,0,0,,,,,,
709,584,556,709,584,556,,,0,0,0,,,,,,
710,584,580,709,584,580,,,1,0,0,,,,,,
710,585,604,710,585,604,,,0,0,0,,,,,,
710,585,628,710,585,628,,,0,0,0,,,,,,
711,586,653,711,586,653,,,0,0,0,,,,,,
711,586,677,711,586,677,,,0,0,0,,,,,,
712,587,702,712,587,702,,,0,0,0,,,,,,
712,588,727,712,587,727,,,0,1,0,,,,,,
713,588,752,713,588,752,,,0,0,0,,,,,,
713,589,777,713,589,777,,,0,0,0,,,,,,
712,607,181,712,607,181,,,0,0,0,,,,,,
712,607,182,712,607,181,,,0,0,1,,,,,,
712,607,185,712,607,185,,,0,0,0,,,,,,
712,607,191,712,607,192,,,0,0,-1,,,,,,
712,607,200,712,607,200,,,0,0,0,,,,,,
712,607,210,712,607,211,,,0,0,-1,,,,,,
713,607,223,712,607,223,,,1,0,0,,,,,,
713,607,238,712,607,239,,,1,0,-1,,,,,,
713,607,254,713,607,254,,,0,0,0,,,,,,
713,608,272,713,607,272,,,0,1,0,,,,,,
713,608,291,713,608,291,,,0,0,0,,,,,,
713,608,310,713,608,310,,,0,0,0,,,,,,
713,608,331,713,608,330,,,0,0,1,,,,,,
713,608,352,713,608,351,,,0,0,1,,,,,,
714,609,373,714,608,373,,,0,1,0,,,,,,
714,609,395,714,608,395,,,0,1,0,,,,,,
714,609,417,714,609,417,,,0,0,0,,,,,,
714,609,440,714,609,440,,,0,0,0,,,,,,
715,610,463,715,610,463,,,0,0,0,,,,,,
715,610,486,715,610,486,,,0,0,0,,,,,,
715,610,510,715,610,510,,,0,0,0,,,,,,
716,611,534,715,611,533,,,1,0,1,,,,,,
716,611,557,716,611,557,,,0,0,0,,,,,,
716,612,581,716,612,581,,,0,0,0,,,,,,
717,612,606,716,612,605,,,1,0,1,,,,,,
717,613,630,717,613,630,,,0,0,0,,,,,,
717,613,654,717,613,654,,,0,0,0,,,,,,
718,614,679,718,614,679,,,0,0,0,,,,,,
718,614,703,718,614,703,,,0,0,0,,,,,,
719,615,728,719,615,728,,,0,0,0,,,,,,
719,616,753,719,615,753,,,0,1,0,,,,,,
720,616,778,720,616,778,,,0,0,0,,,,,,
719,635,188,719,635,188,,,0,0,0,,,,,,
719,635,189,719,635,188,,,0,0,1,,,,,,
719,635,192,719,635,192,,,0,0,0,,,,,,
719,635,198,719,635,199,,,0,0,-1,,,,,,
719,635,206,719,635,206,,,0,0,0,,,,,,
719,635,216,719,635,217,,,0,0,-1,,,,,,
719,635,229,719,635,229,,,0,0,0,,,,,,
720,635,243,719,635,244,,,1,0,-1,,,,,,
720,635,259,720,635,259,,,0,0,0,,,,,,
720,635,276,720,635,277,,,0,0,-1,,,,,,
720,636,295,720,636,295,,,0,0,0,,,,,,
720,636,314,720,636,314,,,0,0,0,,,,,,
720,636,334,720,636,334,,,0,0,0,,,,,,
720,636,355,720,636,355,,,0,0,0,,,,,,
721,636,376,721,636,376,,,0,0,0,,,,,,
721,637,398,721,636,398,,,0,1,0,,,,,,
721,637,420,721,637,420,,,0,0,0,,,,,,
721,637,443,721,637,443,,,0,0,0,,,,,,
722,638,466,722,638,466,,,0,0,0,,,,,,
722,638,489,722,638,489,,,0,0,0,,,,,,
722,638,512,722,638,512,,,0,0,0,,,,,,
722,639,536,722,638,535,,,0,1,1,,,,,,
723,639,559,723,639,559,,,0,0,0,,,,,,
723,639,583,723,639,583,,,0,0,0,,,,,,
723,640,607,723,640,607,,,0,0,0,,,,,,
724,640,632,723,640,631,,,1,0,1,,,,,,
724,641,656,724,641,656,,,0,0,0,,,,,,
725,641,680,724,641,680,,,1,0,0,,,,,,
725,642,705,725,642,705,,,0,0,0,,,,,,
726,643,730,725,642,729,,,1,1,1,,,,,,
726,643,754,726,643,754,,,0,0,0,,,,,,
727,644,779,726,643,779,,,1,1,0,,,,,,
726,663,195,726,663,195,,,0,0,0,,,,,,
727,663,195,726,663,195,,,1,0,0,,,,,,
727,663,198,726,663,198,,,1,0,0,,,,,,
727,663,204,726,663,205,,,1,0,-1,,,,,,
727,663,212,726,663,212,,,1,0,0,,,,,,
727,663,222,726,663,223,,,1,0,-1,,,,,,
727,663,234,726,663,234,,,1,0,0,,,,,,
727,663,248,726,663,249,,,1,0,-1,,,,,,
727,663,264,727,663,264,,,0,0,0,,,,,,
727,663,281,727,663,281,,,0,0,0,,,,,,
727,664,299,727,664,299,,,0,0,0,,,,,,
727,664,318,727,664,318,,,0,0,0,,,,,,
727,664,338,727,664,337,,,0,0,1,,,,,,
728,664,358,727,664,358,,,1,0,0,,,,,,
728,664,379,728,664,379,,,0,0,0,,,,,,
728,665,401,728,664,401,,,0,1,0,,,,,,
728,665,423,728,665,423,,,0,0,0,,,,,,
728,665,445,728,665,445,,,0,0,0,,,,,,
729,666,468,729,666,468,,,0,0,0,,,,,,
729,666,491,729,666,491,,,0,0,0,,,,,,
729,666,514,729,666,514,,,0,0,0,,,,,,
730,667,538,729,666,537,,,1,1,1,,,,,,
730,667,561,730,667,561,,,0,0,0,,,,,,
730,667,585,730,667,585,,,0,0,0,,,,,,
731,668,609,730,668,609,,,1,0,0,,,,,,
731,668,633,731,668,633,,,0,0,0,,,,,,
731,669,658,731,669,657,,,0,0,1,,,,,,
732,669,682,732,669,682,,,0,0,0,,,,,,
732,670,707,732,670,706,,,0,0,1,,,,,,
733,670,731,733,670,731,,,0,0,0,,,,,,
733,671,756,733,671,755,,,0,0,1,,,,,,
734,671,781,734,671,780,,,0,0,1,,,,,,
734,691,202,734,691,202,,,0,0,0,,,,,,
734,691,202,734,691,202,,,0,0,0,,,,,,
734,691,205,734,691,205,,,0,0,0,,,,,,
734,691,210,734,691,211,,,0,0,-1,,,,,,
734,691,218,734,691,218,,,0,0,0,,,,,,
734,691,228,734,691,229,,,0,0,-1,,,,,,
734,691,240,734,691,240,,,0,0,0,,,,,,
734,691,253,734,691,254,,,0,0,-1,,,,,,
734,692,269,734,692,269,,,0,0,0,,,,,,
735,692,285,734,692,286,,,1,0,-1,,,,,,
735,692,303,735,692,303,,,0,0,0,,,,,,
735,692,322,735,692,322,,,0,0,0,,,,,,
735,692,341,735,692,341,,,0,0,0,,,,,,
735,692,362,735,692,362,,,0,0,0,,,,,,
735,693,383,735,693,383,,,0,0,0,,,,,,
735,693,404,735,693,404,,,0,0,0,,,,,,
736,693,426,736,693,426,,,0,0,0,,,,,,
736,693,448,736,693,448,,,0,0,0,,,,,,
736,694,471,736,694,471,,,0,0,0,,,,,,
736,694,493,736,694,494,,,0,0,-1,,,,,,
737,694,517,737,694,517,,,0,0,0,,,,,,
737,695,540,737,694,540,,,0,1,0,,,,,,
737,695,563,737,695,563,,,0,0,0,,,,,,
738,695,587,737,695,587,,,1,0,0,,,,,,
738,696,611,738,696,611,,,0,0,0,,,,,,
739,696,635,738,696,635,,,1,0,0,,,,,,
739,697,659,739,697,659,,,0,0,0,,,,,,
739,697,684,739,697,683,,,0,0,1,,,,,,
740,698,708,740,698,708,,,0,0,0,,,,,,
740,698,733,740,698,732,,,0,0,1,,,,,,
741,699,757,741,699,757,,,0,0,0,,,,,,
741,699,782,741,699,782,,,0,0,0,,,,,,
742,720,208,742,719,208,,,0,1,0,,,,,,
742,720,209,742,719,208,,,0,1,1,,,,,,
742,720,212,742,719,212,,,0,1,0,,,,,,
742,720,217,742,719,218,,,0,1,-1,,,,,,
742,720,224,742,719,224,,,0,1,0,,,,,,
742,720,234,742,719,235,,,0,1,-1,,,,,,
742,720,245,742,719,245,,,0,1,0,,,,,,
742,720,259,742,719,259,,,0,1,0,,,,,,
742,720,274,742,720,274,,,0,0,0,,,,,,
742,720,290,742,720,290,,,0,0,0,,,,,,
742,720,308,743,720,307,,,-1,0,1,,,,,,
743,720,326,743,720,326,,,0,0,0,,,,,,
743,720,345,743,720,345,,,0,0,0,,,,,,
743,721,365,743,720,365,,,0,1,0,,,,,,
743,721,386,743,721,386,,,0,0,0,,,,,,
743,721,407,743,721,407,,,0,0,0,,,,,,
744,721,429,744,721,429,,,0,0,0,,,,,,
744,722,451,744,721,451,,,0,1,0,,,,,,
744,722,473,744,722,473,,,0,0,0,,,,,,
744,722,496,744,722,496,,,0,0,0,,,,,,
745,722,519,745,722,519,,,0,0,0,,,,,,
745,723,542,745,722,542,,,0,1,0,,,,,,
745,723,566,745,723,565,,,0,0,1,,,,,,
746,724,589,745,723,589,,,1,1,0,,,,,,
746,724,613,746,724,613,,,0,0,0,,,,,,
746,724,637,746,724,637,,,0,0,0,,,,,,
747,725,661,747,725,661,,,0,0,0,,,,,,
747,725,686,747,725,685,,,0,0,1,,,,,,
748,726,710,748,726,710,,,0,0,0,,,,,,
748,726,734,748,726,734,,,0,0,0,,,,,,
748,727,759,749,727,759,,,-1,0,0,,,,,,
749,727,784,749,727,783,,,0,0,1,,,,,,
750,748,215,750,748,215,,,0,0,0,,,,,,
750,748,216,750,748,215,,,0,0,1,,,,,,
750,748,219,750,748,219,,,0,0,0,,,,,,
750,748,224,750,748,225,,,0,0,-1,,,,,,
750,748,231,750,748,231,,,0,0,0,,,,,,
750,748,240,750,748,241,,,0,0,-1,,,,,,
750,748,251,750,748,251,,,0,0,0,,,,,,
750,748,264,750,748,265,,,0,0,-1,,,,,,
750,748,279,750,748,279,,,0,0,0,,,,,,
750,748,295,750,748,295,,,0,0,0,,,,,,
751,749,312,751,749,312,,,0,0,0,,,,,,
751,749,330,751,749,330,,,0,0,0,,,,,,
751,749,349,751,749,349,,,0,0,0,,,,,,
751,749,369,751,749,369,,,0,0,0,,,,,,
751,749,390,751,749,390,,,0,0,0,,,,,,
751,749,411,751,749,411,,,0,0,0,,,,,,
752,750,432,752,750,432,,,0,0,0,,,,,,
752,750,454,752,750,454,,,0,0,0,,,,,,
752,750,476,752,750,476,,,0,0,0,,,,,,
752,751,499,752,750,499,,,0,1,0,,,,,,
753,751,522,753,751,522,,,0,0,0,,,,,,
753,751,545,753,751,545,,,0,0,0,,,,,,
753,751,568,753,751,568,,,0,0,0,,,,,,
754,752,592,753,751,591,,,1,1,1,,,,,,
754,752,615,754,752,615,,,0,0,0,,,,,,
754,753,639,754,752,639,,,0,1,0,,,,,,
755,753,663,755,753,663,,,0,0,0,,,,,,
755,753,687,755,753,687,,,0,0,0,,,,,,
756,754,712,756,754,712,,,0,0,0,,,,,,
756,754,736,756,754,736,,,0,0,0,,,,,,
757,755,761,757,755,761,,,0,0,0,,,,,,
757,755,785,757,755,785,,,0,0,0,,,,,,
758,777,222,758,776,222,,,0,1,0,,,,,,
758,777,223,758,776,222,,,0,1,1,,,,,,
758,777,226,758,776,226,,,0,1,0,,,,,,
758,777,230,758,776,231,,,0,1,-1,,,,,,
758,777,237,758,776,237,,,0,1,0,,,,,,
758,777,246,758,776,247,,,0,1,-1,,,,,,
759,777,257,758,776,257,,,1,1,0,,,,,,
759,777,270,758,776,270,,,1,1,0,,,,,,
759,777,284,758,777,284,,,1,0,0,,,,,,
759,777,300,759,777,300,,,0,0,0,,,,,,
759,777,317,759,777,317,,,0,0,0,,,,,,
759,777,335,759,777,335,,,0,0,0,,,,,,
759,777,353,759,777,353,,,0,0,0,,,,,,
759,778,373,759,777,373,,,0,1,0,,,,,,
760,778,393,759,777,393,,,1,1,0,,,,,,
760,778,414,760,778,414,,,0,0,0,,,,,,
760,778,435,760,778,435,,,0,0,0,,,,,,
760,778,457,760,778,457,,,0,0,0,,,,,,
760,779,479,760,778,479,,,0,1,0,,,,,,
761,779,502,761,779,501,,,0,0,1,,,,,,
761,779,524,761,779,524,,,0,0,0,,,,,,
761,780,547,761,779,547,,,0,1,0,,,,,,
762,780,570,761,779,570,,,1,1,0,,,,,,
762,780,594,762,780,594,,,0,0,0,,,,,,
762,781,618,762,780,617,,,0,1,1,,,,,,
763,781,641,763,781,641,,,0,0,0,,,,,,
763,781,665,763,781,665,,,0,0,0,,,,,,
763,782,689,764,782,689,,,-1,0,0,,,,,,
764,782,714,764,782,714,,,0,0,0,,,,,,
764,783,738,764,783,738,,,0,0,0,,,,,,
765,783,762,765,783,762,,,0,0,0,,,,,,
765,784,787,765,784,787,,,0,0,0,,,,,,
767,805,230,767,805,230,,,0,0,0,,,,,,
767,805,230,767,805,230,,,0,0,0,,,,,,
767,805,233,767,805,233,,,0,0,0,,,,,,
767,805,237,767,805,238,,,0,0,-1,,,,,,
767,805,244,767,805,244,,,0,0,0,,,,,,
767,805,253,767,805,253,,,0,0,0,,,,,,
767,805,263,767,805,263,,,0,0,0,,,,,,
767,805,276,767,805,276,,,0,0,0,,,,,,
767,806,290,767,806,290,,,0,0,0,,,,,,
767,806,305,767,806,306,,,0,0,-1,,,,,,
768,806,322,768,806,322,,,0,0,0,,,,,,
768,806,339,768,806,340,,,0,0,-1,,,,,,
768,806,358,768,806,358,,,0,0,0,,,,,,
768,806,377,768,806,377,,,0,0,0,,,,,,
768,806,397,768,806,397,,,0,0,0,,,,,,
768,807,418,768,806,418,,,0,1,0,,,,,,
769,807,439,769,807,439,,,0,0,0,,,,,,
769,807,460,769,807,460,,,0,0,0,,,,,,
769,807,482,769,807,482,,,0,0,0,,,,,,
769,808,504,769,807,504,,,0,1,0,,,,,,
770,808,527,770,808,527,,,0,0,0,,,,,,
770,808,550,770,808,550,,,0,0,0,,,,,,
770,808,573,770,808,573,,,0,0,0,,,,,,
771,809,596,770,808,596,,,1,1,0,,,,,,
771,809,620,771,809,620,,,0,0,0,,,,,,
771,810,644,771,809,643,,,0,1,1,,,,,,
772,810,667,772,810,667,,,0,0,0,,,,,,
772,810,691,772,810,691,,,0,0,0,,,,,,
773,811,716,773,811,716,,,0,0,0,,,,,,
773,811,740,773,811,740,,,0,0,0,,,,,,
773,812,764,773,812,764,,,0,0,0,,,,,,
774,812,789,773,812,788,,,1,0,1,,,,,,
776,834,237,776,834,237,,,0,0,0,,,,,,
776,834,237,776,834,237,,,0,0,0,,,,,,
776,834,240,776,834,240,,,0,0,0,,,,,,
776,834,244,776,834,245,,,0,0,-1,,,,,,
776,834,251,776,834,250,,,0,0,1,,,,,,
776,834,259,776,834,260,,,0,0,-1,,,,,,
776,834,269,776,834,269,,,0,0,0,,,,,,
776,834,282,776,834,282,,,0,0,0,,,,,,
776,834,295,776,834,295,,,0,0,0,,,,,,
776,834,310,776,834,311,,,0,0,-1,,,,,,
777,835,327,777,834,327,,,0,1,0,,,,,,
777,835,344,777,834,344,,,0,1,0,,,,,,
777,835,362,777,835,362,,,0,0,0,,,,,,
777,835,381,777,835,381,,,0,0,0,,,,,,
777,835,401,777,835,401,,,0,0,0,,,,,,
777,835,421,777,835,421,,,0,0,0,,,,,,
778,836,442,778,835,442,,,0,1,0,,,,,,
778,836,464,778,835,464,,,0,1,0,,,,,,
778,836,485,778,836,485,,,0,0,0,,,,,,
778,836,507,778,836,507,,,0,0,0,,,,,,
779,837,530,779,836,530,,,0,1,0,,,,,,
779,837,553,779,836,552,,,0,1,1,,,,,,
779,837,576,779,837,575,,,0,0,1,,,,,,
779,837,599,779,837,599,,,0,0,0,,,,,,
780,838,622,780,837,622,,,0,1,0,,,,,,
780,838,646,780,838,646,,,0,0,0,,,,,,
781,838,670,781,838,669,,,0,0,1,,,,,,
781,839,694,781,839,693,,,0,0,1,,,,,,
781,839,718,782,839,718,,,-1,0,0,,,,,,
782,840,742,782,840,742,,,0,0,0,,,,,,
782,840,766,782,840,766,,,0,0,0,,,,,,
783,841,791,782,841,790,,,1,0,1,,,,,,
785,863,244,785,863,244,,,0,0,0,,,,,,
785,863,245,785,863,244,,,0,0,1,,,,,,
785,863,247,785,863,247,,,0,0,0,,,,,,
785,863,251,785,863,252,,,0,0,-1,,,,,,
785,863,257,785,863,257,,,0,0,0,,,,,,
785,863,266,785,863,266,,,0,0,0,,,,,,
785,863,276,785,863,276,,,0,0,0,,,,,,
785,863,288,785,863,288,,,0,0,0,,,,,,
785,863,301,785,863,301,,,0,0,0,,,,,,
786,863,316,785,863,316,,,1,0,0,,,,,,
786,863,332,786,863,332,,,0,0,0,,,,,,
786,864,349,786,863,349,,,0,1,0,,,,,,
786,864,367,786,864,367,,,0,0,0,,,,,,
786,864,386,786,864,386,,,0,0,0,,,,,,
786,864,405,786,864,405,,,0,0,0,,,,,,
787,864,425,786,864,425,,,1,0,0,,,,,,
787,864,446,787,864,446,,,0,0,0,,,,,,
787,865,467,787,864,467,,,0,1,0,,,,,,
787,865,489,787,865,489,,,0,0,0,,,,,,
787,865,511,787,865,511,,,0,0,0,,,,,,
788,865,533,788,865,533,,,0,0,0,,,,,,
788,866,555,788,865,555,,,0,1,0,,,,,,
788,866,578,788,866,578,,,0,0,0,,,,,,
789,866,601,788,866,601,,,1,0,0,,,,,,
789,866,625,789,866,625,,,0,0,0,,,,,,
789,867,648,789,866,648,,,0,1,0,,,,,,
790,867,672,790,867,672,,,0,0,0,,,,,,
790,868,696,790,867,696,,,0,1,0,,,,,,
791,868,720,791,868,720,,,0,0,0,,,,,,
791,868,744,791,868,744,,,0,0,0,,,,,,
791,869,768,791,869,768,,,0,0,0,,,,,,
792,869,792,791,869,792,,,1,0,0,,,,,,
795,892,251,794,892,251,,,1,0,0,,,,,,
795,892,252,794,892,251,,,1,0,1,,,,,,
795,892,254,794,892,254,,,1,0,0,,,,,,
795,892,258,794,892,259,,,1,0,-1,,,,,,
795,892,264,794,892,264,,,1,0,0,,,,,,
795,892,272,794,892,273,,,1,0,-1,,,,,,
795,892,282,794,892,282,,,1,0,0,,,,,,
795,892,294,794,892,294,,,1,0,0,,,,,,
795,892,307,795,892,307,,,0,0,0,,,,,,
795,892,321,795,892,322,,,0,0,-1,,,,,,
795,892,337,795,892,337,,,0,0,0,,,,,,
795,892,354,795,892,354,,,0,0,0,,,,,,
795,893,371,795,893,371,,,0,0,0,,,,,,
796,893,390,795,893,390,,,1,0,0,,,,,,
796,893,409,795,893,409,,,1,0,0,,,,,,
796,893,429,796,893,429,,,0,0,0,,,,,,
796,893,450,796,893,450,,,0,0,0,,,,,,
796,893,471,796,893,471,,,0,0,0,,,,,,
797,894,492,796,894,492,,,1,0,0,,,,,,
797,894,514,797,894,514,,,0,0,0,,,,,,
797,894,536,797,894,536,,,0,0,0,,,,,,
797,894,558,797,894,558,,,0,0,0,,,,,,
798,895,581,797,895,581,,,1,0,0,,,,,,
798,895,604,798,895,604,,,0,0,0,,,,,,
798,895,627,798,895,627,,,0,0,0,,,,,,
799,896,651,799,895,651,,,0,1,0,,,,,,
799,896,674,799,896,674,,,0,0,0,,,,,,
799,896,698,799,896,698,,,0,0,0,,,,,,
800,897,722,800,897,722,,,0,0,0,,,,,,
800,897,746,800,897,746,,,0,0,0,,,,,,
801,897,770,800,897,770,,,1,0,0,,,,,,
801,898,794,801,898,794,,,0,0,0,,,,,,
672,186,102,672,186,102,,,0,0,0,,,,,,
672,186,103,672,186,102,,,0,0,1,,,,,,
672,186,109,672,186,109,,,0,0,0,,,,,,
672,186,120,672,186,121,,,0,0,-1,,,,,,
672,186,133,672,186,133,,,0,0,0,,,,,,
672,187,150,672,186,150,,,0,1,0,,,,,,
672,187,168,673,187,167,,,-1,0,1,,,,,,
673,187,188,673,187,188,,,0,0,0,,,,,,
673,188,208,673,187,208,,,0,1,0,,,,,,
673,188,230,673,188,230,,,0,0,0,,,,,,
673,189,252,673,188,252,,,0,1,0,,,,,,
673,189,275,673,189,275,,,0,0,0,,,,,,
673,190,298,673,190,298,,,0,0,0,,,,,,
673,191,321,673,191,321,,,0,0,0,,,,,,
674,192,345,674,191,345,,,0,1,0,,,,,,
674,193,369,674,192,369,,,0,1,0,,,,,,
674,194,393,674,194,393,,,0,0,0,,,,,,
674,195,417,674,195,417,,,0,0,0,,,,,,
675,196,441,675,196,441,,,0,0,0,,,,,,
675,198,466,675,197,465,,,0,1,1,,,,,,
675,199,490,675,199,490,,,0,0,0,,,,,,
676,200,515,675,200,515,,,1,0,0,,,,,,
676,202,540,676,202,539,,,0,0,1,,,,,,
676,203,565,676,203,564,,,0,0,1,,,,,,
677,205,590,677,205,589,,,0,0,1,,,,,,
677,207,615,677,206,614,,,0,1,1,,,,,,
678,208,640,677,208,639,,,1,0,1,,,,,,
678,210,665,678,210,664,,,0,0,1,,,,,,
679,212,690,678,212,689,,,1,0,1,,,,,,
679,214,715,679,214,715,,,0,0,0,,,,,,
680,216,741,679,216,740,,,1,0,1,,,,,,
680,218,766,680,218,766,,,0,0,0,,,,,,
672,187,102,672,186,102,,,0,1,0,,,,,,
672,187,104,672,186,102,,,0,1,2,,,,,,
672,187,110,672,186,109,,,0,1,1,,,,,,
672,187,120,672,186,121,,,0,1,-1,,,,,,
672,187,133,672,186,133,,,0,1,0,,,,,,
672,188,150,672,186,150,,,0,2,0,,,,,,
673,188,168,673,187,167,,,0,1,1,,,,,,
673,188,188,673,187,188,,,0,1,0,,,,,,
673,189,208,673,187,208,,,0,2,0,,,,,,
673,189,230,673,188,230,,,0,1,0,,,,,,
673,190,252,673,188,252,,,0,2,0,,,,,,
673,191,275,673,189,275,,,0,2,0,,,,,,
673,191,298,673,190,298,,,0,1,0,,,,,,
674,192,321,673,191,321,,,1,1,0,,,,,,
674,193,345,674,191,345,,,0,2,0,,,,,,
674,194,369,674,192,369,,,0,2,0,,,,,,
674,195,393,674,194,393,,,0,1,0,,,,,,
674,196,417,674,195,417,,,0,1,0,,,,,,
675,197,441,675,196,441,,,0,1,0,,,,,,
675,199,466,675,197,465,,,0,2,1,,,,,,
675,200,490,675,199,490,,,0,1,0,,,,,,
676,201,515,675,200,515,,,1,1,0,,,,,,
676,203,540,676,202,539,,,0,1,1,,,,,,
676,204,565,676,203,564,,,0,1,1,,,,,,
677,206,590,677,205,589,,,0,1,1,,,,,,
677,208,615,677,206,614,,,0,2,1,,,,,,
678,209,640,677,208,639,,,1,1,1,,,,,,
678,211,665,678,210,664,,,0,1,1,,,,,,
679,213,690,678,212,689,,,1,1,1,,,,,,
679,215,715,679,214,715,,,0,1,0,,,,,,
680,217,741,679,216,740,,,1,1,1,,,,,,
680,219,766,680,218,766,,,0,1,0,,,,,,
673,191,102,673,191,102,,,0,0,0,,,,,,
673,191,104,673,191,102,,,0,0,2,,,,,,
673,191,110,673,191,110,,,0,0,0,,,,,,
673,191,120,673,191,122,,,0,0,-2,,,,,,
673,192,134,673,191,134,,,0,1,0,,,,,,
673,192,150,673,192,151,,,0,0,-1,,,,,,
673,192,168,673,192,168,,,0,0,0,,,,,,
673,193,188,673,192,188,,,0,1,0,,,,,,
673,193,209,673,193,209,,,0,0,0,,,,,,
673,194,230,673,193,230,,,0,1,0,,,,,,
673,194,252,673,194,252,,,0,0,0,,,,,,
673,195,275,673,194,275,,,0,1,0,,,,,,
674,195,298,674,195,298,,,0,0,0,,,,,,
674,196,321,674,196,321,,,0,0,0,,,,,,
674,197,345,674,197,345,,,0,0,0,,,,,,
674,198,369,674,198,369,,,0,0,0,,,,,,
675,199,393,674,199,393,,,1,0,0,,,,,,
675,200,417,674,200,417,,,1,0,0,,,,,,
675,201,441,675,201,441,,,0,0,0,,,,,,
675,203,466,675,202,466,,,0,1,0,,,,,,
676,204,490,676,204,490,,,0,0,0,,,,,,
676,205,515,676,205,515,,,0,0,0,,,,,,
676,207,540,676,207,540,,,0,0,0,,,,,,
677,208,565,676,208,564,,,1,0,1,,,,,,
677,210,590,677,210,589,,,0,0,1,,,,,,
678,211,615,677,211,614,,,1,0,1,,,,,,
678,213,640,678,213,639,,,0,0,1,,,,,,
679,215,665,678,215,665,,,1,0,0,,,,,,
679,217,690,679,216,690,,,0,1,0,,,,,,
680,219,715,679,218,715,,,1,1,0,,,,,,
680,221,741,680,220,740,,,0,1,1,,,,,,
681,223,766,680,222,766,,,1,1,0,,,,,,
673,199,103,673,200,103,,,0,-1,0,,,,,,
673,199,105,673,200,103,,,0,-1,2,,,,,,
673,199,111,673,200,111,,,0,-1,0,,,,,,
673,199,121,673,200,122,,,0,-1,-1,,,,,,
673,199,134,673,200,134,,,0,-1,0,,,,,,
673,199,151,673,201,151,,,0,-2,0,,,,,,
673,200,169,673,201,169,,,0,-1,0,,,,,,
674,200,188,673,201,189,,,1,-1,-1,,,,,,
674,201,209,673,202,209,,,1,-1,0,,,,,,
674,201,231,673,202,231,,,1,-1,0,,,,,,
674,202,253,674,203,253,,,0,-1,0,,,,,,
674,202,275,674,203,275,,,0,-1,0,,,,,,
674,203,298,674,204,298,,,0,-1,0,,,,,,
674,204,322,674,205,322,,,0,-1,0,,,,,,
675,204,345,674,206,345,,,1,-2,0,,,,,,
675,205,369,675,206,369,,,0,-1,0,,,,,,
675,206,393,675,207,393,,,0,-1,0,,,,,,
675,207,417,675,208,417,,,0,-1,0,,,,,,
676,209,442,675,209,441,,,1,0,1,,,,,,
676,210,466,676,211,466,,,0,-1,0,,,,,,
676,211,491,676,212,490,,,0,-1,1,,,,,,
677,212,515,676,214,515,,,1,-2,0,,,,,,
677,214,540,677,215,540,,,0,-1,0,,,,,,
677,215,565,677,216,565,,,0,-1,0,,,,,,
678,217,590,677,218,589,,,1,-1,1,,,,,,
678,218,615,678,220,614,,,0,-2,1,,,,,,
679,220,640,678,221,640,,,1,-1,0,,,,,,
679,222,665,679,223,665,,,0,-1,0,,,,,,
680,223,690,679,224,690,,,1,-1,0,,,,,,
680,225,715,680,226,715,,,0,-1,0,,,,,,
681,227,741,680,228,740,,,1,-1,1,,,,,,
681,229,766,681,230,766,,,0,-1,0,,,,,,
674,210,105,674,210,105,,,0,0,0,,,,,,
674,210,106,674,210,105,,,0,0,1,,,,,,
674,210,112,674,210,112,,,0,0,0,,,,,,
674,210,122,674,210,123,,,0,0,-1,,,,,,
674,210,135,674,210,135,,,0,0,0,,,,,,
674,210,152,674,210,152,,,0,0,0,,,,,,
674,211,170,674,210,169,,,0,1,1,,,,,,
674,211,189,674,211,189,,,0,0,0,,,,,,
674,211,210,674,211,210,,,0,0,0,,,,,,
675,212,231,674,212,231,,,1,0,0,,,,,,
675,212,253,675,212,253,,,0,0,0,,,,,,
675,213,276,675,213,276,,,0,0,0,,,,,,
675,213,299,675,213,299,,,0,0,0,,,,,,
675,214,322,675,214,322,,,0,0,0,,,,,,
675,215,346,675,215,346,,,0,0,0,,,,,,
676,216,369,675,215,369,,,1,1,0,,,,,,
676,217,393,676,216,393,,,0,1,0,,,,,,
676,218,418,676,217,417,,,0,1,1,,,,,,
676,219,442,676,218,442,,,0,1,0,,,,,,
677,220,466,676,220,466,,,1,0,0,,,,,,
677,221,491,677,221,491,,,0,0,0,,,,,,
677,222,516,677,222,515,,,0,0,1,,,,,,
678,224,540,678,223,540,,,0,1,0,,,,,,
678,225,565,678,225,565,,,0,0,0,,,,,,
679,227,590,678,226,590,,,1,1,0,,,,,,
679,228,615,679,228,615,,,0,0,0,,,,,,
679,230,640,679,230,640,,,0,0,0,,,,,,
680,231,665,680,231,665,,,0,0,0,,,,,,
680,233,690,680,233,690,,,0,0,0,,,,,,
681,235,716,681,234,715,,,0,1,1,,,,,,
681,237,741,681,236,740,,,0,1,1,,,,,,
682,238,766,682,238,766,,,0,0,0,,,,,,
675,223,107,675,225,107,,,0,-2,0,,,,,,
675,223,108,675,225,107,,,0,-2,1,,,,,,
675,224,114,675,225,114,,,0,-1,0,,,,,,
675,224,124,675,225,125,,,0,-1,-1,,,,,,
675,224,137,675,225,137,,,0,-1,0,,,,,,
675,224,153,675,225,154,,,0,-1,-1,,,,,,
675,224,171,675,225,171,,,0,-1,0,,,,,,
675,225,190,675,225,191,,,0,0,-1,,,,,,
676,225,211,675,226,211,,,1,-1,0,,,,,,
676,225,232,675,226,232,,,1,-1,0,,,,,,
676,226,254,676,227,254,,,0,-1,0,,,,,,
676,226,276,676,227,276,,,0,-1,0,,,,,,
676,227,299,676,228,299,,,0,-1,0,,,,,,
676,228,323,676,229,323,,,0,-1,0,,,,,,
677,228,346,676,229,346,,,1,-1,0,,,,,,
677,229,370,677,230,370,,,0,-1,0,,,,,,
677,230,394,677,231,394,,,0,-1,0,,,,,,
677,231,418,677,232,418,,,0,-1,0,,,,,,
678,232,442,677,233,442,,,1,-1,0,,,,,,
678,233,467,678,234,466,,,0,-1,1,,,,,,
678,234,491,678,235,491,,,0,-1,0,,,,,,
679,235,516,678,236,516,,,1,-1,0,,,,,,
679,237,541,679,237,540,,,0,0,1,,,,,,
679,238,565,679,239,565,,,0,-1,0,,,,,,
680,239,590,680,240,590,,,0,-1,0,,,,,,
680,241,615,680,242,615,,,0,-1,0,,,,,,
681,242,640,680,243,640,,,1,-1,0,,,,,,
681,244,665,681,245,665,,,0,-1,0,,,,,,
681,245,691,681,246,690,,,0,-1,1,,,,,,
682,247,716,682,248,715,,,0,-1,1,,,,,,
683,249,741,682,249,741,,,1,0,0,,,,,,
683,250,766,683,251,766,,,0,-1,0,,,,,,
677,240,109,676,240,109,,,1,0,0,,,,,,
677,240,111,676,240,109,,,1,0,2,,,,,,
677,240,116,676,240,116,,,1,0,0,,,,,,
677,240,126,676,240,127,,,1,0,-1,,,,,,
677,240,139,677,240,139,,,0,0,0,,,,,,
677,240,154,677,240,155,,,0,0,-1,,,,,,
677,240,172,677,240,172,,,0,0,0,,,,,,
677,241,191,677,240,192,,,0,1,-1,,,,,,
677,241,212,677,241,212,,,0,0,0,,,,,,
677,241,233,677,241,233,,,0,0,0,,,,,,
677,242,255,677,242,254,,,0,0,1,,,,,,
677,242,277,677,242,277,,,0,0,0,,,,,,
678,243,300,677,243,300,,,1,0,0,,,,,,
678,244,323,677,243,323,,,1,1,0,,,,,,
678,244,347,678,244,347,,,0,0,0,,,,,,
678,245,371,678,245,370,,,0,0,1,,,,,,
678,246,394,678,246,394,,,0,0,0,,,,,,
679,247,419,678,246,418,,,1,1,1,,,,,,
679,248,443,679,247,443,,,0,1,0,,,,,,
679,249,467,679,248,467,,,0,1,0,,,,,,
680,250,492,679,249,491,,,1,1,1,,,,,,
680,251,516,680,250,516,,,0,1,0,,,,,,
680,252,541,680,251,541,,,0,1,0,,,,,,
681,253,566,681,253,565,,,0,0,1,,,,,,
681,254,591,681,254,590,,,0,0,1,,,,,,
682,256,616,681,256,615,,,1,0,1,,,,,,
682,257,641,682,257,640,,,0,0,1,,,,,,
682,259,666,682,258,665,,,0,1,1,,,,,,
683,260,691,682,260,690,,,1,0,1,,,,,,
683,262,716,683,261,716,,,0,1,0,,,,,,
684,263,741,683,263,741,,,1,0,0,,,,,,
684,265,767,684,264,766,,,0,1,1,,,,,,
678,258,112,678,259,112,,,0,-1,0,,,,,,
678,258,113,678,259,112,,,0,-1,1,,,,,,
678,258,119,678,259,118,,,0,-1,1,,,,,,
678,258,128,678,259,129,,,0,-1,-1,,,,,,
678,258,141,678,259,141,,,0,-1,0,,,,,,
678,258,156,678,259,157,,,0,-1,-1,,,,,,
679,259,174,678,259,174,,,1,0,0,,,,,,
679,259,193,678,259,193,,,1,0,0,,,,,,
679,259,213,678,260,213,,,1,-1,0,,,,,,
679,260,234,678,260,234,,,1,0,0,,,,,,
679,260,256,679,261,256,,,0,-1,0,,,,,,
679,261,278,679,261,278,,,0,0,0,,,,,,
679,261,301,679,262,301,,,0,-1,0,,,,,,
679,262,324,679,262,324,,,0,0,0,,,,,,
680,262,348,679,263,347,,,1,-1,1,,,,,,
680,263,371,680,264,371,,,0,-1,0,,,,,,
680,264,395,680,264,395,,,0,0,0,,,,,,
680,264,419,680,265,419,,,0,-1,0,,,,,,
681,265,443,680,266,443,,,1,-1,0,,,,,,
681,266,468,681,267,467,,,0,-1,1,,,,,,
681,267,492,681,268,492,,,0,-1,0,,,,,,
682,268,517,682,269,516,,,0,-1,1,,,,,,
682,269,541,682,270,541,,,0,-1,0,,,,,,
682,270,566,682,271,566,,,0,-1,0,,,,,,
683,272,591,683,272,591,,,0,0,0,,,,,,
683,273,616,683,273,616,,,0,0,0,,,,,,
684,274,641,683,275,641,,,1,-1,0,,,,,,
684,275,666,684,276,666,,,0,-1,0,,,,,,
685,277,691,684,277,691,,,1,0,0,,,,,,
685,278,716,685,279,716,,,0,-1,0,,,,,,
686,280,742,685,280,742,,,1,0,0,,,,,,
686,281,767,686,282,767,,,0,-1,0,,,,,,
680,278,115,680,278,115,,,0,0,0,,,,,,
680,278,116,680,278,115,,,0,0,1,,,,,,
680,278,122,680,278,121,,,0,0,1,,,,,,
680,278,131,680,278,132,,,0,0,-1,,,,,,
680,278,143,680,278,143,,,0,0,0,,,,,,
681,279,158,680,278,159,,,1,1,-1,,,,,,
681,279,176,680,279,176,,,1,0,0,,,,,,
681,279,195,680,279,195,,,1,0,0,,,,,,
681,279,215,680,279,215,,,1,0,0,,,,,,
681,280,236,680,279,236,,,1,1,0,,,,,,
681,280,257,681,280,257,,,0,0,0,,,,,,
681,280,279,681,280,279,,,0,0,0,,,,,,
681,281,302,681,281,302,,,0,0,0,,,,,,
682,281,325,681,281,325,,,1,0,0,,,,,,
682,282,349,681,282,348,,,1,0,1,,,,,,
682,283,372,682,282,372,,,0,1,0,,,,,,
682,283,396,682,283,396,,,0,0,0,,,,,,
682,284,420,682,284,420,,,0,0,0,,,,,,
683,285,444,682,285,444,,,1,0,0,,,,,,
683,286,468,683,285,468,,,0,1,0,,,,,,
683,287,493,683,286,493,,,0,1,0,,,,,,
684,288,517,684,287,517,,,0,1,0,,,,,,
684,288,542,684,288,542,,,0,0,0,,,,,,
684,290,567,684,289,566,,,0,1,1,,,,,,
685,291,592,684,290,591,,,1,1,1,,,,,,
685,292,616,685,291,616,,,0,1,0,,,,,,
686,293,641,685,293,641,,,1,0,0,,,,,,
686,294,667,686,294,666,,,0,0,1,,,,,,
687,296,692,686,295,691,,,1,1,1,,,,,,
687,297,717,687,297,717,,,0,0,0,,,,,,
688,298,742,687,298,742,,,1,0,0,,,,,,
688,300,767,688,300,767,,,0,0,0,,,,,,
683,300,119,683,300,118,,,0,0,1,,,,,,
683,300,120,683,300,118,,,0,0,2,,,,,,
683,300,125,683,300,125,,,0,0,0,,,,,,
683,300,134,683,300,135,,,0,0,-1,,,,,,
683,300,146,683,300,146,,,0,0,0,,,,,,
683,300,161,683,300,162,,,0,0,-1,,,,,,
683,300,178,683,301,178,,,0,-1,0,,,,,,
683,300,197,683,301,197,,,0,-1,0,,,,,,
683,301,216,683,301,216,,,0,0,0,,,,,,
683,301,237,683,301,237,,,0,0,0,,,,,,
683,301,259,683,302,259,,,0,-1,0,,,,,,
684,302,281,683,302,281,,,1,0,0,,,,,,
684,302,303,684,302,303,,,0,0,0,,,,,,
684,303,326,684,303,326,,,0,0,0,,,,,,
684,303,350,684,303,349,,,0,0,1,,,,,,
684,304,373,684,304,373,,,0,0,0,,,,,,
685,304,397,685,305,397,,,0,-1,0,,,,,,
685,305,421,685,305,421,,,0,0,0,,,,,,
685,306,445,685,306,445,,,0,0,0,,,,,,
685,307,469,685,307,469,,,0,0,0,,,,,,
686,307,494,686,308,493,,,0,-1,1,,,,,,
686,308,518,686,308,518,,,0,0,0,,,,,,
686,309,543,686,309,542,,,0,0,1,,,,,,
687,310,567,687,310,567,,,0,0,0,,,,,,
687,311,592,687,311,592,,,0,0,0,,,,,,
688,312,617,687,312,617,,,1,0,0,,,,,,
688,313,642,688,314,642,,,0,-1,0,,,,,,
689,314,667,688,315,667,,,1,-1,0,,,,,,
689,316,692,689,316,692,,,0,0,0,,,,,,
690,317,717,689,317,717,,,1,0,0,,,,,,
690,318,743,690,319,743,,,0,-1,0,,,,,,
691,320,768,690,320,768,,,1,0,0,,,,,,
686,322,123,685,322,122,,,1,0,1,,,,,,
686,322,124,685,322,122,,,1,0,2,,,,,,
686,322,129,685,322,129,,,1,0,0,,,,,,
686,322,137,685,322,139,,,1,0,-2,,,,,,
686,322,149,685,322,149,,,1,0,0,,,,,,
686,323,164,685,322,165,,,1,1,-1,,,,,,
686,323,181,685,323,180,,,1,0,1,,,,,,
686,323,199,685,323,199,,,1,0,0,,,,,,
686,323,219,686,323,218,,,0,0,1,,,,,,
686,323,239,686,323,239,,,0,0,0,,,,,,
686,324,260,686,324,260,,,0,0,0,,,,,,
686,324,282,686,324,282,,,0,0,0,,,,,,
686,325,305,686,324,305,,,0,1,0,,,,,,
687,325,328,686,325,328,,,1,0,0,,,,,,
687,326,351,687,325,351,,,0,1,0,,,,,,
687,326,374,687,326,374,,,0,0,0,,,,,,
687,327,398,687,327,398,,,0,0,0,,,,,,
688,327,422,687,327,422,,,1,0,0,,,,,,
688,328,446,688,328,446,,,0,0,0,,,,,,
688,329,470,688,328,470,,,0,1,0,,,,,,
688,329,494,688,329,494,,,0,0,0,,,,,,
689,330,519,688,330,519,,,1,0,0,,,,,,
689,331,543,689,331,543,,,0,0,0,,,,,,
690,332,568,689,332,568,,,1,0,0,,,,,,
690,333,593,690,333,592,,,0,0,1,,,,,,
690,334,618,690,334,617,,,0,0,1,,,,,,
691,335,643,691,335,642,,,0,0,1,,,,,,
691,336,668,691,336,667,,,0,0,1,,,,,,
692,337,693,692,337,692,,,0,0,1,,,,,,
692,338,718,692,338,718,,,0,0,0,,,,,,
693,339,743,693,340,743,,,0,-1,0,,,,,,
693,341,768,693,341,768,,,0,0,0,,,,,,
689,346,127,688,346,127,,,1,0,0,,,,,,
689,346,128,688,346,127,,,1,0,1,,,,,,
689,346,133,688,346,133,,,1,0,0,,,,,,
689,346,141,688,346,143,,,1,0,-2,,,,,,
689,346,153,688,346,153,,,1,0,0,,,,,,
689,346,167,688,346,168,,,1,0,-1,,,,,,
689,346,183,688,346,183,,,1,0,0,,,,,,
689,346,202,689,346,202,,,0,0,0,,,,,,
689,347,221,689,347,221,,,0,0,0,,,,,,
689,347,241,689,347,241,,,0,0,0,,,,,,
689,347,262,689,347,262,,,0,0,0,,,,,,
689,348,284,689,348,284,,,0,0,0,,,,,,
690,348,306,689,348,306,,,1,0,0,,,,,,
690,348,329,689,348,329,,,1,0,0,,,,,,
690,349,352,690,349,352,,,0,0,0,,,,,,
690,349,375,690,349,375,,,0,0,0,,,,,,
690,350,399,690,350,399,,,0,0,0,,,,,,
691,350,423,690,351,423,,,1,-1,0,,,,,,
691,351,447,691,351,447,,,0,0,0,,,,,,
691,352,471,691,352,471,,,0,0,0,,,,,,
692,352,495,691,353,495,,,1,-1,0,,,,,,
692,353,520,692,353,520,,,0,0,0,,,,,,
692,354,544,692,354,544,,,0,0,0,,,,,,
693,355,569,692,355,569,,,1,0,0,,,,,,
693,356,594,693,356,593,,,0,0,1,,,,,,
693,357,618,693,357,618,,,0,0,0,,,,,,
694,358,643,694,358,643,,,0,0,0,,,,,,
694,359,668,694,359,668,,,0,0,0,,,,,,
695,360,693,695,360,693,,,0,0,0,,,,,,
695,361,718,695,361,718,,,0,0,0,,,,,,
696,362,744,696,362,744,,,0,0,0,,,,,,
696,363,769,696,363,769,,,0,0,0,,,,,,
692,370,132,692,370,131,,,0,0,1,,,,,,
692,370,133,692,370,131,,,0,0,2,,,,,,
692,370,137,692,370,137,,,0,0,0,,,,,,
692,370,145,692,370,146,,,0,0,-1,,,,,,
692,370,157,692,370,156,,,0,0,1,,,,,,
692,370,171,692,370,171,,,0,0,0,,,,,,
692,371,187,692,370,186,,,0,1,1,,,,,,
692,371,204,692,370,205,,,0,1,-1,,,,,,
692,371,223,692,371,223,,,0,0,0,,,,,,
692,371,244,692,371,244,,,0,0,0,,,,,,
693,371,264,693,371,264,,,0,0,0,,,,,,
693,372,286,693,372,286,,,0,0,0,,,,,,
693,372,308,693,372,308,,,0,0,0,,,,,,
693,372,331,693,372,331,,,0,0,0,,,,,,
693,373,354,693,373,354,,,0,0,0,,,,,,
694,373,377,693,373,377,,,1,0,0,,,,,,
694,374,400,694,374,400,,,0,0,0,,,,,,
694,374,424,694,374,424,,,0,0,0,,,,,,
694,375,448,694,375,448,,,0,0,0,,,,,,
695,376,472,694,376,472,,,1,0,0,,,,,,
695,376,496,695,376,496,,,0,0,0,,,,,,
695,377,521,695,377,521,,,0,0,0,,,,,,
696,378,545,696,377,545,,,0,1,0,,,,,,
696,378,570,696,378,570,,,0,0,0,,,,,,
696,379,594,696,379,594,,,0,0,0,,,,,,
697,380,619,696,380,619,,,1,0,0,,,,,,
697,381,644,697,381,644,,,0,0,0,,,,,,
698,382,669,697,382,669,,,1,0,0,,,,,,
698,383,694,698,383,694,,,0,0,0,,,,,,
699,384,719,698,384,719,,,1,0,0,,,,,,
699,385,744,699,385,744,,,0,0,0,,,,,,
700,386,770,699,386,769,,,1,0,1,,,,,,
696,395,137,696,395,136,,,0,0,1,,,,,,
696,395,138,696,395,136,,,0,0,2,,,,,,
696,395,142,696,395,142,,,0,0,0,,,,,,
696,395,150,696,395,151,,,0,0,-1,,,,,,
696,395,161,696,395,161,,,0,0,0,,,,,,
696,395,174,696,395,175,,,0,0,-1,,,,,,
696,395,190,696,395,190,,,0,0,0,,,,,,
696,396,207,696,395,208,,,0,1,-1,,,,,,
696,396,226,696,396,226,,,0,0,0,,,,,,
696,396,246,696,396,246,,,0,0,0,,,,,,
696,396,267,696,396,267,,,0,0,0,,,,,,
696,397,288,696,397,288,,,0,0,0,,,,,,
697,397,310,697,397,310,,,0,0,0,,,,,,
697,397,333,697,397,332,,,0,0,1,,,,,,
697,398,355,697,398,355,,,0,0,0,,,,,,
697,398,378,697,398,378,,,0,0,0,,,,,,
697,399,402,697,399,401,,,0,0,1,,,,,,
698,399,425,697,399,425,,,1,0,0,,,,,,
698,400,449,698,400,449,,,0,0,0,,,,,,
698,400,473,698,400,473,,,0,0,0,,,,,,
699,401,497,698,401,497,,,1,0,0,,,,,,
699,401,522,699,401,522,,,0,0,0,,,,,,
699,402,546,699,402,546,,,0,0,0,,,,,,
700,403,571,700,403,571,,,0,0,0,,,,,,
700,404,595,700,404,595,,,0,0,0,,,,,,
700,404,620,700,405,620,,,0,-1,0,,,,,,
701,405,645,701,405,645,,,0,0,0,,,,,,
701,406,670,701,406,670,,,0,0,0,,,,,,
702,407,695,701,407,695,,,1,0,0,,,,,,
702,408,720,702,408,720,,,0,0,0,,,,,,
703,409,745,702,409,745,,,1,0,0,,,,,,
703,410,770,703,410,770,,,0,0,0,,,,,,
700,421,142,700,421,142,,,0,0,0,,,,,,
700,421,143,700,421,142,,,0,0,1,,,,,,
700,421,147,700,421,147,,,0,0,0,,,,,,
700,421,155,700,421,156,,,0,0,-1,,,,,,
700,421,165,700,421,165,,,0,0,0,,,,,,
700,421,178,700,421,179,,,0,0,-1,,,,,,
700,421,194,700,421,194,,,0,0,0,,,,,,
700,421,211,700,421,211,,,0,0,0,,,,,,
700,421,229,700,421,229,,,0,0,0,,,,,,
700,421,249,700,421,249,,,0,0,0,,,,,,
700,422,269,700,422,269,,,0,0,0,,,,,,
701,422,290,700,422,290,,,1,0,0,,,,,,
701,422,312,701,422,312,,,0,0,0,,,,,,
701,423,335,701,422,334,,,0,1,1,,,,,,
701,423,357,701,423,357,,,0,0,0,,,,,,
701,423,380,701,423,380,,,0,0,0,,,,,,
702,424,403,701,424,403,,,1,0,0,,,,,,
702,424,427,701,424,427,,,1,0,0,,,,,,
702,425,451,702,425,451,,,0,0,0,,,,,,
702,425,475,702,425,474,,,0,0,1,,,,,,
703,426,499,702,426,498,,,1,0,1,,,,,,
703,427,523,703,426,523,,,0,1,0,,,,,,
703,427,547,703,427,547,,,0,0,0,,,,,,
704,428,572,704,428,572,,,0,0,0,,,,,,
704,429,596,704,429,596,,,0,0,0,,,,,,
705,429,621,704,429,621,,,1,0,0,,,,,,
705,430,646,705,430,645,,,0,0,1,,,,,,
705,431,671,705,431,670,,,0,0,1,,,,,,
706,432,696,705,432,695,,,1,0,1,,,,,,
706,433,721,706,433,720,,,0,0,1,,,,,,
707,434,746,706,434,745,,,1,0,1,,,,,,
707,435,771,707,435,771,,,0,0,0,,,,,,
704,447,147,704,447,147,,,0,0,0,,,,,,
704,447,148,704,447,147,,,0,0,1,,,,,,
704,447,152,704,447,152,,,0,0,0,,,,,,
704,447,159,704,447,161,,,0,0,-2,,,,,,
704,447,170,704,447,170,,,0,0,0,,,,,,
704,447,182,704,447,184,,,0,0,-2,,,,,,
704,447,197,704,447,198,,,0,0,-1,,,,,,
704,447,214,704,447,215,,,0,0,-1,,,,,,
705,447,232,704,447,232,,,1,0,0,,,,,,
705,447,252,704,447,252,,,1,0,0,,,,,,
705,448,272,705,448,272,,,0,0,0,,,,,,
705,448,293,705,448,293,,,0,0,0,,,,,,
705,448,315,705,448,314,,,0,0,1,,,,,,
705,448,337,705,448,336,,,0,0,1,,,,,,
705,449,359,705,449,359,,,0,0,0,,,,,,
706,449,382,705,449,382,,,1,0,0,,,,,,
706,450,405,706,450,405,,,0,0,0,,,,,,
706,450,429,706,450,428,,,0,0,1,,,,,,
706,451,452,706,450,452,,,0,1,0,,,,,,
707,451,476,707,451,476,,,0,0,0,,,,,,
707,452,500,707,451,500,,,0,1,0,,,,,,
707,452,524,707,452,524,,,0,0,0,,,,,,
708,453,549,708,452,548,,,0,1,1,,,,,,
708,453,573,708,453,573,,,0,0,0,,,,,,
708,454,598,709,454,597,,,-1,0,1,,,,,,
709,455,622,709,455,622,,,0,0,0,,,,,,
709,455,647,709,455,647,,,0,0,0,,,,,,
710,456,672,709,456,671,,,1,0,1,,,,,,
710,457,697,710,457,696,,,0,0,1,,,,,,
711,458,722,710,458,721,,,1,0,1,,,,,,
711,459,747,711,459,746,,,0,0,1,,,,,,
712,460,772,711,460,771,,,1,0,1,,,,,,
709,473,153,709,473,153,,,0,0,0,,,,,,
709,473,154,709,473,153,,,0,0,1,,,,,,
709,473,158,709,473,157,,,0,0,1,,,,,,
709,473,165,709,473,166,,,0,0,-1,,,,,,
709,473,175,709,473,174,,,0,0,1,,,,,,
709,473,187,709,473,188,,,0,0,-1,,,,,,
709,473,202,709,473,202,,,0,0,0,,,,,,
709,473,218,709,473,219,,,0,0,-1,,,,,,
709,474,236,709,473,236,,,0,1,0,,,,,,
709,474,255,709,473,255,,,0,1,0,,,,,,
710,474,275,709,474,274,,,1,0,1,,,,,,
710,474,296,709,474,295,,,1,0,1,,,,,,
710,474,317,710,474,317,,,0,0,0,,,,,,
710,475,339,710,474,339,,,0,1,0,,,,,,
710,475,361,710,475,361,,,0,0,0,,,,,,
710,475,384,710,475,384,,,0,0,0,,,,,,
711,476,407,710,476,407,,,1,0,0,,,,,,
711,476,430,711,476,430,,,0,0,0,,,,,,
711,477,454,711,476,454,,,0,1,0,,,,,,
711,477,478,711,477,477,,,0,0,1,,,,,,
712,478,502,712,477,501,,,0,1,1,,,,,,
712,478,526,712,478,525,,,0,0,1,,,,,,
712,479,550,712,478,550,,,0,1,0,,,,,,
713,479,574,713,479,574,,,0,0,0,,,,,,
713,480,599,713,480,598,,,0,0,1,,,,,,
714,481,623,713,480,623,,,1,1,0,,,,,,
714,481,648,714,481,648,,,0,0,0,,,,,,
714,482,673,714,482,673,,,0,0,0,,,,,,
715,483,698,715,482,697,,,0,1,1,,,,,,
715,484,723,715,483,722,,,0,1,1,,,,,,
716,484,748,716,484,747,,,0,0,1,,,,,,
716,485,773,716,485,772,,,0,0,1,,,,,,
714,500,159,714,499,158,,,0,1,1,,,,,,
714,500,160,714,499,158,,,0,1,2,,,,,,
714,500,163,714,499,163,,,0,1,0,,,,,,
714,500,170,714,499,171,,,0,1,-1,,,,,,
714,500,180,714,499,179,,,0,1,1,,,,,,
714,500,192,714,499,193,,,0,1,-1,,,,,,
714,500,206,714,500,206,,,0,0,0,,,,,,
714,500,222,714,500,223,,,0,0,-1,,,,,,
714,500,239,714,500,239,,,0,0,0,,,,,,
714,500,258,714,500,258,,,0,0,0,,,,,,
715,501,278,714,500,278,,,1,1,0,,,,,,
715,501,298,714,501,298,,,1,0,0,,,,,,
715,501,320,715,501,319,,,0,0,1,,,,,,
715,501,341,715,501,341,,,0,0,0,,,,,,
715,502,364,715,501,363,,,0,1,1,,,,,,
715,502,386,715,502,386,,,0,0,0,,,,,,
716,502,409,715,502,409,,,1,0,0,,,,,,
716,503,432,716,503,432,,,0,0,0,,,,,,
716,503,456,716,503,455,,,0,0,1,,,,,,
717,504,479,716,503,479,,,1,1,0,,,,,,
717,504,503,717,504,503,,,0,0,0,,,,,,
717,505,527,717,504,527,,,0,1,0,,,,,,
717,505,551,717,505,551,,,0,0,0,,,,,,
718,506,576,718,505,575,,,0,1,1,,,,,,
718,506,600,718,506,600,,,0,0,0,,,,,,
719,507,625,718,507,624,,,1,0,1,,,,,,
719,507,649,719,507,649,,,0,0,0,,,,,,
719,508,674,719,508,674,,,0,0,0,,,,,,
720,509,699,720,509,698,,,0,0,1,,,,,,
720,510,724,720,509,723,,,0,1,1,,,,,,
721,510,749,721,510,748,,,0,0,1,,,,,,
721,511,774,721,511,773,,,0,0,1,,,,,,
719,527,165,719,526,164,,,0,1,1,,,,,,
719,527,166,719,526,164,,,0,1,2,,,,,,
719,527,169,719,526,169,,,0,1,0,,,,,,
719,527,176,719,526,177,,,0,1,-1,,,,,,
719,527,185,720,526,185,,,-1,1,0,,,,,,
720,527,197,720,526,197,,,0,1,0,,,,,,
720,527,210,720,526,210,,,0,1,0,,,,,,
720,527,226,720,527,227,,,0,0,-1,,,,,,
720,527,243,720,527,243,,,0,0,0,,,,,,
720,527,262,720,527,262,,,0,0,0,,,,,,
720,527,281,720,527,281,,,0,0,0,,,,,,
720,528,301,720,527,302,,,0,1,-1,,,,,,
720,528,322,720,528,322,,,0,0,0,,,,,,
720,528,344,720,528,344,,,0,0,0,,,,,,
721,528,366,721,528,366,,,0,0,0,,,,,,
721,529,388,721,529,388,,,0,0,0,,,,,,
721,529,411,721,529,411,,,0,0,0,,,,,,
721,529,434,721,529,434,,,0,0,0,,,,,,
722,530,458,722,530,457,,,0,0,1,,,,,,
722,530,481,722,530,481,,,0,0,0,,,,,,
722,531,505,722,530,505,,,0,1,0,,,,,,
723,531,529,722,531,528,,,1,0,1,,,,,,
723,532,553,723,531,552,,,0,1,1,,,,,,
723,532,577,723,532,577,,,0,0,0,,,,,,
724,533,601,723,532,601,,,1,1,0,,,,,,
724,533,626,724,533,626,,,0,0,0,,,,,,
724,534,650,724,534,650,,,0,0,0,,,,,,
725,535,675,725,534,675,,,0,1,0,,,,,,
725,535,700,725,535,699,,,0,0,1,,,,,,
726,536,725,726,536,724,,,0,0,1,,,,,,
726,537,750,726,536,749,,,0,1,1,,,,,,
727,537,775,727,537,774,,,0,0,1,,,,,,
725,554,171,725,553,170,,,0,1,1,,,,,,
725,554,172,725,553,170,,,0,1,2,,,,,,
725,554,175,725,554,175,,,0,0,0,,,,,,
725,554,181,725,554,183,,,0,0,-2,,,,,,
725,554,190,725,554,190,,,0,0,0,,,,,,
725,554,202,725,554,202,,,0,0,0,,,,,,
725,554,215,725,554,215,,,0,0,0,,,,,,
725,554,230,725,554,231,,,0,0,-1,,,,,,
725,554,247,725,554,247,,,0,0,0,,,,,,
726,554,265,725,554,266,,,1,0,-1,,,,,,
726,555,285,725,554,285,,,1,1,0,,,,,,
726,555,305,726,555,305,,,0,0,0,,,,,,
726,555,325,726,555,325,,,0,0,0,,,,,,
726,555,347,726,555,347,,,0,0,0,,,,,,
726,556,369,726,555,368,,,0,1,1,,,,,,
727,556,391,726,556,391,,,1,0,0,,,,,,
727,556,413,727,556,413,,,0,0,0,,,,,,
727,557,436,727,556,436,,,0,1,0,,,,,,
727,557,460,727,557,459,,,0,0,1,,,,,,
728,557,483,727,557,483,,,1,0,0,,,,,,
728,558,507,728,557,506,,,0,1,1,,,,,,
728,558,530,728,558,530,,,0,0,0,,,,,,
729,559,554,728,558,554,,,1,1,0,,,,,,
729,559,579,729,559,578,,,0,0,1,,,,,,
729,560,603,729,559,603,,,0,1,0,,,,,,
730,560,627,730,560,627,,,0,0,0,,,,,,
730,561,652,730,561,652,,,0,0,0,,,,,,
730,561,676,730,561,676,,,0,0,0,,,,,,
731,562,701,731,562,701,,,0,0,0,,,,,,
731,563,726,731,562,726,,,0,1,0,,,,,,
732,563,751,732,563,751,,,0,0,0,,,,,,
732,564,776,732,564,775,,,0,0,1,,,,,,
731,581,177,731,581,177,,,0,0,0,,,,,,
731,581,178,731,581,177,,,0,0,1,,,,,,
731,581,181,731,581,181,,,0,0,0,,,,,,
731,581,187,731,581,188,,,0,0,-1,,,,,,
731,581,196,731,581,196,,,0,0,0,,,,,,
731,581,207,731,581,208,,,0,0,-1,,,,,,
731,582,220,731,581,220,,,0,1,0,,,,,,
731,582,235,731,581,235,,,0,1,0,,,,,,
732,582,252,731,582,251,,,1,0,1,,,,,,
732,582,269,731,582,270,,,1,0,-1,,,,,,
732,582,288,731,582,288,,,1,0,0,,,,,,
732,582,308,732,582,308,,,0,0,0,,,,,,
732,582,328,732,582,328,,,0,0,0,,,,,,
732,583,350,732,582,349,,,0,1,1,,,,,,
732,583,371,732,583,371,,,0,0,0,,,,,,
733,583,393,732,583,393,,,1,0,0,,,,,,
733,584,416,733,583,416,,,0,1,0,,,,,,
733,584,439,733,583,438,,,0,1,1,,,,,,
733,584,462,733,584,461,,,0,0,1,,,,,,
734,585,485,733,584,485,,,1,1,0,,,,,,
734,585,509,734,585,508,,,0,0,1,,,,,,
734,585,532,734,585,532,,,0,0,0,,,,,,
735,586,556,734,586,556,,,1,0,0,,,,,,
735,586,580,735,586,580,,,0,0,0,,,,,,
735,587,604,735,587,604,,,0,0,0,,,,,,
736,587,629,736,587,629,,,0,0,0,,,,,,
736,588,653,736,588,653,,,0,0,0,,,,,,
736,589,678,736,588,678,,,0,1,0,,,,,,
737,589,703,737,589,702,,,0,0,1,,,,,,
737,590,727,737,589,727,,,0,1,0,,,,,,
738,590,752,738,590,752,,,0,0,0,,,,,,
738,591,777,738,591,777,,,0,0,0,,,,,,
737,609,183,737,609,183,,,0,0,0,,,,,,
737,609,184,737,609,183,,,0,0,1,,,,,,
738,609,188,737,609,187,,,1,0,1,,,,,,
738,609,193,737,609,194,,,1,0,-1,,,,,,
738,609,202,737,609,201,,,1,0,1,,,,,,
738,609,212,737,609,213,,,1,0,-1,,,,,,
738,609,225,737,609,225,,,1,0,0,,,,,,
738,609,240,738,609,240,,,0,0,0,,,,,,
738,609,256,738,609,256,,,0,0,0,,,,,,
738,610,273,738,609,274,,,0,1,-1,,,,,,
738,610,292,738,610,292,,,0,0,0,,,,,,
738,610,312,738,610,312,,,0,0,0,,,,,,
738,610,332,738,610,331,,,0,0,1,,,,,,
739,610,353,738,610,352,,,1,0,1,,,,,,
739,611,374,739,610,374,,,0,1,0,,,,,,
739,611,396,739,610,396,,,0,1,0,,,,,,
739,611,418,739,611,418,,,0,0,0,,,,,,
739,611,441,739,611,441,,,0,0,0,,,,,,
740,612,464,740,611,464,,,0,1,0,,,,,,
740,612,487,740,612,487,,,0,0,0,,,,,,
740,612,511,740,612,510,,,0,0,1,,,,,,
741,613,534,740,613,534,,,1,0,0,,,,,,
741,613,558,741,613,558,,,0,0,0,,,,,,
741,614,582,741,614,582,,,0,0,0,,,,,,
742,614,606,741,614,606,,,1,0,0,,,,,,
742,615,630,742,615,630,,,0,0,0,,,,,,
742,615,655,742,615,655,,,0,0,0,,,,,,
743,616,679,743,616,679,,,0,0,0,,,,,,
743,616,704,743,616,704,,,0,0,0,,,,,,
744,617,729,744,617,728,,,0,0,1,,,,,,
744,618,753,744,617,753,,,0,1,0,,,,,,
745,618,778,745,618,778,,,0,0,0,,,,,,
744,637,190,744,637,190,,,0,0,0,,,,,,
744,637,191,744,637,190,,,0,0,1,,,,,,
744,637,194,744,637,194,,,0,0,0,,,,,,
744,637,199,744,637,200,,,0,0,-1,,,,,,
744,637,208,744,637,207,,,0,0,1,,,,,,
744,637,218,744,637,219,,,0,0,-1,,,,,,
744,637,230,744,637,230,,,0,0,0,,,,,,
744,637,245,744,637,245,,,0,0,0,,,,,,
745,637,260,745,637,260,,,0,0,0,,,,,,
745,637,278,745,637,278,,,0,0,0,,,,,,
745,637,296,745,638,296,,,0,-1,0,,,,,,
745,638,315,745,638,315,,,0,0,0,,,,,,
745,638,335,745,638,335,,,0,0,0,,,,,,
745,638,356,745,638,356,,,0,0,0,,,,,,
745,638,377,745,638,377,,,0,0,0,,,,,,
746,639,399,745,638,399,,,1,1,0,,,,,,
746,639,421,746,639,421,,,0,0,0,,,,,,
746,639,443,746,639,443,,,0,0,0,,,,,,
746,639,466,746,639,466,,,0,0,0,,,,,,
747,640,489,746,639,489,,,1,1,0,,,,,,
747,640,513,747,640,512,,,0,0,1,,,,,,
747,641,536,747,640,536,,,0,1,0,,,,,,
747,641,560,748,641,560,,,-1,0,0,,,,,,
748,641,584,748,641,584,,,0,0,0,,,,,,
748,642,608,748,642,608,,,0,0,0,,,,,,
749,642,632,748,642,632,,,1,0,0,,,,,,
749,643,656,749,643,656,,,0,0,0,,,,,,
749,643,681,749,643,681,,,0,0,0,,,,,,
750,644,705,750,644,705,,,0,0,0,,,,,,
750,644,730,750,644,730,,,0,0,0,,,,,,
751,645,755,751,645,754,,,0,0,1,,,,,,
751,646,780,751,645,779,,,0,1,1,,,,,,
751,665,197,751,665,196,,,0,0,1,,,,,,
751,665,197,751,665,196,,,0,0,1,,,,,,
751,665,200,751,665,200,,,0,0,0,,,,,,
751,665,206,751,665,207,,,0,0,-1,,,,,,
751,665,214,751,665,213,,,0,0,1,,,,,,
751,665,224,751,665,224,,,0,0,0,,,,,,
751,665,236,751,665,236,,,0,0,0,,,,,,
751,665,250,751,665,250,,,0,0,0,,,,,,
751,665,265,751,665,265,,,0,0,0,,,,,,
752,665,282,752,665,282,,,0,0,0,,,,,,
752,665,300,752,665,300,,,0,0,0,,,,,,
752,666,319,752,665,319,,,0,1,0,,,,,,
752,666,339,752,666,338,,,0,0,1,,,,,,
752,666,359,752,666,359,,,0,0,0,,,,,,
752,666,380,752,666,380,,,0,0,0,,,,,,
753,666,402,752,666,402,,,1,0,0,,,,,,
753,667,424,753,667,424,,,0,0,0,,,,,,
753,667,446,753,667,446,,,0,0,0,,,,,,
753,667,469,753,667,469,,,0,0,0,,,,,,
754,668,492,753,667,492,,,1,1,0,,,,,,
754,668,515,754,668,515,,,0,0,0,,,,,,
754,668,538,754,668,538,,,0,0,0,,,,,,
754,669,562,754,669,562,,,0,0,0,,,,,,
755,669,586,755,669,585,,,0,0,1,,,,,,
755,670,610,755,669,609,,,0,1,1,,,,,,
755,670,634,755,670,633,,,0,0,1,,,,,,
756,671,658,756,670,658,,,0,1,0,,,,,,
756,671,683,756,671,682,,,0,0,1,,,,,,
757,672,707,757,671,707,,,0,1,0,,,,,,
757,672,732,757,672,731,,,0,0,1,,,,,,
758,673,756,758,672,756,,,0,1,0,,,,,,
758,673,781,758,673,781,,,0,0,0,,,,,,
758,693,203,758,693,203,,,0,0,0,,,,,,
758,693,204,758,693,203,,,0,0,1,,,,,,
758,693,207,758,693,207,,,0,0,0,,,,,,
758,693,212,758,693,213,,,0,0,-1,,,,,,
758,693,220,758,693,220,,,0,0,0,,,,,,
758,693,229,758,693,230,,,0,0,-1,,,,,,
759,693,241,758,693,241,,,1,0,0,,,,,,
759,693,255,758,693,256,,,1,0,-1,,,,,,
759,693,270,758,693,270,,,1,0,0,,,,,,
759,693,287,759,693,287,,,0,0,0,,,,,,
759,694,304,759,693,304,,,0,1,0,,,,,,
759,694,323,759,693,323,,,0,1,0,,,,,,
759,694,342,759,694,342,,,0,0,0,,,,,,
759,694,363,759,694,363,,,0,0,0,,,,,,
760,694,384,759,694,384,,,1,0,0,,,,,,
760,695,405,760,694,405,,,0,1,0,,,,,,
760,695,427,760,695,427,,,0,0,0,,,,,,
760,695,449,760,695,449,,,0,0,0,,,,,,
760,695,471,760,695,471,,,0,0,0,,,,,,
761,696,494,761,695,494,,,0,1,0,,,,,,
761,696,517,761,696,517,,,0,0,0,,,,,,
761,696,541,761,696,540,,,0,0,1,,,,,,
762,697,564,761,697,564,,,1,0,0,,,,,,
762,697,588,762,697,587,,,0,0,1,,,,,,
762,698,612,762,697,611,,,0,1,1,,,,,,
763,698,636,763,698,635,,,0,0,1,,,,,,
763,698,660,763,698,659,,,0,0,1,,,,,,
764,699,684,763,699,684,,,1,0,0,,,,,,
764,699,709,764,699,708,,,0,0,1,,,,,,
764,700,733,764,700,733,,,0,0,0,,,,,,
765,700,758,765,700,757,,,0,0,1,,,,,,
765,701,783,765,701,782,,,0,0,1,,,,,,
766,721,210,766,721,210,,,0,0,0,,,,,,
766,721,211,766,721,210,,,0,0,1,,,,,,
766,721,214,766,721,213,,,0,0,1,,,,,,
766,721,219,766,721,220,,,0,0,-1,,,,,,
766,721,226,766,721,226,,,0,0,0,,,,,,
766,721,235,766,721,236,,,0,0,-1,,,,,,
766,721,247,766,721,247,,,0,0,0,,,,,,
766,721,260,766,721,261,,,0,0,-1,,,,,,
766,722,275,766,721,275,,,0,1,0,,,,,,
766,722,291,766,721,292,,,0,1,-1,,,,,,
766,722,309,767,722,309,,,-1,0,0,,,,,,
767,722,327,767,722,327,,,0,0,0,,,,,,
767,722,346,767,722,346,,,0,0,0,,,,,,
767,722,366,767,722,366,,,0,0,0,,,,,,
767,723,387,767,722,387,,,0,1,0,,,,,,
767,723,408,767,723,408,,,0,0,0,,,,,,
768,723,430,768,723,430,,,0,0,0,,,,,,
768,723,452,768,723,452,,,0,0,0,,,,,,
768,724,474,768,723,474,,,0,1,0,,,,,,
768,724,497,768,724,497,,,0,0,0,,,,,,
769,724,520,769,724,520,,,0,0,0,,,,,,
769,724,543,769,724,543,,,0,0,0,,,,,,
769,725,566,769,725,566,,,0,0,0,,,,,,
769,725,590,769,725,589,,,0,0,1,,,,,,
770,726,614,770,725,613,,,0,1,1,,,,,,
770,726,638,770,726,637,,,0,0,1,,,,,,
771,726,662,771,726,661,,,0,0,1,,,,,,
771,727,686,771,727,686,,,0,0,0,,,,,,
771,727,710,771,727,710,,,0,0,0,,,,,,
772,728,735,772,728,735,,,0,0,0,,,,,,
772,728,759,772,728,759,,,0,0,0,,,,,,
773,729,784,773,729,784,,,0,0,0,,,,,,
774,750,217,774,749,217,,,0,1,0,,,,,,
774,750,218,774,749,217,,,0,1,1,,,,,,
774,750,221,774,749,220,,,0,1,1,,,,,,
774,750,225,774,749,226,,,0,1,-1,,,,,,
774,750,232,774,749,232,,,0,1,0,,,,,,
774,750,242,774,749,242,,,0,1,0,,,,,,
774,750,253,774,749,252,,,0,1,1,,,,,,
774,750,266,774,749,266,,,0,1,0,,,,,,
774,750,280,774,750,280,,,0,0,0,,,,,,
774,750,296,774,750,297,,,0,0,-1,,,,,,
774,750,313,774,750,313,,,0,0,0,,,,,,
774,750,331,774,750,331,,,0,0,0,,,,,,
775,751,350,775,750,350,,,0,1,0,,,,,,
775,751,370,775,750,370,,,0,1,0,,,,,,
775,751,390,775,751,390,,,0,0,0,,,,,,
775,751,411,775,751,411,,,0,0,0,,,,,,
775,751,433,775,751,433,,,0,0,0,,,,,,
776,752,455,775,751,455,,,1,1,0,,,,,,
776,752,477,776,752,477,,,0,0,0,,,,,,
776,752,499,776,752,499,,,0,0,0,,,,,,
776,752,522,776,752,522,,,0,0,0,,,,,,
777,753,545,776,752,545,,,1,1,0,,,,,,
777,753,569,777,753,568,,,0,0,1,,,,,,
777,753,592,777,753,592,,,0,0,0,,,,,,
778,754,616,778,753,615,,,0,1,1,,,,,,
778,754,640,778,754,639,,,0,0,1,,,,,,
778,755,664,778,754,663,,,0,1,1,,,,,,
779,755,688,779,755,688,,,0,0,0,,,,,,
779,756,712,779,755,712,,,0,1,0,,,,,,
780,756,737,780,756,737,,,0,0,0,,,,,,
780,756,761,780,756,761,,,0,0,0,,,,,,
781,757,786,781,757,786,,,0,0,0,,,,,,
782,778,224,782,778,224,,,0,0,0,,,,,,
782,778,225,782,778,224,,,0,0,1,,,,,,
782,778,227,782,778,227,,,0,0,0,,,,,,
782,778,232,782,778,233,,,0,0,-1,,,,,,
782,778,239,782,778,239,,,0,0,0,,,,,,
782,778,248,782,778,248,,,0,0,0,,,,,,
782,778,259,782,778,258,,,0,0,1,,,,,,
782,778,271,782,778,272,,,0,0,-1,,,,,,
782,778,286,782,778,285,,,0,0,1,,,,,,
782,779,301,782,778,302,,,0,1,-1,,,,,,
782,779,318,782,779,318,,,0,0,0,,,,,,
783,779,336,783,779,336,,,0,0,0,,,,,,
783,779,355,783,779,354,,,0,0,1,,,,,,
783,779,374,783,779,374,,,0,0,0,,,,,,
783,779,394,783,779,394,,,0,0,0,,,,,,
783,780,415,783,779,415,,,0,1,0,,,,,,
783,780,436,783,780,436,,,0,0,0,,,,,,
784,780,458,784,780,458,,,0,0,0,,,,,,
784,780,480,784,780,480,,,0,0,0,,,,,,
784,781,502,784,780,502,,,0,1,0,,,,,,
784,781,525,784,781,525,,,0,0,0,,,,,,
785,781,548,785,781,548,,,0,0,0,,,,,,
785,781,571,785,781,571,,,0,0,0,,,,,,
785,782,594,785,781,594,,,0,1,0,,,,,,
786,782,618,786,782,618,,,0,0,0,,,,,,
786,783,642,786,782,641,,,0,1,1,,,,,,
786,783,666,786,783,665,,,0,0,1,,,,,,
787,783,690,787,783,690,,,0,0,0,,,,,,
787,784,714,787,784,714,,,0,0,0,,,,,,
788,784,738,788,784,738,,,0,0,0,,,,,,
788,785,763,788,785,763,,,0,0,0,,,,,,
789,785,787,789,785,787,,,0,0,0,,,,,,
790,807,231,790,806,231,,,0,1,0,,,,,,
790,807,232,790,806,231,,,0,1,1,,,,,,
790,807,234,790,806,234,,,0,1,0,,,,,,
790,807,239,790,806,240,,,0,1,-1,,,,,,
790,807,245,790,806,245,,,0,1,0,,,,,,
790,807,254,790,806,255,,,0,1,-1,,,,,,
790,807,265,790,806,264,,,0,1,1,,,,,,
790,807,277,790,807,277,,,0,0,0,,,,,,
791,807,291,790,807,291,,,1,0,0,,,,,,
791,807,306,790,807,307,,,1,0,-1,,,,,,
791,807,323,791,807,323,,,0,0,0,,,,,,
791,807,340,791,807,341,,,0,0,-1,,,,,,
791,808,359,791,807,359,,,0,1,0,,,,,,
791,808,378,791,807,378,,,0,1,0,,,,,,
791,808,398,791,807,398,,,0,1,0,,,,,,
792,808,418,791,808,418,,,1,0,0,,,,,,
792,808,440,792,808,439,,,0,0,1,,,,,,
792,809,461,792,808,461,,,0,1,0,,,,,,
792,809,483,792,808,483,,,0,1,0,,,,,,
793,809,505,792,809,505,,,1,0,0,,,,,,
793,809,528,793,809,527,,,0,0,1,,,,,,
793,810,551,793,809,550,,,0,1,1,,,,,,
793,810,574,793,809,573,,,0,1,1,,,,,,
794,810,597,793,810,597,,,1,0,0,,,,,,
794,811,620,794,810,620,,,0,1,0,,,,,,
794,811,644,794,811,644,,,0,0,0,,,,,,
795,811,668,795,811,667,,,0,0,1,,,,,,
795,812,692,795,812,692,,,0,0,0,,,,,,
796,812,716,796,812,716,,,0,0,0,,,,,,
796,813,740,796,813,740,,,0,0,0,,,,,,
796,813,765,796,813,764,,,0,0,1,,,,,,
797,814,789,797,814,789,,,0,0,0,,,,,,
799,835,238,799,835,238,,,0,0,0,,,,,,
799,835,239,799,835,238,,,0,0,1,,,,,,
799,835,241,799,835,241,,,0,0,0,,,,,,
799,835,246,799,835,246,,,0,0,0,,,,,,
799,835,252,799,835,252,,,0,0,0,,,,,,
799,836,261,799,835,261,,,0,1,0,,,,,,
799,836,271,799,835,271,,,0,1,0,,,,,,
799,836,283,799,835,283,,,0,1,0,,,,,,
799,836,297,799,836,296,,,0,0,1,,,,,,
799,836,312,799,836,312,,,0,0,0,,,,,,
799,836,328,799,836,328,,,0,0,0,,,,,,
800,836,345,800,836,345,,,0,0,0,,,,,,
800,836,363,800,836,363,,,0,0,0,,,,,,
800,836,382,800,836,382,,,0,0,0,,,,,,
800,837,402,800,836,402,,,0,1,0,,,,,,
800,837,422,800,836,422,,,0,1,0,,,,,,
800,837,443,800,837,443,,,0,0,0,,,,,,
801,837,464,801,837,464,,,0,0,0,,,,,,
801,837,486,801,837,486,,,0,0,0,,,,,,
801,838,508,801,837,508,,,0,1,0,,,,,,
801,838,531,801,838,530,,,0,0,1,,,,,,
802,838,553,802,838,553,,,0,0,0,,,,,,
802,839,576,802,838,576,,,0,1,0,,,,,,
802,839,599,802,838,599,,,0,1,0,,,,,,
803,839,623,802,839,623,,,1,0,0,,,,,,
803,840,646,803,839,646,,,0,1,0,,,,,,
803,840,670,803,840,670,,,0,0,0,,,,,,
804,840,694,804,840,694,,,0,0,0,,,,,,
804,841,718,804,841,718,,,0,0,0,,,,,,
805,841,742,805,841,742,,,0,0,0,,,,,,
805,842,767,805,842,766,,,0,0,1,,,,,,
805,842,791,805,842,791,,,0,0,0,,,,,,
808,864,245,808,864,245,,,0,0,0,,,,,,
808,864,246,808,864,245,,,0,0,1,,,,,,
808,864,248,808,864,248,,,0,0,0,,,,,,
808,864,253,808,864,253,,,0,0,0,,,,,,
808,864,259,808,864,258,,,0,0,1,,,,,,
808,864,267,808,864,268,,,0,0,-1,,,,,,
808,864,277,808,864,277,,,0,0,0,,,,,,
808,864,289,808,864,289,,,0,0,0,,,,,,
808,865,302,808,864,302,,,0,1,0,,,,,,
808,865,317,808,864,317,,,0,1,0,,,,,,
808,865,333,808,864,333,,,0,1,0,,,,,,
808,865,350,808,864,350,,,0,1,0,,,,,,
809,865,368,809,865,368,,,0,0,0,,,,,,
809,865,386,809,865,387,,,0,0,-1,,,,,,
809,865,406,809,865,406,,,0,0,0,,,,,,
809,866,426,809,865,426,,,0,1,0,,,,,,
809,866,447,809,865,447,,,0,1,0,,,,,,
810,866,468,809,866,468,,,1,0,0,,,,,,
810,866,489,810,866,489,,,0,0,0,,,,,,
810,866,511,810,866,511,,,0,0,0,,,,,,
810,867,534,810,866,533,,,0,1,1,,,,,,
811,867,556,810,867,556,,,1,0,0,,,,,,
811,867,579,811,867,579,,,0,0,0,,,,,,
811,868,602,811,867,602,,,0,1,0,,,,,,
811,868,625,811,867,625,,,0,1,0,,,,,,
812,868,649,812,868,649,,,0,0,0,,,,,,
812,869,672,812,868,672,,,0,1,0,,,,,,
813,869,696,813,869,696,,,0,0,0,,,,,,
813,869,720,813,869,720,,,0,0,0,,,,,,
813,870,744,813,870,744,,,0,0,0,,,,,,
814,870,769,814,870,768,,,0,0,1,,,,,,
814,871,793,814,870,793,,,0,1,0,,,,,,
817,893,253,817,893,252,,,0,0,1,,,,,,
817,893,253,817,893,252,,,0,0,1,,,,,,
817,893,256,817,893,255,,,0,0,1,,,,,,
817,893,260,817,893,260,,,0,0,0,,,,,,
817,893,266,817,893,265,,,0,0,1,,,,,,
817,893,274,817,893,274,,,0,0,0,,,,,,
817,893,283,817,893,283,,,0,0,0,,,,,,
817,893,295,817,893,295,,,0,0,0,,,,,,
817,893,308,817,893,308,,,0,0,0,,,,,,
817,893,322,817,893,323,,,0,0,-1,,,,,,
817,894,338,817,893,338,,,0,1,0,,,,,,
818,894,355,818,893,355,,,0,1,0,,,,,,
818,894,372,818,894,372,,,0,0,0,,,,,,
818,894,391,818,894,391,,,0,0,0,,,,,,
818,894,410,818,894,410,,,0,0,0,,,,,,
818,894,430,818,894,430,,,0,0,0,,,,,,
818,895,450,818,894,450,,,0,1,0,,,,,,
819,895,471,819,894,471,,,0,1,0,,,,,,
819,895,493,819,895,493,,,0,0,0,,,,,,
819,895,515,819,895,514,,,0,0,1,,,,,,
819,895,537,819,895,536,,,0,0,1,,,,,,
820,896,559,820,895,559,,,0,1,0,,,,,,
820,896,582,820,896,581,,,0,0,1,,,,,,
820,896,605,820,896,604,,,0,0,1,,,,,,
821,897,628,820,896,628,,,1,1,0,,,,,,
821,897,651,821,896,651,,,0,1,0,,,,,,
821,897,675,821,897,675,,,0,0,0,,,,,,
822,898,699,822,897,698,,,0,1,1,,,,,,
822,898,722,822,898,722,,,0,0,0,,,,,,
822,898,746,822,898,746,,,0,0,0,,,,,,
823,899,771,823,899,770,,,0,0,1,,,,,,
823,899,795,823,899,795,,,0,0,0,,,,,,
700,194,106,700,194,106,,,0,0,0,,,,,,
700,194,108,700,194,106,,,0,0,2,,,,,,
700,194,113,700,194,113,,,0,0,0,,,,,,
700,194,123,700,194,124,,,0,0,-1,,,,,,
700,194,136,700,194,136,,,0,0,0,,,,,,
700,194,152,700,194,153,,,0,0,-1,,,,,,
701,195,170,701,195,170,,,0,0,0,,,,,,
701,195,190,701,195,190,,,0,0,0,,,,,,
701,195,210,701,195,210,,,0,0,0,,,,,,
701,196,232,701,195,232,,,0,1,0,,,,,,
701,196,254,701,196,254,,,0,0,0,,,,,,
701,197,276,701,197,276,,,0,0,0,,,,,,
701,198,299,701,198,299,,,0,0,0,,,,,,
701,199,322,701,198,322,,,0,1,0,,,,,,
702,199,346,702,199,346,,,0,0,0,,,,,,
702,200,370,702,200,370,,,0,0,0,,,,,,
702,201,394,702,201,394,,,0,0,0,,,,,,
702,202,418,702,202,418,,,0,0,0,,,,,,
703,204,442,703,204,442,,,0,0,0,,,,,,
703,205,467,703,205,466,,,0,0,1,,,,,,
703,206,491,703,206,491,,,0,0,0,,,,,,
704,207,516,703,207,515,,,1,0,1,,,,,,
704,209,540,704,209,540,,,0,0,0,,,,,,
704,210,565,704,210,565,,,0,0,0,,,,,,
705,212,590,705,212,590,,,0,0,0,,,,,,
705,214,615,705,213,615,,,0,1,0,,,,,,
705,215,640,705,215,640,,,0,0,0,,,,,,
706,217,665,705,217,665,,,1,0,0,,,,,,
706,219,690,706,219,690,,,0,0,0,,,,,,
707,221,716,706,221,715,,,1,0,1,,,,,,
707,223,741,707,223,741,,,0,0,0,,,,,,
708,225,766,707,225,766,,,1,0,0,,,,,,
700,195,106,700,194,106,,,0,1,0,,,,,,
700,195,108,700,194,106,,,0,1,2,,,,,,
700,195,113,700,194,113,,,0,1,0,,,,,,
700,195,123,700,194,124,,,0,1,-1,,,,,,
700,195,136,700,194,136,,,0,1,0,,,,,,
701,195,152,700,194,153,,,1,1,-1,,,,,,
701,196,170,701,195,170,,,0,1,0,,,,,,
701,196,190,701,195,190,,,0,1,0,,,,,,
701,196,210,701,195,210,,,0,1,0,,,,,,
701,197,232,701,195,232,,,0,2,0,,,,,,
701,198,254,701,196,254,,,0,2,0,,,,,,
701,198,276,701,197,276,,,0,1,0,,,,,,
701,199,299,701,198,299,,,0,1,0,,,,,,
702,200,323,701,198,322,,,1,2,1,,,,,,
702,200,346,702,199,346,,,0,1,0,,,,,,
702,201,370,702,200,370,,,0,1,0,,,,,,
702,202,394,702,201,394,,,0,1,0,,,,,,
702,203,418,702,202,418,,,0,1,0,,,,,,
703,205,442,703,204,442,,,0,1,0,,,,,,
703,206,467,703,205,466,,,0,1,1,,,,,,
703,207,491,703,206,491,,,0,1,0,,,,,,
704,208,516,703,207,515,,,1,1,1,,,,,,
704,210,540,704,209,540,,,0,1,0,,,,,,
704,211,565,704,210,565,,,0,1,0,,,,,,
705,213,590,705,212,590,,,0,1,0,,,,,,
705,215,615,705,213,615,,,0,2,0,,,,,,
706,216,640,705,215,640,,,1,1,0,,,,,,
706,218,665,705,217,665,,,1,1,0,,,,,,
706,220,691,706,219,690,,,0,1,1,,,,,,
707,222,716,706,221,715,,,1,1,1,,,,,,
707,224,741,707,223,741,,,0,1,0,,,,,,
708,226,766,707,225,766,,,1,1,0,,,,,,
701,199,107,701,199,107,,,0,0,0,,,,,,
701,199,108,701,199,107,,,0,0,1,,,,,,
701,199,114,701,199,114,,,0,0,0,,,,,,
701,199,124,701,199,125,,,0,0,-1,,,,,,
701,199,137,701,199,137,,,0,0,0,,,,,,
701,199,153,701,199,154,,,0,0,-1,,,,,,
701,200,171,701,200,171,,,0,0,0,,,,,,
701,200,190,701,200,191,,,0,0,-1,,,,,,
701,200,211,701,200,211,,,0,0,0,,,,,,
701,201,232,701,200,232,,,0,1,0,,,,,,
701,201,254,701,201,254,,,0,0,0,,,,,,
701,202,276,701,202,276,,,0,0,0,,,,,,
702,203,299,702,203,299,,,0,0,0,,,,,,
702,204,323,702,203,322,,,0,1,1,,,,,,
702,204,346,702,204,346,,,0,0,0,,,,,,
702,205,370,702,205,370,,,0,0,0,,,,,,
702,206,394,702,206,394,,,0,0,0,,,,,,
703,207,418,702,207,418,,,1,0,0,,,,,,
703,208,442,703,208,442,,,0,0,0,,,,,,
703,210,467,703,209,466,,,0,1,1,,,,,,
704,211,491,704,211,491,,,0,0,0,,,,,,
704,212,516,704,212,516,,,0,0,0,,,,,,
704,214,541,704,214,541,,,0,0,0,,,,,,
705,215,565,704,215,565,,,1,0,0,,,,,,
705,217,590,705,217,590,,,0,0,0,,,,,,
705,218,615,705,218,615,,,0,0,0,,,,,,
706,220,640,706,220,640,,,0,0,0,,,,,,
706,222,665,706,221,665,,,0,1,0,,,,,,
707,223,691,707,223,691,,,0,0,0,,,,,,
707,225,716,707,225,716,,,0,0,0,,,,,,
708,227,741,708,227,741,,,0,0,0,,,,,,
708,229,766,708,229,766,,,0,0,0,,,,,,
701,206,108,701,208,108,,,0,-2,0,,,,,,
701,206,109,701,208,108,,,0,-2,1,,,,,,
701,206,115,701,208,115,,,0,-2,0,,,,,,
701,206,124,701,208,126,,,0,-2,-2,,,,,,
701,206,138,701,208,138,,,0,-2,0,,,,,,
701,207,153,701,208,154,,,0,-1,-1,,,,,,
701,207,171,701,208,171,,,0,-1,0,,,,,,
701,207,191,701,208,191,,,0,-1,0,,,,,,
702,208,211,701,209,211,,,1,-1,0,,,,,,
702,208,232,701,209,233,,,1,-1,-1,,,,,,
702,209,254,702,210,254,,,0,-1,0,,,,,,
702,209,277,702,210,277,,,0,-1,0,,,,,,
702,210,300,702,211,299,,,0,-1,1,,,,,,
702,211,323,702,212,323,,,0,-1,0,,,,,,
703,211,346,702,213,346,,,1,-2,0,,,,,,
703,212,370,702,213,370,,,1,-1,0,,,,,,
703,213,394,703,214,394,,,0,-1,0,,,,,,
703,214,418,703,215,418,,,0,-1,0,,,,,,
703,215,442,703,216,442,,,0,-1,0,,,,,,
704,217,467,704,218,467,,,0,-1,0,,,,,,
704,218,491,704,219,491,,,0,-1,0,,,,,,
704,219,516,704,220,516,,,0,-1,0,,,,,,
705,220,541,705,222,541,,,0,-2,0,,,,,,
705,222,566,705,223,565,,,0,-1,1,,,,,,
706,223,590,705,225,590,,,1,-2,0,,,,,,
706,225,615,706,226,615,,,0,-1,0,,,,,,
706,226,640,706,228,640,,,0,-2,0,,,,,,
707,228,666,707,229,665,,,0,-1,1,,,,,,
707,230,691,707,231,691,,,0,-1,0,,,,,,
708,232,716,708,232,716,,,0,0,0,,,,,,
708,233,741,708,234,741,,,0,-1,0,,,,,,
709,235,766,709,236,766,,,0,-1,0,,,,,,
702,217,109,702,217,109,,,0,0,0,,,,,,
702,217,110,702,217,109,,,0,0,1,,,,,,
702,217,116,702,217,116,,,0,0,0,,,,,,
702,217,126,702,217,127,,,0,0,-1,,,,,,
702,217,139,702,217,139,,,0,0,0,,,,,,
702,217,154,702,217,155,,,0,0,-1,,,,,,
702,217,172,702,217,172,,,0,0,0,,,,,,
702,218,191,702,217,192,,,0,1,-1,,,,,,
702,218,212,702,218,212,,,0,0,0,,,,,,
702,218,233,702,218,233,,,0,0,0,,,,,,
703,219,255,703,219,255,,,0,0,0,,,,,,
703,220,277,703,219,277,,,0,1,0,,,,,,
703,220,300,703,220,300,,,0,0,0,,,,,,
703,221,323,703,221,323,,,0,0,0,,,,,,
703,222,347,703,222,347,,,0,0,0,,,,,,
704,222,371,703,222,370,,,1,0,1,,,,,,
704,223,394,704,223,394,,,0,0,0,,,,,,
704,224,419,704,224,418,,,0,0,1,,,,,,
704,225,443,704,225,443,,,0,0,0,,,,,,
705,226,467,704,226,467,,,1,0,0,,,,,,
705,228,492,705,228,492,,,0,0,0,,,,,,
705,229,516,705,229,516,,,0,0,0,,,,,,
706,230,541,706,230,541,,,0,0,0,,,,,,
706,231,566,706,231,566,,,0,0,0,,,,,,
706,233,591,706,233,591,,,0,0,0,,,,,,
707,234,616,706,234,616,,,1,0,0,,,,,,
707,236,641,707,236,641,,,0,0,0,,,,,,
708,237,666,707,237,666,,,1,0,0,,,,,,
708,239,691,708,239,691,,,0,0,0,,,,,,
709,241,716,708,240,716,,,1,1,0,,,,,,
709,242,741,709,242,741,,,0,0,0,,,,,,
710,244,767,709,244,766,,,1,0,1,,,,,,
703,230,111,703,231,111,,,0,-1,0,,,,,,
703,230,112,703,231,111,,,0,-1,1,,,,,,
703,230,118,703,231,118,,,0,-1,0,,,,,,
703,230,127,703,231,129,,,0,-1,-2,,,,,,
703,230,140,703,231,140,,,0,-1,0,,,,,,
703,230,156,703,231,157,,,0,-1,-1,,,,,,
703,231,173,703,231,173,,,0,0,0,,,,,,
703,231,192,703,232,193,,,0,-1,-1,,,,,,
703,231,213,703,232,213,,,0,-1,0,,,,,,
704,232,234,703,233,234,,,1,-1,0,,,,,,
704,232,256,704,233,255,,,0,-1,1,,,,,,
704,233,278,704,234,278,,,0,-1,0,,,,,,
704,233,301,704,234,300,,,0,-1,1,,,,,,
704,234,324,704,235,324,,,0,-1,0,,,,,,
704,235,347,704,236,347,,,0,-1,0,,,,,,
705,235,371,704,236,371,,,1,-1,0,,,,,,
705,236,395,705,237,394,,,0,-1,1,,,,,,
705,237,419,705,238,419,,,0,-1,0,,,,,,
705,238,443,705,239,443,,,0,-1,0,,,,,,
706,239,467,705,240,467,,,1,-1,0,,,,,,
706,240,492,706,241,492,,,0,-1,0,,,,,,
706,241,517,706,242,516,,,0,-1,1,,,,,,
707,243,541,707,243,541,,,0,0,0,,,,,,
707,244,566,707,245,566,,,0,-1,0,,,,,,
707,245,591,707,246,591,,,0,-1,0,,,,,,
708,246,616,708,248,616,,,0,-2,0,,,,,,
708,248,641,708,249,641,,,0,-1,0,,,,,,
709,249,666,708,250,666,,,1,-1,0,,,,,,
709,251,691,709,252,691,,,0,-1,0,,,,,,
710,253,716,709,253,716,,,1,0,0,,,,,,
710,254,742,710,255,741,,,0,-1,1,,,,,,
711,256,767,710,257,766,,,1,-1,1,,,,,,
704,246,113,704,246,113,,,0,0,0,,,,,,
704,246,114,704,246,113,,,0,0,1,,,,,,
704,246,120,704,246,120,,,0,0,0,,,,,,
704,246,129,704,246,131,,,0,0,-2,,,,,,
705,246,142,705,246,142,,,0,0,0,,,,,,
705,246,157,705,246,158,,,0,0,-1,,,,,,
705,246,175,705,246,175,,,0,0,0,,,,,,
705,247,193,705,246,194,,,0,1,-1,,,,,,
705,247,214,705,247,214,,,0,0,0,,,,,,
705,247,235,705,247,235,,,0,0,0,,,,,,
705,248,256,705,248,256,,,0,0,0,,,,,,
705,248,279,705,248,278,,,0,0,1,,,,,,
705,249,301,705,249,301,,,0,0,0,,,,,,
706,249,325,705,249,324,,,1,0,1,,,,,,
706,250,348,706,250,348,,,0,0,0,,,,,,
706,251,372,706,251,371,,,0,0,1,,,,,,
706,252,395,706,252,395,,,0,0,0,,,,,,
706,252,419,706,252,419,,,0,0,0,,,,,,
707,253,444,707,253,444,,,0,0,0,,,,,,
707,254,468,707,254,468,,,0,0,0,,,,,,
707,255,492,707,255,492,,,0,0,0,,,,,,
708,256,517,707,256,517,,,1,0,0,,,,,,
708,257,542,708,257,542,,,0,0,0,,,,,,
708,259,566,708,258,566,,,0,1,0,,,,,,
709,260,591,709,260,591,,,0,0,0,,,,,,
709,261,616,709,261,616,,,0,0,0,,,,,,
710,263,641,710,263,641,,,0,0,0,,,,,,
710,264,666,710,264,666,,,0,0,0,,,,,,
710,265,691,710,265,691,,,0,0,0,,,,,,
711,267,717,710,266,716,,,1,1,1,,,,,,
711,268,742,711,268,742,,,0,0,0,,,,,,
712,270,767,712,270,767,,,0,0,0,,,,,,
706,263,116,706,264,116,,,0,-1,0,,,,,,
706,264,117,706,264,116,,,0,0,1,,,,,,
706,264,122,706,264,122,,,0,0,0,,,,,,
706,264,131,706,264,133,,,0,0,-2,,,,,,
706,264,144,706,264,144,,,0,0,0,,,,,,
706,264,159,706,264,160,,,0,0,-1,,,,,,
706,264,176,706,265,176,,,0,-1,0,,,,,,
706,264,195,706,265,196,,,0,-1,-1,,,,,,
706,265,215,706,265,215,,,0,0,0,,,,,,
707,265,236,706,266,236,,,1,-1,0,,,,,,
707,265,258,707,266,257,,,0,-1,1,,,,,,
707,266,280,707,267,279,,,0,-1,1,,,,,,
707,266,302,707,267,302,,,0,-1,0,,,,,,
707,267,325,707,268,325,,,0,-1,0,,,,,,
707,268,349,707,268,349,,,0,0,0,,,,,,
708,268,372,707,269,372,,,1,-1,0,,,,,,
708,269,396,708,270,396,,,0,-1,0,,,,,,
708,270,420,708,270,420,,,0,0,0,,,,,,
708,271,444,708,271,444,,,0,0,0,,,,,,
709,272,468,708,272,468,,,1,0,0,,,,,,
709,272,493,709,273,493,,,0,-1,0,,,,,,
709,273,517,709,274,517,,,0,-1,0,,,,,,
710,274,542,710,275,542,,,0,-1,0,,,,,,
710,276,567,710,276,567,,,0,0,0,,,,,,
710,277,592,710,277,591,,,0,0,1,,,,,,
711,278,617,711,279,616,,,0,-1,1,,,,,,
711,279,642,711,280,641,,,0,-1,1,,,,,,
712,281,667,711,281,666,,,1,0,1,,,,,,
712,282,692,712,282,691,,,0,0,1,,,,,,
713,283,717,712,284,717,,,1,-1,0,,,,,,
713,285,742,713,285,742,,,0,0,0,,,,,,
714,286,767,713,287,767,,,1,-1,0,,,,,,
708,283,119,708,283,119,,,0,0,0,,,,,,
708,283,120,708,283,119,,,0,0,1,,,,,,
708,283,125,708,283,125,,,0,0,0,,,,,,
708,283,134,708,283,135,,,0,0,-1,,,,,,
708,283,146,708,283,146,,,0,0,0,,,,,,
708,284,161,708,283,162,,,0,1,-1,,,,,,
708,284,178,708,284,178,,,0,0,0,,,,,,
708,284,197,708,284,197,,,0,0,0,,,,,,
708,284,217,708,284,217,,,0,0,0,,,,,,
709,285,237,708,284,238,,,1,1,-1,,,,,,
709,285,259,709,285,259,,,0,0,0,,,,,,
709,285,281,709,285,281,,,0,0,0,,,,,,
709,286,303,709,286,303,,,0,0,0,,,,,,
709,286,326,709,286,326,,,0,0,0,,,,,,
709,287,350,709,287,350,,,0,0,0,,,,,,
710,288,373,709,287,373,,,1,1,0,,,,,,
710,288,397,710,288,397,,,0,0,0,,,,,,
710,289,421,710,289,421,,,0,0,0,,,,,,
710,290,445,710,290,445,,,0,0,0,,,,,,
711,291,469,710,290,469,,,1,1,0,,,,,,
711,291,494,711,291,494,,,0,0,0,,,,,,
711,292,518,711,292,518,,,0,0,0,,,,,,
712,293,543,712,293,543,,,0,0,0,,,,,,
712,294,567,712,294,567,,,0,0,0,,,,,,
712,295,592,712,295,592,,,0,0,0,,,,,,
713,297,617,712,296,617,,,1,1,0,,,,,,
713,298,642,713,298,642,,,0,0,0,,,,,,
714,299,667,713,299,667,,,1,0,0,,,,,,
714,300,692,714,300,692,,,0,0,0,,,,,,
715,302,717,714,301,717,,,1,1,0,,,,,,
715,303,743,715,303,743,,,0,0,0,,,,,,
716,304,768,715,304,768,,,1,0,0,,,,,,
710,304,122,710,304,122,,,0,0,0,,,,,,
710,304,124,710,304,122,,,0,0,2,,,,,,
710,304,129,710,305,128,,,0,-1,1,,,,,,
710,304,137,710,305,138,,,0,-1,-1,,,,,,
710,304,149,710,305,149,,,0,-1,0,,,,,,
711,305,164,710,305,164,,,1,0,0,,,,,,
711,305,180,710,305,180,,,1,0,0,,,,,,
711,305,199,710,305,199,,,1,0,0,,,,,,
711,305,218,710,305,218,,,1,0,0,,,,,,
711,306,239,711,306,239,,,0,0,0,,,,,,
711,306,260,711,306,260,,,0,0,0,,,,,,
711,306,282,711,307,282,,,0,-1,0,,,,,,
711,307,305,711,307,304,,,0,0,1,,,,,,
711,307,328,711,308,327,,,0,-1,1,,,,,,
712,308,351,711,308,351,,,1,0,0,,,,,,
712,308,374,712,309,374,,,0,-1,0,,,,,,
712,309,398,712,309,398,,,0,0,0,,,,,,
712,310,422,712,310,422,,,0,0,0,,,,,,
713,310,446,712,311,446,,,1,-1,0,,,,,,
713,311,470,713,311,470,,,0,0,0,,,,,,
713,312,494,713,312,494,,,0,0,0,,,,,,
714,313,519,713,313,519,,,1,0,0,,,,,,
714,314,543,714,314,543,,,0,0,0,,,,,,
714,315,568,714,315,568,,,0,0,0,,,,,,
715,316,593,714,316,592,,,1,0,1,,,,,,
715,317,618,715,317,617,,,0,0,1,,,,,,
715,318,643,715,318,642,,,0,0,1,,,,,,
716,319,668,716,319,667,,,0,0,1,,,,,,
716,320,693,716,320,692,,,0,0,1,,,,,,
717,321,718,717,322,718,,,0,-1,0,,,,,,
717,323,743,717,323,743,,,0,0,0,,,,,,
718,324,768,718,324,768,,,0,0,0,,,,,,
713,326,126,713,326,126,,,0,0,0,,,,,,
713,326,127,713,326,126,,,0,0,1,,,,,,
713,327,132,713,327,132,,,0,0,0,,,,,,
713,327,141,713,327,142,,,0,0,-1,,,,,,
713,327,152,713,327,152,,,0,0,0,,,,,,
713,327,166,713,327,167,,,0,0,-1,,,,,,
713,327,183,713,327,183,,,0,0,0,,,,,,
713,327,201,713,327,201,,,0,0,0,,,,,,
713,327,220,713,327,220,,,0,0,0,,,,,,
713,328,241,713,327,241,,,0,1,0,,,,,,
714,328,262,714,328,262,,,0,0,0,,,,,,
714,328,284,714,328,284,,,0,0,0,,,,,,
714,329,306,714,329,306,,,0,0,0,,,,,,
714,329,329,714,329,329,,,0,0,0,,,,,,
714,330,352,714,330,352,,,0,0,0,,,,,,
714,330,375,714,330,375,,,0,0,0,,,,,,
715,331,399,715,331,399,,,0,0,0,,,,,,
715,331,423,715,331,423,,,0,0,0,,,,,,
715,332,447,715,332,447,,,0,0,0,,,,,,
716,333,471,715,333,471,,,1,0,0,,,,,,
716,334,495,716,334,495,,,0,0,0,,,,,,
716,334,520,716,334,519,,,0,0,1,,,,,,
716,335,544,716,335,544,,,0,0,0,,,,,,
717,336,569,716,336,568,,,1,0,1,,,,,,
717,337,593,717,337,593,,,0,0,0,,,,,,
718,338,618,717,338,618,,,1,0,0,,,,,,
718,339,643,718,339,643,,,0,0,0,,,,,,
718,340,668,718,340,668,,,0,0,0,,,,,,
719,341,693,719,341,693,,,0,0,0,,,,,,
719,342,718,719,342,718,,,0,0,0,,,,,,
720,344,744,720,344,744,,,0,0,0,,,,,,
720,345,769,720,345,769,,,0,0,0,,,,,,
716,350,130,716,350,130,,,0,0,0,,,,,,
716,350,132,716,350,130,,,0,0,2,,,,,,
716,350,136,716,350,136,,,0,0,0,,,,,,
716,350,144,716,350,145,,,0,0,-1,,,,,,
716,350,156,716,350,155,,,0,0,1,,,,,,
716,350,170,716,350,170,,,0,0,0,,,,,,
716,350,186,716,350,186,,,0,0,0,,,,,,
716,350,204,716,350,204,,,0,0,0,,,,,,
716,351,223,716,351,222,,,0,0,1,,,,,,
716,351,243,716,351,243,,,0,0,0,,,,,,
717,351,264,717,351,264,,,0,0,0,,,,,,
717,351,286,717,352,285,,,0,-1,1,,,,,,
717,352,308,717,352,307,,,0,0,1,,,,,,
717,352,330,717,353,330,,,0,-1,0,,,,,,
717,353,353,717,353,353,,,0,0,0,,,,,,
717,353,377,717,354,376,,,0,-1,1,,,,,,
718,354,400,718,354,400,,,0,0,0,,,,,,
718,354,424,718,355,424,,,0,-1,0,,,,,,
718,355,448,718,355,448,,,0,0,0,,,,,,
718,356,472,718,356,472,,,0,0,0,,,,,,
719,356,496,719,357,496,,,0,-1,0,,,,,,
719,357,520,719,357,520,,,0,0,0,,,,,,
719,358,545,719,358,545,,,0,0,0,,,,,,
720,359,570,719,359,569,,,1,0,1,,,,,,
720,359,594,720,360,594,,,0,-1,0,,,,,,
721,360,619,720,361,619,,,1,-1,0,,,,,,
721,361,644,721,362,644,,,0,-1,0,,,,,,
721,362,669,721,362,669,,,0,0,0,,,,,,
722,363,694,722,363,694,,,0,0,0,,,,,,
722,364,719,722,365,719,,,0,-1,0,,,,,,
723,366,744,723,366,744,,,0,0,0,,,,,,
723,367,769,723,367,769,,,0,0,0,,,,,,
719,374,135,719,374,135,,,0,0,0,,,,,,
719,374,136,719,374,135,,,0,0,1,,,,,,
719,374,140,719,374,140,,,0,0,0,,,,,,
719,374,148,719,374,149,,,0,0,-1,,,,,,
719,374,159,719,374,159,,,0,0,0,,,,,,
719,374,173,719,374,174,,,0,0,-1,,,,,,
719,374,189,719,374,189,,,0,0,0,,,,,,
719,374,206,719,374,207,,,0,0,-1,,,,,,
720,375,225,720,375,225,,,0,0,0,,,,,,
720,375,245,720,375,245,,,0,0,0,,,,,,
720,375,266,720,375,266,,,0,0,0,,,,,,
720,375,287,720,375,287,,,0,0,0,,,,,,
720,376,309,720,376,309,,,0,0,0,,,,,,
720,376,332,720,376,332,,,0,0,0,,,,,,
720,377,355,720,377,355,,,0,0,0,,,,,,
721,377,378,720,377,378,,,1,0,0,,,,,,
721,378,401,721,378,401,,,0,0,0,,,,,,
721,378,425,721,378,425,,,0,0,0,,,,,,
721,379,449,721,379,449,,,0,0,0,,,,,,
722,379,473,721,379,473,,,1,0,0,,,,,,
722,380,497,722,380,497,,,0,0,0,,,,,,
722,381,521,722,380,521,,,0,1,0,,,,,,
723,381,546,723,381,546,,,0,0,0,,,,,,
723,382,570,723,382,570,,,0,0,0,,,,,,
723,383,595,723,383,595,,,0,0,0,,,,,,
724,384,620,723,384,620,,,1,0,0,,,,,,
724,385,645,724,385,645,,,0,0,0,,,,,,
725,386,670,724,385,670,,,1,1,0,,,,,,
725,386,695,725,386,695,,,0,0,0,,,,,,
726,387,720,725,387,720,,,1,0,0,,,,,,
726,389,745,726,389,745,,,0,0,0,,,,,,
727,390,770,726,390,770,,,1,0,0,,,,,,
723,398,140,723,399,140,,,0,-1,0,,,,,,
723,398,141,723,399,140,,,0,-1,1,,,,,,
723,399,145,723,399,145,,,0,0,0,,,,,,
723,399,153,723,399,154,,,0,0,-1,,,,,,
723,399,163,723,399,163,,,0,0,0,,,,,,
723,399,177,723,399,178,,,0,0,-1,,,,,,
723,399,192,723,399,192,,,0,0,0,,,,,,
723,399,209,723,399,210,,,0,0,-1,,,,,,
723,399,228,723,399,228,,,0,0,0,,,,,,
723,399,248,723,399,248,,,0,0,0,,,,,,
723,400,268,723,400,268,,,0,0,0,,,,,,
723,400,290,723,400,289,,,0,0,1,,,,,,
724,400,311,724,400,311,,,0,0,0,,,,,,
724,401,334,724,401,333,,,0,0,1,,,,,,
724,401,356,724,401,356,,,0,0,0,,,,,,
724,402,379,724,402,379,,,0,0,0,,,,,,
724,402,403,724,402,402,,,0,0,1,,,,,,
725,402,426,724,403,426,,,1,-1,0,,,,,,
725,403,450,725,403,450,,,0,0,0,,,,,,
725,404,474,725,404,474,,,0,0,0,,,,,,
726,404,498,725,404,498,,,1,0,0,,,,,,
726,405,522,726,405,522,,,0,0,0,,,,,,
726,405,547,726,405,547,,,0,0,0,,,,,,
727,406,571,726,406,571,,,1,0,0,,,,,,
727,407,596,727,407,596,,,0,0,0,,,,,,
727,408,621,727,408,620,,,0,0,1,,,,,,
728,409,646,728,409,645,,,0,0,1,,,,,,
728,409,670,728,409,670,,,0,0,0,,,,,,
729,410,695,728,410,695,,,1,0,0,,,,,,
729,411,720,729,411,720,,,0,0,0,,,,,,
730,412,746,729,413,745,,,1,-1,1,,,,,,
730,413,771,730,414,770,,,0,-1,1,,,,,,
727,424,145,727,424,145,,,0,0,0,,,,,,
727,424,146,727,424,145,,,0,0,1,,,,,,
727,424,150,727,424,150,,,0,0,0,,,,,,
727,424,157,727,424,159,,,0,0,-2,,,,,,
727,424,168,727,424,168,,,0,0,0,,,,,,
727,424,181,727,424,182,,,0,0,-1,,,,,,
727,424,196,727,424,196,,,0,0,0,,,,,,
727,424,213,727,424,213,,,0,0,0,,,,,,
727,424,231,727,424,231,,,0,0,0,,,,,,
727,425,250,727,424,251,,,0,1,-1,,,,,,
727,425,271,727,425,271,,,0,0,0,,,,,,
727,425,292,727,425,292,,,0,0,0,,,,,,
728,425,313,728,425,313,,,0,0,0,,,,,,
728,426,336,728,425,335,,,0,1,1,,,,,,
728,426,358,728,426,358,,,0,0,0,,,,,,
728,427,381,728,426,381,,,0,1,0,,,,,,
728,427,404,728,427,404,,,0,0,0,,,,,,
729,427,428,728,427,428,,,1,0,0,,,,,,
729,428,452,729,428,452,,,0,0,0,,,,,,
729,429,475,729,428,475,,,0,1,0,,,,,,
729,429,499,729,429,499,,,0,0,0,,,,,,
730,430,524,729,429,523,,,1,1,1,,,,,,
730,430,548,730,430,548,,,0,0,0,,,,,,
730,431,572,730,431,572,,,0,0,0,,,,,,
731,432,597,731,432,597,,,0,0,0,,,,,,
731,432,622,731,432,621,,,0,0,1,,,,,,
732,433,646,732,433,646,,,0,0,0,,,,,,
732,434,671,732,434,671,,,0,0,0,,,,,,
732,435,696,732,435,696,,,0,0,0,,,,,,
733,436,721,732,436,721,,,1,0,0,,,,,,
733,437,746,733,437,746,,,0,0,0,,,,,,
734,438,771,733,438,771,,,1,0,0,,,,,,
731,450,150,731,450,150,,,0,0,0,,,,,,
731,450,151,731,450,150,,,0,0,1,,,,,,
731,450,155,731,450,155,,,0,0,0,,,,,,
731,450,162,731,450,163,,,0,0,-1,,,,,,
731,450,172,731,450,172,,,0,0,0,,,,,,
731,450,185,731,450,186,,,0,0,-1,,,,,,
731,450,200,731,450,200,,,0,0,0,,,,,,
731,450,216,731,450,217,,,0,0,-1,,,,,,
731,450,234,731,450,234,,,0,0,0,,,,,,
731,450,253,731,450,254,,,0,0,-1,,,,,,
731,451,273,731,451,273,,,0,0,0,,,,,,
732,451,294,731,451,294,,,1,0,0,,,,,,
732,451,316,732,451,315,,,0,0,1,,,,,,
732,451,338,732,451,337,,,0,0,1,,,,,,
732,452,360,732,452,360,,,0,0,0,,,,,,
732,452,383,732,452,383,,,0,0,0,,,,,,
733,453,406,732,453,406,,,1,0,0,,,,,,
733,453,429,733,453,429,,,0,0,0,,,,,,
733,453,453,733,453,453,,,0,0,0,,,,,,
733,454,477,733,454,477,,,0,0,0,,,,,,
734,455,501,733,454,500,,,1,1,1,,,,,,
734,455,525,734,455,525,,,0,0,0,,,,,,
734,456,549,734,455,549,,,0,1,0,,,,,,
735,456,574,735,456,573,,,0,0,1,,,,,,
735,457,598,735,457,598,,,0,0,0,,,,,,
735,458,623,735,458,622,,,0,0,1,,,,,,
736,458,647,736,458,647,,,0,0,0,,,,,,
736,459,672,736,459,672,,,0,0,0,,,,,,
737,460,697,736,460,697,,,1,0,0,,,,,,
737,461,722,737,461,722,,,0,0,0,,,,,,
738,462,747,737,462,747,,,1,0,0,,,,,,
738,462,772,738,463,772,,,0,-1,0,,,,,,
735,476,156,735,476,156,,,0,0,0,,,,,,
735,476,157,735,476,156,,,0,0,1,,,,,,
735,476,160,735,476,160,,,0,0,0,,,,,,
735,476,167,735,476,168,,,0,0,-1,,,,,,
735,476,177,735,476,177,,,0,0,0,,,,,,
736,476,189,735,476,190,,,1,0,-1,,,,,,
736,476,204,736,476,204,,,0,0,0,,,,,,
736,476,220,736,476,221,,,0,0,-1,,,,,,
736,476,238,736,476,238,,,0,0,0,,,,,,
736,476,256,736,476,257,,,0,0,-1,,,,,,
736,477,276,736,477,276,,,0,0,0,,,,,,
736,477,297,736,477,297,,,0,0,0,,,,,,
736,477,318,736,477,318,,,0,0,0,,,,,,
736,478,340,736,477,340,,,0,1,0,,,,,,
737,478,362,737,478,362,,,0,0,0,,,,,,
737,478,385,737,478,385,,,0,0,0,,,,,,
737,479,408,737,479,408,,,0,0,0,,,,,,
737,479,431,737,479,431,,,0,0,0,,,,,,
738,479,455,738,479,455,,,0,0,0,,,,,,
738,480,478,738,479,478,,,0,1,0,,,,,,
738,480,502,738,480,502,,,0,0,0,,,,,,
738,481,526,738,480,526,,,0,1,0,,,,,,
739,481,551,739,481,551,,,0,0,0,,,,,,
739,482,575,739,482,575,,,0,0,0,,,,,,
740,483,599,740,483,599,,,0,0,0,,,,,,
740,483,624,740,483,624,,,0,0,0,,,,,,
740,484,649,740,484,649,,,0,0,0,,,,,,
741,485,673,740,484,673,,,1,1,0,,,,,,
741,485,698,741,485,698,,,0,0,0,,,,,,
742,486,723,741,486,723,,,1,0,0,,,,,,
742,487,748,742,487,748,,,0,0,0,,,,,,
743,488,773,742,488,773,,,1,0,0,,,,,,
740,502,161,740,502,161,,,0,0,0,,,,,,
740,502,162,740,502,161,,,0,0,1,,,,,,
740,502,166,740,502,166,,,0,0,0,,,,,,
740,502,172,740,502,174,,,0,0,-2,,,,,,
740,502,182,740,502,182,,,0,0,0,,,,,,
740,502,194,740,502,195,,,0,0,-1,,,,,,
740,503,208,741,502,208,,,-1,1,0,,,,,,
741,503,224,741,502,224,,,0,1,0,,,,,,
741,503,241,741,503,241,,,0,0,0,,,,,,
741,503,260,741,503,260,,,0,0,0,,,,,,
741,503,279,741,503,279,,,0,0,0,,,,,,
741,503,300,741,503,300,,,0,0,0,,,,,,
741,504,321,741,503,321,,,0,1,0,,,,,,
741,504,342,741,504,342,,,0,0,0,,,,,,
742,504,365,742,504,364,,,0,0,1,,,,,,
742,505,387,742,505,387,,,0,0,0,,,,,,
742,505,410,742,505,410,,,0,0,0,,,,,,
742,505,433,742,505,433,,,0,0,0,,,,,,
742,506,456,743,505,456,,,-1,1,0,,,,,,
743,506,480,743,506,480,,,0,0,0,,,,,,
743,507,504,743,506,504,,,0,1,0,,,,,,
743,507,528,743,507,528,,,0,0,0,,,,,,
744,508,552,744,507,552,,,0,1,0,,,,,,
744,508,576,744,508,576,,,0,0,0,,,,,,
744,509,601,744,509,600,,,0,0,1,,,,,,
745,509,625,744,509,625,,,1,0,0,,,,,,
745,510,650,745,510,650,,,0,0,0,,,,,,
746,511,674,745,510,674,,,1,1,0,,,,,,
746,511,699,746,511,699,,,0,0,0,,,,,,
746,512,724,746,512,724,,,0,0,0,,,,,,
747,513,749,747,513,749,,,0,0,0,,,,,,
747,514,774,747,514,774,,,0,0,0,,,,,,
745,529,167,745,529,167,,,0,0,0,,,,,,
745,529,168,745,529,167,,,0,0,1,,,,,,
745,529,172,745,529,172,,,0,0,0,,,,,,
745,529,178,745,529,179,,,0,0,-1,,,,,,
746,529,187,746,529,187,,,0,0,0,,,,,,
746,529,199,746,529,199,,,0,0,0,,,,,,
746,529,212,746,529,212,,,0,0,0,,,,,,
746,529,228,746,529,228,,,0,0,0,,,,,,
746,530,245,746,530,245,,,0,0,0,,,,,,
746,530,263,746,530,264,,,0,0,-1,,,,,,
746,530,283,746,530,283,,,0,0,0,,,,,,
746,530,303,746,530,303,,,0,0,0,,,,,,
746,530,324,746,530,324,,,0,0,0,,,,,,
747,531,345,746,530,345,,,1,1,0,,,,,,
747,531,367,747,531,367,,,0,0,0,,,,,,
747,531,389,747,531,389,,,0,0,0,,,,,,
747,532,412,747,532,412,,,0,0,0,,,,,,
747,532,435,747,532,435,,,0,0,0,,,,,,
748,532,458,748,532,458,,,0,0,0,,,,,,
748,533,482,748,532,482,,,0,1,0,,,,,,
748,533,506,748,533,506,,,0,0,0,,,,,,
748,534,529,748,533,529,,,0,1,0,,,,,,
749,534,553,749,534,553,,,0,0,0,,,,,,
749,535,578,749,534,577,,,0,1,1,,,,,,
749,535,602,749,535,602,,,0,0,0,,,,,,
750,536,626,749,535,626,,,1,1,0,,,,,,
750,536,651,750,536,651,,,0,0,0,,,,,,
751,537,676,750,537,675,,,1,0,1,,,,,,
751,538,700,751,538,700,,,0,0,0,,,,,,
752,538,725,751,538,725,,,1,0,0,,,,,,
752,539,750,752,539,750,,,0,0,0,,,,,,
753,540,775,752,540,775,,,1,0,0,,,,,,
751,556,173,751,556,173,,,0,0,0,,,,,,
751,556,174,751,556,173,,,0,0,1,,,,,,
751,556,177,751,556,178,,,0,0,-1,,,,,,
751,556,184,751,556,185,,,0,0,-1,,,,,,
751,556,192,751,556,192,,,0,0,0,,,,,,
751,556,204,751,556,204,,,0,0,0,,,,,,
751,556,217,751,556,217,,,0,0,0,,,,,,
751,557,232,751,556,233,,,0,1,-1,,,,,,
751,557,249,751,557,249,,,0,0,0,,,,,,
751,557,267,751,557,267,,,0,0,0,,,,,,
752,557,286,751,557,286,,,1,0,0,,,,,,
752,557,306,751,557,306,,,1,0,0,,,,,,
752,557,327,752,557,327,,,0,0,0,,,,,,
752,558,348,752,557,348,,,0,1,0,,,,,,
752,558,370,752,558,369,,,0,0,1,,,,,,
752,558,392,752,558,392,,,0,0,0,,,,,,
753,559,414,752,559,414,,,1,0,0,,,,,,
753,559,437,753,559,437,,,0,0,0,,,,,,
753,559,460,753,559,460,,,0,0,0,,,,,,
753,560,484,753,559,483,,,0,1,1,,,,,,
754,560,507,753,560,507,,,1,0,0,,,,,,
754,561,531,754,560,531,,,0,1,0,,,,,,
754,561,555,754,561,555,,,0,0,0,,,,,,
755,562,579,754,561,579,,,1,1,0,,,,,,
755,562,604,755,562,603,,,0,0,1,,,,,,
755,563,628,755,562,628,,,0,1,0,,,,,,
756,563,652,756,563,652,,,0,0,0,,,,,,
756,564,677,756,563,677,,,0,1,0,,,,,,
757,564,702,756,564,701,,,1,0,1,,,,,,
757,565,726,757,565,726,,,0,0,0,,,,,,
757,566,751,757,566,751,,,0,0,0,,,,,,
758,566,776,758,566,776,,,0,0,0,,,,,,
757,583,179,757,583,179,,,0,0,0,,,,,,
757,583,180,757,583,179,,,0,0,1,,,,,,
757,584,184,757,584,184,,,0,0,0,,,,,,
757,584,189,757,584,191,,,0,0,-2,,,,,,
757,584,198,757,584,198,,,0,0,0,,,,,,
757,584,209,757,584,210,,,0,0,-1,,,,,,
757,584,222,757,584,222,,,0,0,0,,,,,,
757,584,237,757,584,237,,,0,0,0,,,,,,
757,584,253,757,584,253,,,0,0,0,,,,,,
757,584,271,757,584,271,,,0,0,0,,,,,,
757,584,290,757,584,290,,,0,0,0,,,,,,
757,584,309,757,584,310,,,0,0,-1,,,,,,
758,585,330,758,585,330,,,0,0,0,,,,,,
758,585,351,758,585,351,,,0,0,0,,,,,,
758,585,372,758,585,372,,,0,0,0,,,,,,
758,585,394,758,585,394,,,0,0,0,,,,,,
758,586,417,758,586,417,,,0,0,0,,,,,,
759,586,439,758,586,439,,,1,0,0,,,,,,
759,586,462,759,586,462,,,0,0,0,,,,,,
759,587,486,759,586,485,,,0,1,1,,,,,,
759,587,509,759,587,509,,,0,0,0,,,,,,
760,588,533,759,587,533,,,1,1,0,,,,,,
760,588,557,760,588,557,,,0,0,0,,,,,,
760,589,581,760,588,581,,,0,1,0,,,,,,
761,589,605,761,589,605,,,0,0,0,,,,,,
761,590,629,761,589,629,,,0,1,0,,,,,,
762,590,654,762,590,654,,,0,0,0,,,,,,
762,591,678,762,590,678,,,0,1,0,,,,,,
762,591,703,762,591,703,,,0,0,0,,,,,,
763,592,728,762,592,728,,,1,0,0,,,,,,
763,593,753,763,593,753,,,0,0,0,,,,,,
764,593,778,763,593,777,,,1,0,1,,,,,,
763,611,186,763,611,185,,,0,0,1,,,,,,
763,611,187,763,611,185,,,0,0,2,,,,,,
763,611,190,763,611,190,,,0,0,0,,,,,,
763,611,195,763,611,196,,,0,0,-1,,,,,,
763,611,204,763,611,203,,,0,0,1,,,,,,
763,611,214,763,611,215,,,0,0,-1,,,,,,
763,611,227,763,611,227,,,0,0,0,,,,,,
763,611,241,763,611,242,,,0,0,-1,,,,,,
763,612,257,763,611,257,,,0,1,0,,,,,,
763,612,275,763,611,275,,,0,1,0,,,,,,
763,612,293,763,612,293,,,0,0,0,,,,,,
764,612,313,763,612,313,,,1,0,0,,,,,,
764,612,333,764,612,333,,,0,0,0,,,,,,
764,612,354,764,612,354,,,0,0,0,,,,,,
764,613,375,764,612,375,,,0,1,0,,,,,,
764,613,397,764,613,397,,,0,0,0,,,,,,
764,613,419,764,613,419,,,0,0,0,,,,,,
765,614,442,764,613,442,,,1,1,0,,,,,,
765,614,465,765,613,464,,,0,1,1,,,,,,
765,614,488,765,614,487,,,0,0,1,,,,,,
766,615,511,765,614,511,,,1,1,0,,,,,,
766,615,535,766,615,535,,,0,0,0,,,,,,
766,615,559,766,615,559,,,0,0,0,,,,,,
766,616,583,766,616,583,,,0,0,0,,,,,,
767,616,607,767,616,607,,,0,0,0,,,,,,
767,617,631,767,617,631,,,0,0,0,,,,,,
768,617,655,768,617,655,,,0,0,0,,,,,,
768,618,680,768,618,680,,,0,0,0,,,,,,
768,618,704,768,618,704,,,0,0,0,,,,,,
769,619,729,769,619,729,,,0,0,0,,,,,,
769,620,754,769,620,754,,,0,0,0,,,,,,
770,620,779,770,620,778,,,0,0,1,,,,,,
769,639,192,769,639,192,,,0,0,0,,,,,,
769,639,193,769,639,192,,,0,0,1,,,,,,
769,639,196,769,639,196,,,0,0,0,,,,,,
769,639,202,769,639,202,,,0,0,0,,,,,,
769,639,209,769,639,209,,,0,0,0,,,,,,
769,639,220,769,639,220,,,0,0,0,,,,,,
769,639,232,769,639,232,,,0,0,0,,,,,,
770,639,246,769,639,247,,,1,0,-1,,,,,,
770,639,262,770,639,262,,,0,0,0,,,,,,
770,639,279,770,639,279,,,0,0,0,,,,,,
770,640,297,770,640,297,,,0,0,0,,,,,,
770,640,316,770,640,316,,,0,0,0,,,,,,
770,640,336,770,640,336,,,0,0,0,,,,,,
770,640,357,770,640,357,,,0,0,0,,,,,,
770,640,378,770,640,378,,,0,0,0,,,,,,
771,641,400,770,640,400,,,1,1,0,,,,,,
771,641,422,771,641,422,,,0,0,0,,,,,,
771,641,444,771,641,444,,,0,0,0,,,,,,
771,641,467,771,641,467,,,0,0,0,,,,,,
772,642,490,771,641,490,,,1,1,0,,,,,,
772,642,513,772,642,513,,,0,0,0,,,,,,
772,643,537,772,642,537,,,0,1,0,,,,,,
773,643,561,773,643,561,,,0,0,0,,,,,,
773,643,584,773,643,585,,,0,0,-1,,,,,,
773,644,609,773,644,609,,,0,0,0,,,,,,
774,644,633,773,644,633,,,1,0,0,,,,,,
774,645,657,774,645,657,,,0,0,0,,,,,,
774,645,681,774,645,681,,,0,0,0,,,,,,
775,646,706,775,646,706,,,0,0,0,,,,,,
775,646,731,775,646,730,,,0,0,1,,,,,,
776,647,755,776,647,755,,,0,0,0,,,,,,
776,648,780,776,647,780,,,0,1,0,,,,,,
776,667,199,776,667,198,,,0,0,1,,,,,,
776,667,200,776,667,198,,,0,0,2,,,,,,
776,667,202,776,667,202,,,0,0,0,,,,,,
776,667,208,776,667,209,,,0,0,-1,,,,,,
776,667,215,776,667,215,,,0,0,0,,,,,,
776,667,225,776,667,226,,,0,0,-1,,,,,,
776,667,237,776,667,237,,,0,0,0,,,,,,
776,667,251,776,667,252,,,0,0,-1,,,,,,
776,667,267,776,667,267,,,0,0,0,,,,,,
776,667,283,776,667,284,,,0,0,-1,,,,,,
777,667,301,777,667,301,,,0,0,0,,,,,,
777,668,320,777,667,320,,,0,1,0,,,,,,
777,668,340,777,668,340,,,0,0,0,,,,,,
777,668,360,777,668,360,,,0,0,0,,,,,,
777,668,381,777,668,381,,,0,0,0,,,,,,
777,668,403,777,668,403,,,0,0,0,,,,,,
778,669,425,778,669,425,,,0,0,0,,,,,,
778,669,447,778,669,447,,,0,0,0,,,,,,
778,669,470,778,669,469,,,0,0,1,,,,,,
778,670,492,778,669,492,,,0,1,0,,,,,,
779,670,516,779,670,515,,,0,0,1,,,,,,
779,670,539,779,670,539,,,0,0,0,,,,,,
779,671,563,779,671,563,,,0,0,0,,,,,,
780,671,586,779,671,586,,,1,0,0,,,,,,
780,671,610,780,671,610,,,0,0,0,,,,,,
780,672,634,780,672,634,,,0,0,0,,,,,,
781,672,659,781,672,658,,,0,0,1,,,,,,
781,673,683,781,673,683,,,0,0,0,,,,,,
781,673,707,781,673,707,,,0,0,0,,,,,,
782,674,732,782,674,732,,,0,0,0,,,,,,
782,675,757,782,674,756,,,0,1,1,,,,,,
783,675,782,783,675,781,,,0,0,1,,,,,,
783,695,205,783,695,205,,,0,0,0,,,,,,
783,695,206,783,695,205,,,0,0,1,,,,,,
783,695,209,783,695,209,,,0,0,0,,,,,,
783,695,214,783,695,215,,,0,0,-1,,,,,,
783,695,222,783,695,222,,,0,0,0,,,,,,
783,695,231,783,695,232,,,0,0,-1,,,,,,
783,695,243,783,695,243,,,0,0,0,,,,,,
783,695,256,783,695,257,,,0,0,-1,,,,,,
783,695,272,783,695,272,,,0,0,0,,,,,,
783,695,288,783,695,289,,,0,0,-1,,,,,,
784,695,306,784,695,306,,,0,0,0,,,,,,
784,696,324,784,695,325,,,0,1,-1,,,,,,
784,696,344,784,696,344,,,0,0,0,,,,,,
784,696,364,784,696,364,,,0,0,0,,,,,,
784,696,385,784,696,385,,,0,0,0,,,,,,
784,696,406,784,696,406,,,0,0,0,,,,,,
785,697,428,785,697,428,,,0,0,0,,,,,,
785,697,450,785,697,450,,,0,0,0,,,,,,
785,697,472,785,697,472,,,0,0,0,,,,,,
785,697,495,785,697,495,,,0,0,0,,,,,,
786,698,518,786,698,518,,,0,0,0,,,,,,
786,698,541,786,698,541,,,0,0,0,,,,,,
786,699,565,786,699,565,,,0,0,0,,,,,,
786,699,588,786,699,588,,,0,0,0,,,,,,
787,699,612,787,699,612,,,0,0,0,,,,,,
787,700,636,787,699,636,,,0,1,0,,,,,,
788,700,660,788,700,660,,,0,0,0,,,,,,
788,701,685,788,700,684,,,0,1,1,,,,,,
788,701,709,788,701,709,,,0,0,0,,,,,,
789,702,734,788,701,733,,,1,1,1,,,,,,
789,702,758,789,702,758,,,0,0,0,,,,,,
790,703,783,789,702,783,,,1,1,0,,,,,,
790,723,212,790,723,212,,,0,0,0,,,,,,
790,723,213,790,723,212,,,0,0,1,,,,,,
790,723,216,790,723,215,,,0,0,1,,,,,,
790,723,221,790,723,221,,,0,0,0,,,,,,
790,723,228,790,723,228,,,0,0,0,,,,,,
790,723,237,790,723,238,,,0,0,-1,,,,,,
790,723,249,790,723,248,,,0,0,1,,,,,,
791,723,262,790,723,262,,,1,0,0,,,,,,
791,723,277,790,723,277,,,1,0,0,,,,,,
791,723,293,790,723,293,,,1,0,0,,,,,,
791,724,310,791,723,310,,,0,1,0,,,,,,
791,724,328,791,723,329,,,0,1,-1,,,,,,
791,724,347,791,724,347,,,0,0,0,,,,,,
791,724,367,791,724,367,,,0,0,0,,,,,,
791,724,388,791,724,388,,,0,0,0,,,,,,
792,725,409,791,724,409,,,1,1,0,,,,,,
792,725,431,792,725,431,,,0,0,0,,,,,,
792,725,453,792,725,453,,,0,0,0,,,,,,
792,725,475,792,725,475,,,0,0,0,,,,,,
793,726,497,792,725,497,,,1,1,0,,,,,,
793,726,520,793,726,520,,,0,0,0,,,,,,
793,726,544,793,726,543,,,0,0,1,,,,,,
793,727,567,793,727,567,,,0,0,0,,,,,,
794,727,591,794,727,590,,,0,0,1,,,,,,
794,727,614,794,727,614,,,0,0,0,,,,,,
794,728,638,794,727,638,,,0,1,0,,,,,,
795,728,662,795,728,662,,,0,0,0,,,,,,
795,729,687,795,728,686,,,0,1,1,,,,,,
796,729,711,795,729,711,,,1,0,0,,,,,,
796,730,735,796,729,735,,,0,1,0,,,,,,
796,730,760,796,730,760,,,0,0,0,,,,,,
797,731,785,797,730,784,,,0,1,1,,,,,,
798,751,219,798,751,219,,,0,0,0,,,,,,
798,751,220,798,751,219,,,0,0,1,,,,,,
798,751,222,798,751,222,,,0,0,0,,,,,,
798,751,227,798,751,228,,,0,0,-1,,,,,,
798,751,234,798,751,234,,,0,0,0,,,,,,
798,751,243,798,751,244,,,0,0,-1,,,,,,
798,751,254,798,751,254,,,0,0,0,,,,,,
798,752,267,798,751,268,,,0,1,-1,,,,,,
798,752,282,798,752,282,,,0,0,0,,,,,,
798,752,297,798,752,298,,,0,0,-1,,,,,,
798,752,315,798,752,315,,,0,0,0,,,,,,
799,752,333,798,752,333,,,1,0,0,,,,,,
799,752,351,799,752,351,,,0,0,0,,,,,,
799,752,371,799,752,371,,,0,0,0,,,,,,
799,753,391,799,753,391,,,0,0,0,,,,,,
799,753,412,799,753,412,,,0,0,0,,,,,,
799,753,434,799,753,434,,,0,0,0,,,,,,
800,753,456,799,753,456,,,1,0,0,,,,,,
800,754,478,800,754,478,,,0,0,0,,,,,,
800,754,500,800,754,500,,,0,0,0,,,,,,
800,754,523,800,754,523,,,0,0,0,,,,,,
801,754,546,800,754,546,,,1,0,0,,,,,,
801,755,569,801,755,569,,,0,0,0,,,,,,
801,755,593,801,755,592,,,0,0,1,,,,,,
802,755,616,802,755,616,,,0,0,0,,,,,,
802,756,640,802,755,640,,,0,1,0,,,,,,
802,756,664,802,756,664,,,0,0,0,,,,,,
803,757,688,802,756,688,,,1,1,0,,,,,,
803,757,713,803,757,713,,,0,0,0,,,,,,
804,758,737,803,757,737,,,1,1,0,,,,,,
804,758,762,804,758,762,,,0,0,0,,,,,,
804,759,786,804,758,786,,,0,1,0,,,,,,
806,780,226,806,779,226,,,0,1,0,,,,,,
806,780,227,806,779,226,,,0,1,1,,,,,,
806,780,229,806,779,229,,,0,1,0,,,,,,
806,780,234,806,779,234,,,0,1,0,,,,,,
806,780,241,806,779,240,,,0,1,1,,,,,,
806,780,249,806,779,250,,,0,1,-1,,,,,,
806,780,260,806,779,260,,,0,1,0,,,,,,
806,780,273,806,780,273,,,0,0,0,,,,,,
806,780,287,806,780,287,,,0,0,0,,,,,,
806,780,302,806,780,303,,,0,0,-1,,,,,,
806,780,319,806,780,319,,,0,0,0,,,,,,
806,780,337,806,780,337,,,0,0,0,,,,,,
807,781,356,807,780,355,,,0,1,1,,,,,,
807,781,375,807,780,375,,,0,1,0,,,,,,
807,781,395,807,781,395,,,0,0,0,,,,,,
807,781,416,807,781,416,,,0,0,0,,,,,,
807,781,437,807,781,437,,,0,0,0,,,,,,
807,782,459,807,781,459,,,0,1,0,,,,,,
808,782,481,808,782,481,,,0,0,0,,,,,,
808,782,503,808,782,503,,,0,0,0,,,,,,
808,782,526,808,782,525,,,0,0,1,,,,,,
808,783,549,808,782,548,,,0,1,1,,,,,,
809,783,572,809,783,571,,,0,0,1,,,,,,
809,783,595,809,783,595,,,0,0,0,,,,,,
809,784,619,809,783,618,,,0,1,1,,,,,,
810,784,642,809,784,642,,,1,0,0,,,,,,
810,785,666,810,784,666,,,0,1,0,,,,,,
811,785,690,810,785,690,,,1,0,0,,,,,,
811,785,715,811,785,715,,,0,0,0,,,,,,
811,786,739,811,786,739,,,0,0,0,,,,,,
812,786,763,812,786,763,,,0,0,0,,,,,,
812,787,788,812,787,788,,,0,0,0,,,,,,
814,808,233,814,808,233,,,0,0,0,,,,,,
814,808,234,814,808,233,,,0,0,1,,,,,,
814,808,236,814,808,236,,,0,0,0,,,,,,
814,808,241,814,808,241,,,0,0,0,,,,,,
814,808,247,814,808,247,,,0,0,0,,,,,,
814,808,256,814,808,256,,,0,0,0,,,,,,
814,808,266,814,808,266,,,0,0,0,,,,,,
814,809,278,814,808,279,,,0,1,-1,,,,,,
814,809,292,814,809,292,,,0,0,0,,,,,,
814,809,308,814,809,308,,,0,0,0,,,,,,
814,809,324,814,809,324,,,0,0,0,,,,,,
814,809,341,814,809,342,,,0,0,-1,,,,,,
815,809,360,815,809,360,,,0,0,0,,,,,,
815,809,379,815,809,379,,,0,0,0,,,,,,
815,809,399,815,809,399,,,0,0,0,,,,,,
815,810,419,815,809,419,,,0,1,0,,,,,,
815,810,440,815,810,440,,,0,0,0,,,,,,
816,810,462,815,810,462,,,1,0,0,,,,,,
816,810,484,816,810,484,,,0,0,0,,,,,,
816,811,506,816,810,506,,,0,1,0,,,,,,
816,811,528,816,811,528,,,0,0,0,,,,,,
817,811,551,816,811,551,,,1,0,0,,,,,,
817,811,574,817,811,574,,,0,0,0,,,,,,
817,812,598,817,811,597,,,0,1,1,,,,,,
817,812,621,817,812,621,,,0,0,0,,,,,,
818,813,645,817,812,644,,,1,1,1,,,,,,
818,813,668,818,813,668,,,0,0,0,,,,,,
819,813,692,818,813,692,,,1,0,0,,,,,,
819,814,717,819,814,717,,,0,0,0,,,,,,
819,814,741,819,814,741,,,0,0,0,,,,,,
820,815,765,820,815,765,,,0,0,0,,,,,,
820,815,790,820,815,789,,,0,0,1,,,,,,
822,837,240,822,837,240,,,0,0,0,,,,,,
822,837,241,822,837,240,,,0,0,1,,,,,,
822,837,243,822,837,243,,,0,0,0,,,,,,
822,837,247,822,837,248,,,0,0,-1,,,,,,
822,837,254,822,837,253,,,0,0,1,,,,,,
822,837,262,822,837,263,,,0,0,-1,,,,,,
822,837,272,822,837,272,,,0,0,0,,,,,,
822,837,284,822,837,285,,,0,0,-1,,,,,,
822,837,298,822,837,297,,,0,0,1,,,,,,
823,837,313,822,837,313,,,1,0,0,,,,,,
823,837,329,822,837,329,,,1,0,0,,,,,,
823,838,346,823,837,346,,,0,1,0,,,,,,
823,838,364,823,837,364,,,0,1,0,,,,,,
823,838,383,823,837,383,,,0,1,0,,,,,,
823,838,403,823,838,403,,,0,0,0,,,,,,
823,838,423,823,838,423,,,0,0,0,,,,,,
824,838,444,823,838,444,,,1,0,0,,,,,,
824,839,465,824,838,465,,,0,1,0,,,,,,
824,839,487,824,839,487,,,0,0,0,,,,,,
824,839,509,824,839,509,,,0,0,0,,,,,,
825,839,531,824,839,531,,,1,0,0,,,,,,
825,840,554,825,839,554,,,0,1,0,,,,,,
825,840,577,825,840,577,,,0,0,0,,,,,,
825,840,600,825,840,600,,,0,0,0,,,,,,
826,841,623,825,840,623,,,1,1,0,,,,,,
826,841,647,826,841,647,,,0,0,0,,,,,,
826,841,671,826,841,670,,,0,0,1,,,,,,
827,842,695,827,842,694,,,0,0,1,,,,,,
827,842,719,827,842,719,,,0,0,0,,,,,,
828,843,743,828,843,743,,,0,0,0,,,,,,
828,843,767,828,843,767,,,0,0,0,,,,,,
829,843,791,829,843,791,,,0,0,0,,,,,,
831,866,247,831,866,247,,,0,0,0,,,,,,
831,866,248,831,866,247,,,0,0,1,,,,,,
831,866,250,831,866,250,,,0,0,0,,,,,,
831,866,254,831,866,255,,,0,0,-1,,,,,,
831,866,260,831,866,260,,,0,0,0,,,,,,
831,866,269,831,866,269,,,0,0,0,,,,,,
831,866,279,831,866,279,,,0,0,0,,,,,,
831,866,290,831,866,291,,,0,0,-1,,,,,,
831,866,303,831,866,303,,,0,0,0,,,,,,
831,866,318,831,866,318,,,0,0,0,,,,,,
831,866,334,831,866,334,,,0,0,0,,,,,,
831,866,351,831,866,351,,,0,0,0,,,,,,
832,866,369,832,866,369,,,0,0,0,,,,,,
832,867,387,832,866,388,,,0,1,-1,,,,,,
832,867,407,832,867,407,,,0,0,0,,,,,,
832,867,427,832,867,427,,,0,0,0,,,,,,
832,867,448,832,867,448,,,0,0,0,,,,,,
832,867,469,832,867,469,,,0,0,0,,,,,,
833,868,490,833,868,490,,,0,0,0,,,,,,
833,868,512,833,868,512,,,0,0,0,,,,,,
833,868,534,833,868,534,,,0,0,0,,,,,,
833,868,557,833,868,557,,,0,0,0,,,,,,
834,869,580,834,869,580,,,0,0,0,,,,,,
834,869,603,834,869,603,,,0,0,0,,,,,,
834,869,626,834,869,626,,,0,0,0,,,,,,
835,870,649,834,869,649,,,1,1,0,,,,,,
835,870,673,835,870,673,,,0,0,0,,,,,,
835,870,697,835,870,697,,,0,0,0,,,,,,
836,871,721,836,871,721,,,0,0,0,,,,,,
836,871,745,836,871,745,,,0,0,0,,,,,,
837,872,769,837,872,769,,,0,0,0,,,,,,
837,872,793,837,872,793,,,0,0,0,,,,,,
840,894,254,840,894,254,,,0,0,0,,,,,,
840,894,255,840,894,254,,,0,0,1,,,,,,
840,894,257,840,894,257,,,0,0,0,,,,,,
840,895,261,840,894,262,,,0,1,-1,,,,,,
840,895,267,840,894,267,,,0,1,0,,,,,,
840,895,275,840,894,276,,,0,1,-1,,,,,,
840,895,285,840,895,285,,,0,0,0,,,,,,
840,895,296,840,895,297,,,0,0,-1,,,,,,
840,895,309,840,895,309,,,0,0,0,,,,,,
840,895,324,840,895,324,,,0,0,0,,,,,,
840,895,339,840,895,339,,,0,0,0,,,,,,
840,895,356,840,895,356,,,0,0,0,,,,,,
840,895,373,841,895,373,,,-1,0,0,,,,,,
841,895,392,841,895,392,,,0,0,0,,,,,,
841,896,411,841,895,411,,,0,1,0,,,,,,
841,896,431,841,895,431,,,0,1,0,,,,,,
841,896,451,841,896,451,,,0,0,0,,,,,,
841,896,472,841,896,472,,,0,0,0,,,,,,
842,896,494,842,896,493,,,0,0,1,,,,,,
842,897,515,842,896,515,,,0,1,0,,,,,,
842,897,537,842,897,537,,,0,0,0,,,,,,
842,897,560,842,897,559,,,0,0,1,,,,,,
843,897,582,843,897,582,,,0,0,0,,,,,,
843,898,605,843,897,605,,,0,1,0,,,,,,
843,898,628,843,898,628,,,0,0,0,,,,,,
844,898,652,843,898,652,,,1,0,0,,,,,,
844,899,675,844,898,675,,,0,1,0,,,,,,
844,899,699,844,899,699,,,0,0,0,,,,,,
845,899,723,845,899,723,,,0,0,0,,,,,,
845,900,747,845,900,747,,,0,0,0,,,,,,
845,900,771,845,900,771,,,0,0,0,,,,,,
846,901,795,846,900,795,,,0,1,0,,,,,,
728,201,110,728,201,110,,,0,0,0,,,,,,
728,201,112,728,201,110,,,0,0,2,,,,,,
728,202,117,728,201,117,,,0,1,0,,,,,,
728,202,127,728,201,128,,,0,1,-1,,,,,,
728,202,140,728,202,139,,,0,0,1,,,,,,
729,202,155,728,202,156,,,1,0,-1,,,,,,
729,202,173,729,202,172,,,0,0,1,,,,,,
729,203,192,729,202,192,,,0,1,0,,,,,,
729,203,212,729,203,212,,,0,0,0,,,,,,
729,204,234,729,203,233,,,0,1,1,,,,,,
729,204,255,729,204,255,,,0,0,0,,,,,,
729,205,278,729,204,278,,,0,1,0,,,,,,
729,205,301,729,205,300,,,0,0,1,,,,,,
729,206,324,729,206,323,,,0,0,1,,,,,,
730,207,347,730,207,347,,,0,0,0,,,,,,
730,208,371,730,207,371,,,0,1,0,,,,,,
730,209,395,730,208,395,,,0,1,0,,,,,,
730,210,419,730,209,419,,,0,1,0,,,,,,
731,211,443,731,211,443,,,0,0,0,,,,,,
731,212,467,731,212,467,,,0,0,0,,,,,,
731,213,492,731,213,492,,,0,0,0,,,,,,
731,215,516,731,214,516,,,0,1,0,,,,,,
732,216,541,732,216,541,,,0,0,0,,,,,,
732,217,566,732,217,566,,,0,0,0,,,,,,
733,219,591,732,219,591,,,1,0,0,,,,,,
733,221,616,732,220,615,,,1,1,1,,,,,,
733,222,641,733,222,640,,,0,0,1,,,,,,
734,224,666,733,224,665,,,1,0,1,,,,,,
734,226,691,734,226,691,,,0,0,0,,,,,,
735,227,716,734,227,716,,,1,0,0,,,,,,
735,229,741,735,229,741,,,0,0,0,,,,,,
736,231,767,735,231,767,,,1,0,0,,,,,,
728,202,110,728,201,110,,,0,1,0,,,,,,
728,203,112,728,201,110,,,0,2,2,,,,,,
728,203,117,728,201,117,,,0,2,0,,,,,,
729,203,127,728,201,128,,,1,2,-1,,,,,,
729,203,140,728,202,139,,,1,1,1,,,,,,
729,203,155,728,202,156,,,1,1,-1,,,,,,
729,203,173,729,202,172,,,0,1,1,,,,,,
729,204,192,729,202,192,,,0,2,0,,,,,,
729,204,212,729,203,212,,,0,1,0,,,,,,
729,205,234,729,203,233,,,0,2,1,,,,,,
729,205,255,729,204,255,,,0,1,0,,,,,,
729,206,278,729,204,278,,,0,2,0,,,,,,
729,206,301,729,205,300,,,0,1,1,,,,,,
730,207,324,729,206,323,,,1,1,1,,,,,,
730,208,347,730,207,347,,,0,1,0,,,,,,
730,209,371,730,207,371,,,0,2,0,,,,,,
730,210,395,730,208,395,,,0,2,0,,,,,,
730,211,419,730,209,419,,,0,2,0,,,,,,
731,212,443,731,211,443,,,0,1,0,,,,,,
731,213,467,731,212,467,,,0,1,0,,,,,,
731,214,492,731,213,492,,,0,1,0,,,,,,
732,216,517,731,214,516,,,1,2,1,,,,,,
732,217,541,732,216,541,,,0,1,0,,,,,,
732,218,566,732,217,566,,,0,1,0,,,,,,
733,220,591,732,219,591,,,1,1,0,,,,,,
733,221,616,732,220,615,,,1,1,1,,,,,,
733,223,641,733,222,640,,,0,1,1,,,,,,
734,225,666,733,224,665,,,1,1,1,,,,,,
734,227,691,734,226,691,,,0,1,0,,,,,,
735,228,716,734,227,716,,,1,1,0,,,,,,
735,230,742,735,229,741,,,0,1,1,,,,,,
736,232,767,735,231,767,,,1,1,0,,,,,,
729,206,111,729,206,111,,,0,0,0,,,,,,
729,206,112,729,206,111,,,0,0,1,,,,,,
729,206,118,729,206,118,,,0,0,0,,,,,,
729,207,127,729,206,129,,,0,1,-2,,,,,,
729,207,140,729,206,140,,,0,1,0,,,,,,
729,207,156,729,207,156,,,0,0,0,,,,,,
729,207,173,729,207,173,,,0,0,0,,,,,,
729,208,192,729,207,193,,,0,1,-1,,,,,,
729,208,213,729,207,213,,,0,1,0,,,,,,
729,208,234,729,208,234,,,0,0,0,,,,,,
729,209,256,729,208,255,,,0,1,1,,,,,,
729,210,278,729,209,278,,,0,1,0,,,,,,
730,210,301,730,210,300,,,0,0,1,,,,,,
730,211,324,730,211,324,,,0,0,0,,,,,,
730,212,347,730,211,347,,,0,1,0,,,,,,
730,213,371,730,212,371,,,0,1,0,,,,,,
730,214,395,730,213,395,,,0,1,0,,,,,,
731,215,419,730,214,419,,,1,1,0,,,,,,
731,216,443,731,215,443,,,0,1,0,,,,,,
731,217,468,731,216,467,,,0,1,1,,,,,,
732,218,492,732,218,492,,,0,0,0,,,,,,
732,219,517,732,219,516,,,0,0,1,,,,,,
732,221,541,732,221,541,,,0,0,0,,,,,,
733,222,566,732,222,566,,,1,0,0,,,,,,
733,223,591,733,223,591,,,0,0,0,,,,,,
733,225,616,733,225,615,,,0,0,1,,,,,,
734,227,641,734,226,640,,,0,1,1,,,,,,
734,228,666,734,228,666,,,0,0,0,,,,,,
735,230,691,734,230,691,,,1,0,0,,,,,,
735,232,716,735,231,716,,,0,1,0,,,,,,
735,234,742,735,233,741,,,0,1,1,,,,,,
736,235,767,736,235,767,,,0,0,0,,,,,,
729,213,112,729,215,112,,,0,-2,0,,,,,,
729,213,113,729,215,112,,,0,-2,1,,,,,,
729,213,119,729,215,119,,,0,-2,0,,,,,,
729,214,128,729,215,130,,,0,-1,-2,,,,,,
729,214,141,729,215,141,,,0,-1,0,,,,,,
729,214,156,729,215,157,,,0,-1,-1,,,,,,
729,214,174,729,215,174,,,0,-1,0,,,,,,
730,214,193,729,216,193,,,1,-2,0,,,,,,
730,215,213,729,216,213,,,1,-1,0,,,,,,
730,215,234,729,216,234,,,1,-1,0,,,,,,
730,216,256,730,217,256,,,0,-1,0,,,,,,
730,216,278,730,218,278,,,0,-2,0,,,,,,
730,217,301,730,218,301,,,0,-1,0,,,,,,
730,218,324,730,219,324,,,0,-1,0,,,,,,
731,219,348,730,220,347,,,1,-1,1,,,,,,
731,219,371,730,220,371,,,1,-1,0,,,,,,
731,220,395,731,221,395,,,0,-1,0,,,,,,
731,221,419,731,222,419,,,0,-1,0,,,,,,
731,222,443,731,223,443,,,0,-1,0,,,,,,
732,223,468,732,225,467,,,0,-2,1,,,,,,
732,225,492,732,226,492,,,0,-1,0,,,,,,
732,226,517,732,227,516,,,0,-1,1,,,,,,
733,227,541,732,228,541,,,1,-1,0,,,,,,
733,228,566,733,230,566,,,0,-2,0,,,,,,
733,230,591,733,231,591,,,0,-1,0,,,,,,
734,231,616,734,232,616,,,0,-1,0,,,,,,
734,233,641,734,234,641,,,0,-1,0,,,,,,
735,235,666,734,236,666,,,1,-1,0,,,,,,
735,236,691,735,237,691,,,0,-1,0,,,,,,
736,238,716,735,239,716,,,1,-1,0,,,,,,
736,240,742,736,241,741,,,0,-1,1,,,,,,
737,242,767,736,242,767,,,1,0,0,,,,,,
730,223,113,730,223,113,,,0,0,0,,,,,,
730,223,115,730,223,113,,,0,0,2,,,,,,
730,223,120,730,223,120,,,0,0,0,,,,,,
730,224,129,730,223,131,,,0,1,-2,,,,,,
730,224,142,730,224,142,,,0,0,0,,,,,,
730,224,157,730,224,158,,,0,0,-1,,,,,,
730,224,175,730,224,174,,,0,0,1,,,,,,
730,224,194,730,224,194,,,0,0,0,,,,,,
730,225,214,730,225,214,,,0,0,0,,,,,,
730,225,235,730,225,235,,,0,0,0,,,,,,
731,226,256,731,226,256,,,0,0,0,,,,,,
731,226,279,731,226,279,,,0,0,0,,,,,,
731,227,301,731,227,301,,,0,0,0,,,,,,
731,228,325,731,227,324,,,0,1,1,,,,,,
731,228,348,731,228,348,,,0,0,0,,,,,,
731,229,372,731,229,371,,,0,0,1,,,,,,
732,230,395,732,230,395,,,0,0,0,,,,,,
732,231,419,732,231,419,,,0,0,0,,,,,,
732,232,444,732,232,444,,,0,0,0,,,,,,
732,233,468,732,233,468,,,0,0,0,,,,,,
733,234,492,733,234,492,,,0,0,0,,,,,,
733,235,517,733,235,517,,,0,0,0,,,,,,
733,236,542,733,236,541,,,0,0,1,,,,,,
734,238,566,733,238,566,,,1,0,0,,,,,,
734,239,591,734,239,591,,,0,0,0,,,,,,
735,241,616,734,240,616,,,1,1,0,,,,,,
735,242,641,735,242,641,,,0,0,0,,,,,,
735,244,666,735,243,666,,,0,1,0,,,,,,
736,245,691,736,245,691,,,0,0,0,,,,,,
736,247,717,736,247,716,,,0,0,1,,,,,,
737,249,742,737,248,741,,,0,1,1,,,,,,
737,250,767,737,250,767,,,0,0,0,,,,,,
731,236,115,731,237,115,,,0,-1,0,,,,,,
731,236,116,731,237,115,,,0,-1,1,,,,,,
731,236,121,731,237,121,,,0,-1,0,,,,,,
731,236,131,731,237,132,,,0,-1,-1,,,,,,
731,237,143,731,238,143,,,0,-1,0,,,,,,
731,237,158,731,238,159,,,0,-1,-1,,,,,,
731,237,176,731,238,176,,,0,-1,0,,,,,,
731,237,194,731,238,195,,,0,-1,-1,,,,,,
731,238,215,731,239,215,,,0,-1,0,,,,,,
732,238,236,731,239,236,,,1,-1,0,,,,,,
732,238,257,732,240,257,,,0,-2,0,,,,,,
732,239,279,732,240,279,,,0,-1,0,,,,,,
732,240,302,732,241,302,,,0,-1,0,,,,,,
732,240,325,732,241,325,,,0,-1,0,,,,,,
732,241,348,732,242,348,,,0,-1,0,,,,,,
732,242,372,732,243,372,,,0,-1,0,,,,,,
733,242,396,733,243,395,,,0,-1,1,,,,,,
733,243,420,733,244,419,,,0,-1,1,,,,,,
733,244,444,733,245,444,,,0,-1,0,,,,,,
734,245,468,733,246,468,,,1,-1,0,,,,,,
734,246,493,734,247,492,,,0,-1,1,,,,,,
734,247,517,734,248,517,,,0,-1,0,,,,,,
734,249,542,734,249,542,,,0,0,0,,,,,,
735,250,567,735,251,566,,,0,-1,1,,,,,,
735,251,592,735,252,591,,,0,-1,1,,,,,,
736,252,616,735,253,616,,,1,-1,0,,,,,,
736,254,641,736,255,641,,,0,-1,0,,,,,,
736,255,667,736,256,666,,,0,-1,1,,,,,,
737,257,692,737,258,691,,,0,-1,1,,,,,,
737,258,717,737,259,716,,,0,-1,1,,,,,,
738,260,742,738,261,742,,,0,-1,0,,,,,,
738,262,767,738,263,767,,,0,-1,0,,,,,,
732,252,117,732,252,117,,,0,0,0,,,,,,
732,252,118,732,252,117,,,0,0,1,,,,,,
732,252,124,732,252,123,,,0,0,1,,,,,,
732,252,132,732,252,134,,,0,0,-2,,,,,,
732,252,145,732,252,145,,,0,0,0,,,,,,
732,252,160,732,252,161,,,0,0,-1,,,,,,
733,252,177,732,252,177,,,1,0,0,,,,,,
733,253,196,732,252,196,,,1,1,0,,,,,,
733,253,216,733,253,216,,,0,0,0,,,,,,
733,253,236,733,253,237,,,0,0,-1,,,,,,
733,254,258,733,254,258,,,0,0,0,,,,,,
733,254,280,733,254,280,,,0,0,0,,,,,,
733,255,303,733,255,302,,,0,0,1,,,,,,
733,255,326,733,255,325,,,0,0,1,,,,,,
734,256,349,734,256,349,,,0,0,0,,,,,,
734,257,373,734,256,372,,,0,1,1,,,,,,
734,257,396,734,257,396,,,0,0,0,,,,,,
734,258,420,734,258,420,,,0,0,0,,,,,,
735,259,444,734,259,444,,,1,0,0,,,,,,
735,260,469,734,260,468,,,1,0,1,,,,,,
735,261,493,735,261,493,,,0,0,0,,,,,,
735,262,518,735,262,517,,,0,0,1,,,,,,
736,263,542,736,263,542,,,0,0,0,,,,,,
736,264,567,736,264,567,,,0,0,0,,,,,,
736,266,592,736,265,592,,,0,1,0,,,,,,
737,267,617,737,267,616,,,0,0,1,,,,,,
737,268,642,737,268,641,,,0,0,1,,,,,,
738,269,667,737,269,666,,,1,0,1,,,,,,
738,271,692,738,271,691,,,0,0,1,,,,,,
739,272,717,738,272,717,,,1,0,0,,,,,,
739,274,742,739,274,742,,,0,0,0,,,,,,
740,276,768,739,275,767,,,1,1,1,,,,,,
734,269,120,734,270,119,,,0,-1,1,,,,,,
734,269,121,734,270,119,,,0,-1,2,,,,,,
734,269,126,734,270,126,,,0,-1,0,,,,,,
734,269,135,734,270,136,,,0,-1,-1,,,,,,
734,269,147,734,270,147,,,0,-1,0,,,,,,
734,269,162,734,270,163,,,0,-1,-1,,,,,,
734,270,179,734,270,179,,,0,0,0,,,,,,
734,270,197,734,270,198,,,0,0,-1,,,,,,
734,270,217,734,271,217,,,0,-1,0,,,,,,
734,271,238,734,271,238,,,0,0,0,,,,,,
735,271,259,734,272,259,,,1,-1,0,,,,,,
735,271,281,734,272,281,,,1,-1,0,,,,,,
735,272,304,735,273,303,,,0,-1,1,,,,,,
735,272,327,735,273,326,,,0,-1,1,,,,,,
735,273,350,735,274,350,,,0,-1,0,,,,,,
735,274,373,735,274,373,,,0,0,0,,,,,,
736,274,397,735,275,397,,,1,-1,0,,,,,,
736,275,421,736,276,421,,,0,-1,0,,,,,,
736,276,445,736,277,445,,,0,-1,0,,,,,,
736,277,469,736,277,469,,,0,0,0,,,,,,
737,278,494,736,278,493,,,1,0,1,,,,,,
737,279,518,737,279,518,,,0,0,0,,,,,,
737,280,543,737,280,543,,,0,0,0,,,,,,
738,281,568,738,281,567,,,0,0,1,,,,,,
738,282,592,738,282,592,,,0,0,0,,,,,,
738,283,617,738,284,617,,,0,-1,0,,,,,,
739,284,642,739,285,642,,,0,-1,0,,,,,,
739,286,667,739,286,667,,,0,0,0,,,,,,
740,287,692,739,288,692,,,1,-1,0,,,,,,
740,288,717,740,289,717,,,0,-1,0,,,,,,
741,290,743,740,291,743,,,1,-1,0,,,,,,
741,291,768,741,292,768,,,0,-1,0,,,,,,
736,288,123,736,288,122,,,0,0,1,,,,,,
736,288,124,736,288,122,,,0,0,2,,,,,,
736,288,129,736,288,128,,,0,0,1,,,,,,
736,288,137,736,288,138,,,0,0,-1,,,,,,
736,289,149,736,288,149,,,0,1,0,,,,,,
736,289,164,736,288,164,,,0,1,0,,,,,,
736,289,181,736,289,180,,,0,0,1,,,,,,
736,289,199,736,289,199,,,0,0,0,,,,,,
736,289,219,736,289,219,,,0,0,0,,,,,,
736,290,239,736,289,239,,,0,1,0,,,,,,
736,290,260,736,290,260,,,0,0,0,,,,,,
737,290,282,736,290,282,,,1,0,0,,,,,,
737,291,305,737,291,304,,,0,0,1,,,,,,
737,291,328,737,291,327,,,0,0,1,,,,,,
737,292,351,737,292,351,,,0,0,0,,,,,,
737,293,374,737,292,374,,,0,1,0,,,,,,
738,293,398,737,293,398,,,1,0,0,,,,,,
738,294,422,737,294,422,,,1,0,0,,,,,,
738,295,446,738,295,446,,,0,0,0,,,,,,
738,296,470,738,295,470,,,0,1,0,,,,,,
739,296,494,738,296,494,,,1,0,0,,,,,,
739,297,519,739,297,519,,,0,0,0,,,,,,
739,298,543,739,298,543,,,0,0,0,,,,,,
740,299,568,739,299,568,,,1,0,0,,,,,,
740,300,593,740,300,592,,,0,0,1,,,,,,
740,301,618,740,301,617,,,0,0,1,,,,,,
741,303,643,740,303,642,,,1,0,1,,,,,,
741,304,668,741,304,667,,,0,0,1,,,,,,
742,305,693,741,305,692,,,1,0,1,,,,,,
742,306,718,742,306,718,,,0,0,0,,,,,,
743,308,743,742,308,743,,,1,0,0,,,,,,
743,309,768,743,309,768,,,0,0,0,,,,,,
738,309,126,738,309,126,,,0,0,0,,,,,,
738,309,127,738,309,126,,,0,0,1,,,,,,
738,309,132,738,309,132,,,0,0,0,,,,,,
738,309,140,738,309,142,,,0,0,-2,,,,,,
738,309,152,738,310,152,,,0,-1,0,,,,,,
738,309,166,738,310,167,,,0,-1,-1,,,,,,
738,310,183,738,310,183,,,0,0,0,,,,,,
738,310,201,738,310,201,,,0,0,0,,,,,,
738,310,220,738,310,220,,,0,0,0,,,,,,
738,310,241,738,310,241,,,0,0,0,,,,,,
739,311,262,739,311,262,,,0,0,0,,,,,,
739,311,284,739,311,284,,,0,0,0,,,,,,
739,311,306,739,312,306,,,0,-1,0,,,,,,
739,312,329,739,312,329,,,0,0,0,,,,,,
739,312,352,739,313,352,,,0,-1,0,,,,,,
739,313,375,739,313,375,,,0,0,0,,,,,,
740,314,399,740,314,399,,,0,0,0,,,,,,
740,314,423,740,315,422,,,0,-1,1,,,,,,
740,315,447,740,315,446,,,0,0,1,,,,,,
740,316,471,740,316,471,,,0,0,0,,,,,,
741,317,495,741,317,495,,,0,0,0,,,,,,
741,317,519,741,318,519,,,0,-1,0,,,,,,
741,318,544,741,318,544,,,0,0,0,,,,,,
742,319,569,741,319,568,,,1,0,1,,,,,,
742,320,593,742,320,593,,,0,0,0,,,,,,
742,321,618,742,322,618,,,0,-1,0,,,,,,
743,322,643,743,323,643,,,0,-1,0,,,,,,
743,323,668,743,324,668,,,0,-1,0,,,,,,
744,325,693,744,325,693,,,0,0,0,,,,,,
744,326,718,744,326,718,,,0,0,0,,,,,,
745,327,743,745,328,744,,,0,-1,-1,,,,,,
745,328,769,745,329,769,,,0,-1,0,,,,,,
741,331,130,740,330,129,,,1,1,1,,,,,,
741,331,131,740,330,129,,,1,1,2,,,,,,
741,331,136,740,331,135,,,1,0,1,,,,,,
741,331,144,740,331,145,,,1,0,-1,,,,,,
741,331,155,740,331,155,,,1,0,0,,,,,,
741,331,169,740,331,170,,,1,0,-1,,,,,,
741,331,185,740,331,185,,,1,0,0,,,,,,
741,332,203,740,331,203,,,1,1,0,,,,,,
741,332,222,740,331,222,,,1,1,0,,,,,,
741,332,243,741,332,242,,,0,0,1,,,,,,
741,332,264,741,332,263,,,0,0,1,,,,,,
741,333,285,741,333,285,,,0,0,0,,,,,,
741,333,307,741,333,307,,,0,0,0,,,,,,
742,334,330,741,334,330,,,1,0,0,,,,,,
742,334,353,741,334,353,,,1,0,0,,,,,,
742,335,376,742,335,376,,,0,0,0,,,,,,
742,335,400,742,335,400,,,0,0,0,,,,,,
742,336,424,742,336,423,,,0,0,1,,,,,,
743,336,448,742,336,447,,,1,0,1,,,,,,
743,337,472,743,337,471,,,0,0,1,,,,,,
743,338,496,743,338,496,,,0,0,0,,,,,,
744,339,520,743,338,520,,,1,1,0,,,,,,
744,339,545,743,339,545,,,1,0,0,,,,,,
744,340,569,744,340,569,,,0,0,0,,,,,,
745,341,594,744,341,594,,,1,0,0,,,,,,
745,342,619,745,342,618,,,0,0,1,,,,,,
745,343,644,745,343,643,,,0,0,1,,,,,,
746,344,669,746,344,668,,,0,0,1,,,,,,
746,345,694,746,345,693,,,0,0,1,,,,,,
747,347,719,747,346,719,,,0,1,0,,,,,,
747,348,744,747,348,744,,,0,0,0,,,,,,
748,349,769,748,349,769,,,0,0,0,,,,,,
743,354,134,743,354,133,,,0,0,1,,,,,,
743,354,135,743,354,133,,,0,0,2,,,,,,
743,354,139,743,354,139,,,0,0,0,,,,,,
743,354,147,743,354,149,,,0,0,-2,,,,,,
743,354,158,743,354,158,,,0,0,0,,,,,,
743,354,172,743,354,173,,,0,0,-1,,,,,,
744,354,188,743,354,188,,,1,0,0,,,,,,
744,354,206,743,354,206,,,1,0,0,,,,,,
744,355,225,743,355,224,,,1,0,1,,,,,,
744,355,245,744,355,245,,,0,0,0,,,,,,
744,355,265,744,355,265,,,0,0,0,,,,,,
744,356,287,744,356,287,,,0,0,0,,,,,,
744,356,309,744,356,309,,,0,0,0,,,,,,
744,356,332,744,357,331,,,0,-1,1,,,,,,
745,357,354,744,357,354,,,1,0,0,,,,,,
745,357,378,744,358,377,,,1,-1,1,,,,,,
745,358,401,745,358,401,,,0,0,0,,,,,,
745,358,425,745,359,424,,,0,-1,1,,,,,,
745,359,449,745,359,448,,,0,0,1,,,,,,
746,360,473,745,360,472,,,1,0,1,,,,,,
746,360,497,746,360,497,,,0,0,0,,,,,,
746,361,521,746,361,521,,,0,0,0,,,,,,
747,362,546,746,362,545,,,1,0,1,,,,,,
747,363,570,747,363,570,,,0,0,0,,,,,,
747,363,595,747,364,594,,,0,-1,1,,,,,,
748,364,620,747,365,619,,,1,-1,1,,,,,,
748,365,644,748,366,644,,,0,-1,0,,,,,,
749,366,669,748,366,669,,,1,0,0,,,,,,
749,367,694,749,367,694,,,0,0,0,,,,,,
749,368,719,749,369,719,,,0,-1,0,,,,,,
750,369,745,750,370,745,,,0,-1,0,,,,,,
750,371,770,750,371,770,,,0,0,0,,,,,,
746,378,138,746,377,138,,,0,1,0,,,,,,
746,378,139,746,377,138,,,0,1,1,,,,,,
746,378,144,746,378,143,,,0,0,1,,,,,,
746,378,151,746,378,152,,,0,0,-1,,,,,,
747,378,162,746,378,162,,,1,0,0,,,,,,
747,378,175,746,378,176,,,1,0,-1,,,,,,
747,378,191,746,378,191,,,1,0,0,,,,,,
747,378,208,746,378,209,,,1,0,-1,,,,,,
747,378,227,747,378,227,,,0,0,0,,,,,,
747,379,247,747,378,247,,,0,1,0,,,,,,
747,379,268,747,379,267,,,0,0,1,,,,,,
747,379,289,747,379,289,,,0,0,0,,,,,,
747,380,311,747,379,310,,,0,1,1,,,,,,
747,380,333,747,380,333,,,0,0,0,,,,,,
748,380,356,747,380,356,,,1,0,0,,,,,,
748,381,379,747,381,379,,,1,0,0,,,,,,
748,381,402,748,381,402,,,0,0,0,,,,,,
748,382,426,748,382,426,,,0,0,0,,,,,,
749,382,450,748,382,450,,,1,0,0,,,,,,
749,383,474,748,383,474,,,1,0,0,,,,,,
749,384,498,749,383,498,,,0,1,0,,,,,,
749,384,522,749,384,522,,,0,0,0,,,,,,
750,385,547,750,385,546,,,0,0,1,,,,,,
750,386,571,750,385,571,,,0,1,0,,,,,,
750,387,596,750,386,595,,,0,1,1,,,,,,
751,387,620,750,387,620,,,1,0,0,,,,,,
751,388,645,751,388,645,,,0,0,0,,,,,,
752,389,670,751,389,670,,,1,0,0,,,,,,
752,390,695,752,390,695,,,0,0,0,,,,,,
753,391,720,752,391,720,,,1,0,0,,,,,,
753,392,745,753,392,745,,,0,0,0,,,,,,
754,393,770,753,393,770,,,1,0,0,,,,,,
750,402,143,750,402,143,,,0,0,0,,,,,,
750,402,144,750,402,143,,,0,0,1,,,,,,
750,402,148,750,402,148,,,0,0,0,,,,,,
750,402,156,750,402,157,,,0,0,-1,,,,,,
750,402,166,750,402,166,,,0,0,0,,,,,,
750,402,179,750,402,180,,,0,0,-1,,,,,,
750,402,194,750,402,194,,,0,0,0,,,,,,
750,403,211,750,402,212,,,0,1,-1,,,,,,
750,403,230,750,403,230,,,0,0,0,,,,,,
750,403,249,750,403,250,,,0,0,-1,,,,,,
750,403,270,750,403,270,,,0,0,0,,,,,,
751,404,291,750,403,291,,,1,1,0,,,,,,
751,404,313,751,404,312,,,0,0,1,,,,,,
751,404,335,751,404,335,,,0,0,0,,,,,,
751,405,358,751,405,357,,,0,0,1,,,,,,
751,405,381,751,405,380,,,0,0,1,,,,,,
752,405,404,751,406,403,,,1,-1,1,,,,,,
752,406,427,751,406,427,,,1,0,0,,,,,,
752,406,451,752,407,451,,,0,-1,0,,,,,,
752,407,475,752,407,475,,,0,0,0,,,,,,
753,408,499,752,408,499,,,1,0,0,,,,,,
753,408,523,753,408,523,,,0,0,0,,,,,,
753,409,548,753,409,547,,,0,0,1,,,,,,
754,410,572,753,410,572,,,1,0,0,,,,,,
754,410,597,754,410,596,,,0,0,1,,,,,,
754,411,621,754,411,621,,,0,0,0,,,,,,
755,412,646,754,412,646,,,1,0,0,,,,,,
755,413,671,755,413,671,,,0,0,0,,,,,,
756,414,696,755,414,696,,,1,0,0,,,,,,
756,415,721,756,415,721,,,0,0,0,,,,,,
756,416,746,756,416,746,,,0,0,0,,,,,,
757,417,771,757,417,771,,,0,0,0,,,,,,
754,427,148,754,427,148,,,0,0,0,,,,,,
754,427,149,754,427,148,,,0,0,1,,,,,,
754,427,153,754,427,153,,,0,0,0,,,,,,
754,427,160,754,427,161,,,0,0,-1,,,,,,
754,427,170,754,427,170,,,0,0,0,,,,,,
754,427,183,754,427,184,,,0,0,-1,,,,,,
754,427,198,754,427,198,,,0,0,0,,,,,,
754,428,215,754,427,215,,,0,1,0,,,,,,
754,428,233,754,427,233,,,0,1,0,,,,,,
754,428,252,754,428,252,,,0,0,0,,,,,,
754,428,272,754,428,272,,,0,0,0,,,,,,
754,428,293,754,428,293,,,0,0,0,,,,,,
754,429,315,755,428,314,,,-1,1,1,,,,,,
755,429,337,755,429,337,,,0,0,0,,,,,,
755,429,359,755,429,359,,,0,0,0,,,,,,
755,430,382,755,430,382,,,0,0,0,,,,,,
755,430,405,755,430,405,,,0,0,0,,,,,,
755,431,429,755,431,428,,,0,0,1,,,,,,
756,431,452,756,431,452,,,0,0,0,,,,,,
756,432,476,756,432,476,,,0,0,0,,,,,,
756,432,500,756,432,500,,,0,0,0,,,,,,
757,433,524,756,433,524,,,1,0,0,,,,,,
757,434,549,757,433,548,,,0,1,1,,,,,,
757,434,573,757,434,573,,,0,0,0,,,,,,
758,435,598,758,435,597,,,0,0,1,,,,,,
758,436,622,758,435,622,,,0,1,0,,,,,,
758,436,647,758,436,647,,,0,0,0,,,,,,
759,437,672,758,437,671,,,1,0,1,,,,,,
759,438,697,759,438,696,,,0,0,1,,,,,,
760,439,722,759,439,721,,,1,0,1,,,,,,
760,440,747,760,440,746,,,0,0,1,,,,,,
761,441,772,760,441,772,,,1,0,0,,,,,,
758,453,153,758,453,153,,,0,0,0,,,,,,
758,453,154,758,453,153,,,0,0,1,,,,,,
758,453,158,758,453,158,,,0,0,0,,,,,,
758,453,165,758,453,166,,,0,0,-1,,,,,,
758,453,175,758,453,175,,,0,0,0,,,,,,
758,453,187,758,453,188,,,0,0,-1,,,,,,
758,453,202,758,453,202,,,0,0,0,,,,,,
758,453,218,758,453,219,,,0,0,-1,,,,,,
758,453,236,758,453,236,,,0,0,0,,,,,,
758,453,255,758,453,255,,,0,0,0,,,,,,
758,454,275,758,454,275,,,0,0,0,,,,,,
758,454,296,758,454,296,,,0,0,0,,,,,,
759,454,317,759,454,317,,,0,0,0,,,,,,
759,455,339,759,454,339,,,0,1,0,,,,,,
759,455,361,759,455,361,,,0,0,0,,,,,,
759,455,384,759,455,384,,,0,0,0,,,,,,
759,456,407,759,456,407,,,0,0,0,,,,,,
760,456,430,759,456,430,,,1,0,0,,,,,,
760,457,454,760,456,454,,,0,1,0,,,,,,
760,457,478,760,457,477,,,0,0,1,,,,,,
760,458,502,760,457,501,,,0,1,1,,,,,,
761,458,526,760,458,525,,,1,0,1,,,,,,
761,459,550,761,458,550,,,0,1,0,,,,,,
761,459,574,761,459,574,,,0,0,0,,,,,,
762,460,599,762,460,598,,,0,0,1,,,,,,
762,461,623,762,461,623,,,0,0,0,,,,,,
762,461,648,762,461,648,,,0,0,0,,,,,,
763,462,673,762,462,672,,,1,0,1,,,,,,
763,463,698,763,463,697,,,0,0,1,,,,,,
764,464,723,763,464,722,,,1,0,1,,,,,,
764,465,748,764,465,747,,,0,0,1,,,,,,
765,465,773,764,466,772,,,1,-1,1,,,,,,
762,479,158,762,479,158,,,0,0,0,,,,,,
762,479,159,762,479,158,,,0,0,1,,,,,,
762,479,163,762,479,163,,,0,0,0,,,,,,
762,479,170,762,479,171,,,0,0,-1,,,,,,
762,479,179,762,479,179,,,0,0,0,,,,,,
762,479,191,762,479,192,,,0,0,-1,,,,,,
762,479,206,762,479,206,,,0,0,0,,,,,,
762,479,222,762,479,222,,,0,0,0,,,,,,
762,479,239,762,479,239,,,0,0,0,,,,,,
763,479,258,762,479,258,,,1,0,0,,,,,,
763,480,278,762,480,277,,,1,0,1,,,,,,
763,480,298,762,480,298,,,1,0,0,,,,,,
763,480,319,763,480,319,,,0,0,0,,,,,,
763,480,341,763,480,341,,,0,0,0,,,,,,
763,481,363,763,481,363,,,0,0,0,,,,,,
763,481,386,763,481,386,,,0,0,0,,,,,,
764,481,409,763,481,409,,,1,0,0,,,,,,
764,482,432,764,481,432,,,0,1,0,,,,,,
764,482,456,764,482,455,,,0,0,1,,,,,,
764,483,479,764,482,479,,,0,1,0,,,,,,
765,483,503,764,483,503,,,1,0,0,,,,,,
765,484,527,765,483,527,,,0,1,0,,,,,,
765,484,551,765,484,551,,,0,0,0,,,,,,
766,485,576,766,485,575,,,0,0,1,,,,,,
766,486,600,766,486,600,,,0,0,0,,,,,,
766,486,625,766,486,624,,,0,0,1,,,,,,
767,487,649,766,487,649,,,1,0,0,,,,,,
767,488,674,767,487,674,,,0,1,0,,,,,,
768,488,699,767,488,698,,,1,0,1,,,,,,
768,489,724,768,489,723,,,0,0,1,,,,,,
768,490,749,768,490,748,,,0,0,1,,,,,,
769,491,774,769,491,773,,,0,0,1,,,,,,
767,505,164,766,505,164,,,1,0,0,,,,,,
767,505,165,766,505,164,,,1,0,1,,,,,,
767,505,169,766,505,168,,,1,0,1,,,,,,
767,505,175,766,505,176,,,1,0,-1,,,,,,
767,505,184,767,505,184,,,0,0,0,,,,,,
767,505,196,767,505,197,,,0,0,-1,,,,,,
767,505,210,767,505,210,,,0,0,0,,,,,,
767,505,226,767,505,226,,,0,0,0,,,,,,
767,506,243,767,505,243,,,0,1,0,,,,,,
767,506,261,767,506,262,,,0,0,-1,,,,,,
767,506,281,767,506,281,,,0,0,0,,,,,,
767,506,301,767,506,301,,,0,0,0,,,,,,
768,506,322,767,506,322,,,1,0,0,,,,,,
768,507,344,768,506,344,,,0,1,0,,,,,,
768,507,366,768,507,365,,,0,0,1,,,,,,
768,507,388,768,507,388,,,0,0,0,,,,,,
768,508,411,768,508,411,,,0,0,0,,,,,,
769,508,434,768,508,434,,,1,0,0,,,,,,
769,508,457,769,508,457,,,0,0,0,,,,,,
769,509,481,769,508,481,,,0,1,0,,,,,,
769,509,505,769,509,504,,,0,0,1,,,,,,
770,510,529,769,509,528,,,1,1,1,,,,,,
770,510,553,770,510,552,,,0,0,1,,,,,,
770,511,577,770,511,577,,,0,0,0,,,,,,
771,511,601,771,511,601,,,0,0,0,,,,,,
771,512,626,771,512,625,,,0,0,1,,,,,,
771,513,650,771,513,650,,,0,0,0,,,,,,
772,513,675,771,513,675,,,1,0,0,,,,,,
772,514,700,772,514,699,,,0,0,1,,,,,,
773,515,725,772,515,724,,,1,0,1,,,,,,
773,516,750,773,515,749,,,0,1,1,,,,,,
774,516,775,773,516,774,,,1,0,1,,,,,,
772,532,170,771,531,169,,,1,1,1,,,,,,
772,532,171,771,531,169,,,1,1,2,,,,,,
772,532,174,771,531,174,,,1,1,0,,,,,,
772,532,180,771,531,182,,,1,1,-2,,,,,,
772,532,189,772,531,189,,,0,1,0,,,,,,
772,532,201,772,531,201,,,0,1,0,,,,,,
772,532,214,772,532,214,,,0,0,0,,,,,,
772,532,230,772,532,230,,,0,0,0,,,,,,
772,532,247,772,532,246,,,0,0,1,,,,,,
772,532,265,772,532,265,,,0,0,0,,,,,,
772,533,284,772,532,284,,,0,1,0,,,,,,
772,533,304,772,532,304,,,0,1,0,,,,,,
773,533,325,772,533,325,,,1,0,0,,,,,,
773,533,346,772,533,346,,,1,0,0,,,,,,
773,534,368,773,533,368,,,0,1,0,,,,,,
773,534,390,773,534,390,,,0,0,0,,,,,,
773,534,413,773,534,413,,,0,0,0,,,,,,
774,535,436,773,534,436,,,1,1,0,,,,,,
774,535,459,774,535,459,,,0,0,0,,,,,,
774,535,483,774,535,482,,,0,0,1,,,,,,
774,536,506,774,535,506,,,0,1,0,,,,,,
775,536,530,774,536,530,,,1,0,0,,,,,,
775,537,554,775,536,554,,,0,1,0,,,,,,
775,537,578,775,537,578,,,0,0,0,,,,,,
776,538,603,775,537,602,,,1,1,1,,,,,,
776,538,627,776,538,627,,,0,0,0,,,,,,
776,539,652,776,539,651,,,0,0,1,,,,,,
777,540,676,776,539,676,,,1,1,0,,,,,,
777,540,701,777,540,701,,,0,0,0,,,,,,
778,541,726,777,541,725,,,1,0,1,,,,,,
778,542,751,778,541,750,,,0,1,1,,,,,,
779,542,776,778,542,775,,,1,0,1,,,,,,
777,559,176,777,558,175,,,0,1,1,,,,,,
777,559,177,777,558,175,,,0,1,2,,,,,,
777,559,180,777,558,180,,,0,1,0,,,,,,
777,559,186,777,558,187,,,0,1,-1,,,,,,
777,559,195,777,558,194,,,0,1,1,,,,,,
777,559,206,777,558,206,,,0,1,0,,,,,,
777,559,219,777,559,219,,,0,0,0,,,,,,
777,559,234,777,559,234,,,0,0,0,,,,,,
777,559,251,777,559,250,,,0,0,1,,,,,,
777,559,268,777,559,269,,,0,0,-1,,,,,,
778,559,287,777,559,287,,,1,0,0,,,,,,
778,560,307,777,559,307,,,1,1,0,,,,,,
778,560,328,778,560,328,,,0,0,0,,,,,,
778,560,349,778,560,349,,,0,0,0,,,,,,
778,560,371,778,560,370,,,0,0,1,,,,,,
778,561,393,778,560,393,,,0,1,0,,,,,,
779,561,415,778,561,415,,,1,0,0,,,,,,
779,561,438,779,561,438,,,0,0,0,,,,,,
779,562,461,779,561,461,,,0,1,0,,,,,,
779,562,485,779,562,484,,,0,0,1,,,,,,
780,563,508,779,562,508,,,1,1,0,,,,,,
780,563,532,780,563,532,,,0,0,0,,,,,,
780,563,556,780,563,555,,,0,0,1,,,,,,
781,564,580,780,564,579,,,1,0,1,,,,,,
781,564,604,781,564,604,,,0,0,0,,,,,,
781,565,628,781,565,628,,,0,0,0,,,,,,
782,566,653,782,565,653,,,0,1,0,,,,,,
782,566,678,782,566,677,,,0,0,1,,,,,,
782,567,702,782,567,702,,,0,0,0,,,,,,
783,567,727,783,567,727,,,0,0,0,,,,,,
783,568,752,783,568,752,,,0,0,0,,,,,,
784,569,777,784,569,776,,,0,0,1,,,,,,
783,586,182,783,585,181,,,0,1,1,,,,,,
783,586,183,783,585,181,,,0,1,2,,,,,,
783,586,186,783,586,186,,,0,0,0,,,,,,
783,586,192,783,586,193,,,0,0,-1,,,,,,
783,586,200,783,586,200,,,0,0,0,,,,,,
783,586,211,783,586,212,,,0,0,-1,,,,,,
783,586,224,783,586,224,,,0,0,0,,,,,,
783,586,238,783,586,239,,,0,0,-1,,,,,,
783,586,255,783,586,254,,,0,0,1,,,,,,
783,586,272,783,586,272,,,0,0,0,,,,,,
783,587,291,783,586,291,,,0,1,0,,,,,,
783,587,311,783,586,311,,,0,1,0,,,,,,
783,587,331,783,587,331,,,0,0,0,,,,,,
784,587,352,783,587,352,,,1,0,0,,,,,,
784,587,373,784,587,373,,,0,0,0,,,,,,
784,588,395,784,587,395,,,0,1,0,,,,,,
784,588,418,784,588,418,,,0,0,0,,,,,,
784,588,440,784,588,440,,,0,0,0,,,,,,
785,589,463,785,588,463,,,0,1,0,,,,,,
785,589,487,785,589,486,,,0,0,1,,,,,,
785,590,510,785,589,510,,,0,1,0,,,,,,
785,590,534,785,590,533,,,0,0,1,,,,,,
786,590,558,786,590,557,,,0,0,1,,,,,,
786,591,582,786,591,581,,,0,0,1,,,,,,
786,591,606,786,591,605,,,0,0,1,,,,,,
787,592,630,787,592,630,,,0,0,0,,,,,,
787,592,654,787,592,654,,,0,0,0,,,,,,
788,593,679,787,593,679,,,1,0,0,,,,,,
788,594,704,788,593,703,,,0,1,1,,,,,,
788,594,728,788,594,728,,,0,0,0,,,,,,
789,595,753,789,595,753,,,0,0,0,,,,,,
789,596,778,789,595,778,,,0,1,0,,,,,,
788,613,188,788,613,188,,,0,0,0,,,,,,
788,613,189,788,613,188,,,0,0,1,,,,,,
789,613,192,788,613,192,,,1,0,0,,,,,,
789,613,198,788,613,198,,,1,0,0,,,,,,
789,613,206,788,613,205,,,1,0,1,,,,,,
789,613,216,788,613,217,,,1,0,-1,,,,,,
789,613,229,788,613,229,,,1,0,0,,,,,,
789,614,243,789,613,244,,,0,1,-1,,,,,,
789,614,259,789,613,259,,,0,1,0,,,,,,
789,614,276,789,614,276,,,0,0,0,,,,,,
789,614,295,789,614,294,,,0,0,1,,,,,,
789,614,314,789,614,314,,,0,0,0,,,,,,
789,614,334,789,614,334,,,0,0,0,,,,,,
789,615,355,789,614,355,,,0,1,0,,,,,,
790,615,376,789,615,376,,,1,0,0,,,,,,
790,615,398,790,615,398,,,0,0,0,,,,,,
790,615,420,790,615,420,,,0,0,0,,,,,,
790,616,443,790,615,443,,,0,1,0,,,,,,
791,616,466,790,616,465,,,1,0,1,,,,,,
791,616,489,791,616,488,,,0,0,1,,,,,,
791,617,512,791,616,512,,,0,1,0,,,,,,
791,617,536,791,617,535,,,0,0,1,,,,,,
792,618,559,792,617,559,,,0,1,0,,,,,,
792,618,583,792,618,583,,,0,0,0,,,,,,
792,619,607,792,618,607,,,0,1,0,,,,,,
793,619,632,793,619,631,,,0,0,1,,,,,,
793,620,656,793,619,656,,,0,1,0,,,,,,
793,620,680,793,620,680,,,0,0,0,,,,,,
794,621,705,794,620,705,,,0,1,0,,,,,,
794,621,730,794,621,729,,,0,0,1,,,,,,
795,622,754,795,622,754,,,0,0,0,,,,,,
795,622,779,795,622,779,,,0,0,0,,,,,,
795,641,194,794,641,194,,,1,0,0,,,,,,
795,641,195,794,641,194,,,1,0,1,,,,,,
795,641,198,794,641,198,,,1,0,0,,,,,,
795,641,204,794,641,204,,,1,0,0,,,,,,
795,641,212,794,641,211,,,1,0,1,,,,,,
795,641,222,794,641,222,,,1,0,0,,,,,,
795,641,234,794,641,234,,,1,0,0,,,,,,
795,641,248,795,641,248,,,0,0,0,,,,,,
795,641,264,795,641,263,,,0,0,1,,,,,,
795,641,281,795,641,281,,,0,0,0,,,,,,
795,642,299,795,642,298,,,0,0,1,,,,,,
795,642,318,795,642,318,,,0,0,0,,,,,,
795,642,338,795,642,337,,,0,0,1,,,,,,
796,642,358,795,642,358,,,1,0,0,,,,,,
796,642,379,795,642,379,,,1,0,0,,,,,,
796,643,401,796,642,401,,,0,1,0,,,,,,
796,643,423,796,643,423,,,0,0,0,,,,,,
796,643,445,796,643,445,,,0,0,0,,,,,,
797,644,468,796,643,468,,,1,1,0,,,,,,
797,644,491,797,643,491,,,0,1,0,,,,,,
797,644,514,797,644,514,,,0,0,0,,,,,,
797,645,538,797,644,537,,,0,1,1,,,,,,
798,645,561,798,645,561,,,0,0,0,,,,,,
798,645,585,798,645,585,,,0,0,0,,,,,,
798,646,609,798,646,609,,,0,0,0,,,,,,
799,646,633,799,646,633,,,0,0,0,,,,,,
799,647,658,799,647,657,,,0,0,1,,,,,,
800,647,682,799,647,682,,,1,0,0,,,,,,
800,648,706,800,648,706,,,0,0,0,,,,,,
800,648,731,800,648,731,,,0,0,0,,,,,,
801,649,756,801,649,755,,,0,0,1,,,,,,
801,650,781,801,649,780,,,0,1,1,,,,,,
801,669,201,801,669,201,,,0,0,0,,,,,,
801,669,202,801,669,201,,,0,0,1,,,,,,
801,669,205,801,669,204,,,0,0,1,,,,,,
801,669,210,801,669,211,,,0,0,-1,,,,,,
801,669,217,801,669,217,,,0,0,0,,,,,,
801,669,227,801,669,228,,,0,0,-1,,,,,,
801,669,239,801,669,239,,,0,0,0,,,,,,
801,669,253,801,669,253,,,0,0,0,,,,,,
801,669,268,801,669,268,,,0,0,0,,,,,,
802,669,285,802,669,285,,,0,0,0,,,,,,
802,669,303,802,669,302,,,0,0,1,,,,,,
802,670,321,802,669,322,,,0,1,-1,,,,,,
802,670,341,802,670,341,,,0,0,0,,,,,,
802,670,361,802,670,361,,,0,0,0,,,,,,
802,670,382,802,670,382,,,0,0,0,,,,,,
802,670,404,802,670,404,,,0,0,0,,,,,,
803,671,426,803,671,425,,,0,0,1,,,,,,
803,671,448,803,671,448,,,0,0,0,,,,,,
803,671,470,803,671,470,,,0,0,0,,,,,,
803,672,493,803,671,493,,,0,1,0,,,,,,
804,672,516,804,672,516,,,0,0,0,,,,,,
804,672,540,804,672,539,,,0,0,1,,,,,,
804,673,563,804,672,563,,,0,1,0,,,,,,
805,673,587,804,673,587,,,1,0,0,,,,,,
805,673,611,805,673,611,,,0,0,0,,,,,,
805,674,635,805,674,635,,,0,0,0,,,,,,
806,674,659,806,674,659,,,0,0,0,,,,,,
806,675,684,806,675,683,,,0,0,1,,,,,,
806,675,708,806,675,708,,,0,0,0,,,,,,
807,676,733,807,676,732,,,0,0,1,,,,,,
807,677,757,807,676,757,,,0,1,0,,,,,,
808,677,782,808,677,782,,,0,0,0,,,,,,
808,697,207,808,697,207,,,0,0,0,,,,,,
808,697,208,808,697,207,,,0,0,1,,,,,,
808,697,211,808,697,211,,,0,0,0,,,,,,
808,697,216,808,697,217,,,0,0,-1,,,,,,
808,697,223,808,697,223,,,0,0,0,,,,,,
808,697,233,808,697,234,,,0,0,-1,,,,,,
808,697,245,808,697,244,,,0,0,1,,,,,,
808,697,258,808,697,259,,,0,0,-1,,,,,,
808,697,273,808,697,273,,,0,0,0,,,,,,
808,697,289,808,697,290,,,0,0,-1,,,,,,
808,697,307,809,697,307,,,-1,0,0,,,,,,
809,697,325,809,697,326,,,0,0,-1,,,,,,
809,698,345,809,698,345,,,0,0,0,,,,,,
809,698,365,809,698,365,,,0,0,0,,,,,,
809,698,386,809,698,386,,,0,0,0,,,,,,
809,698,407,809,698,407,,,0,0,0,,,,,,
809,699,428,810,699,428,,,-1,0,0,,,,,,
810,699,451,810,699,450,,,0,0,1,,,,,,
810,699,473,810,699,473,,,0,0,0,,,,,,
810,699,496,810,699,495,,,0,0,1,,,,,,
810,700,519,810,700,518,,,0,0,1,,,,,,
811,700,542,810,700,542,,,1,0,0,,,,,,
811,700,565,811,700,565,,,0,0,0,,,,,,
811,701,589,811,700,589,,,0,1,0,,,,,,
812,701,613,812,701,613,,,0,0,0,,,,,,
812,702,637,812,701,637,,,0,1,0,,,,,,
812,702,661,812,702,661,,,0,0,0,,,,,,
813,703,685,812,702,685,,,1,1,0,,,,,,
813,703,710,813,703,709,,,0,0,1,,,,,,
814,704,734,813,703,734,,,1,1,0,,,,,,
814,704,759,814,704,758,,,0,0,1,,,,,,
814,705,783,814,704,783,,,0,1,0,,,,,,
815,725,214,815,725,214,,,0,0,0,,,,,,
815,725,215,815,725,214,,,0,0,1,,,,,,
815,725,218,815,725,217,,,0,0,1,,,,,,
815,725,222,815,725,223,,,0,0,-1,,,,,,
815,725,230,815,725,229,,,0,0,1,,,,,,
815,725,239,815,725,240,,,0,0,-1,,,,,,
815,725,250,815,725,250,,,0,0,0,,,,,,
815,725,263,815,725,264,,,0,0,-1,,,,,,
815,725,278,815,725,278,,,0,0,0,,,,,,
815,725,294,815,725,295,,,0,0,-1,,,,,,
815,725,311,815,725,311,,,0,0,0,,,,,,
816,726,330,816,725,330,,,0,1,0,,,,,,
816,726,349,816,726,348,,,0,0,1,,,,,,
816,726,368,816,726,369,,,0,0,-1,,,,,,
816,726,389,816,726,389,,,0,0,0,,,,,,
816,726,410,816,726,410,,,0,0,0,,,,,,
816,727,431,816,727,431,,,0,0,0,,,,,,
817,727,453,817,727,453,,,0,0,0,,,,,,
817,727,476,817,727,475,,,0,0,1,,,,,,
817,727,498,817,727,498,,,0,0,0,,,,,,
817,728,521,817,728,521,,,0,0,0,,,,,,
818,728,544,817,728,544,,,1,0,0,,,,,,
818,728,568,818,728,567,,,0,0,1,,,,,,
818,729,591,818,728,591,,,0,1,0,,,,,,
819,729,615,819,729,615,,,0,0,0,,,,,,
819,730,639,819,729,638,,,0,1,1,,,,,,
819,730,663,819,730,662,,,0,0,1,,,,,,
820,730,687,819,730,687,,,1,0,0,,,,,,
820,731,711,820,731,711,,,0,0,0,,,,,,
821,731,736,820,731,736,,,1,0,0,,,,,,
821,732,760,821,732,760,,,0,0,0,,,,,,
821,732,785,821,732,785,,,0,0,0,,,,,,
822,753,221,822,753,221,,,0,0,0,,,,,,
822,753,222,822,753,221,,,0,0,1,,,,,,
822,753,224,822,753,224,,,0,0,0,,,,,,
822,753,229,822,753,230,,,0,0,-1,,,,,,
822,753,236,822,753,236,,,0,0,0,,,,,,
822,753,245,822,753,246,,,0,0,-1,,,,,,
822,753,256,822,753,256,,,0,0,0,,,,,,
823,753,269,822,753,269,,,1,0,0,,,,,,
823,753,283,822,753,283,,,1,0,0,,,,,,
823,753,299,822,753,299,,,1,0,0,,,,,,
823,754,316,822,753,316,,,1,1,0,,,,,,
823,754,334,823,753,334,,,0,1,0,,,,,,
823,754,353,823,754,352,,,0,0,1,,,,,,
823,754,372,823,754,372,,,0,0,0,,,,,,
823,754,392,823,754,392,,,0,0,0,,,,,,
824,755,413,823,754,413,,,1,1,0,,,,,,
824,755,435,823,755,435,,,1,0,0,,,,,,
824,755,456,824,755,456,,,0,0,0,,,,,,
824,755,478,824,755,478,,,0,0,0,,,,,,
824,756,501,824,755,501,,,0,1,0,,,,,,
825,756,524,824,756,523,,,1,0,1,,,,,,
825,756,547,825,756,546,,,0,0,1,,,,,,
825,756,570,825,756,570,,,0,0,0,,,,,,
826,757,593,825,756,593,,,1,1,0,,,,,,
826,757,617,826,757,617,,,0,0,0,,,,,,
826,758,641,826,757,640,,,0,1,1,,,,,,
827,758,665,826,758,664,,,1,0,1,,,,,,
827,758,689,827,758,689,,,0,0,0,,,,,,
827,759,713,827,759,713,,,0,0,0,,,,,,
828,759,738,828,759,738,,,0,0,0,,,,,,
828,760,762,828,760,762,,,0,0,0,,,,,,
829,760,787,829,760,787,,,0,0,0,,,,,,
830,781,228,830,781,228,,,0,0,0,,,,,,
830,781,228,830,781,228,,,0,0,0,,,,,,
830,781,231,830,781,231,,,0,0,0,,,,,,
830,781,236,830,781,236,,,0,0,0,,,,,,
830,781,242,830,781,242,,,0,0,0,,,,,,
830,782,251,830,781,252,,,0,1,-1,,,,,,
830,782,262,830,781,261,,,0,1,1,,,,,,
830,782,274,830,781,275,,,0,1,-1,,,,,,
830,782,288,830,782,288,,,0,0,0,,,,,,
830,782,304,830,782,304,,,0,0,0,,,,,,
830,782,320,830,782,320,,,0,0,0,,,,,,
830,782,338,830,782,338,,,0,0,0,,,,,,
831,782,357,831,782,356,,,0,0,1,,,,,,
831,782,376,831,782,376,,,0,0,0,,,,,,
831,783,396,831,782,396,,,0,1,0,,,,,,
831,783,417,831,783,417,,,0,0,0,,,,,,
831,783,438,831,783,438,,,0,0,0,,,,,,
832,783,459,831,783,459,,,1,0,0,,,,,,
832,784,481,832,783,481,,,0,1,0,,,,,,
832,784,504,832,784,503,,,0,0,1,,,,,,
832,784,526,832,784,526,,,0,0,0,,,,,,
833,784,549,832,784,549,,,1,0,0,,,,,,
833,785,572,833,784,572,,,0,1,0,,,,,,
833,785,596,833,785,595,,,0,0,1,,,,,,
833,785,619,833,785,619,,,0,0,0,,,,,,
834,786,643,833,785,643,,,1,1,0,,,,,,
834,786,667,834,786,666,,,0,0,1,,,,,,
835,787,691,834,786,691,,,1,1,0,,,,,,
835,787,715,835,787,715,,,0,0,0,,,,,,
835,788,739,835,787,739,,,0,1,0,,,,,,
836,788,764,836,788,764,,,0,0,0,,,,,,
836,788,788,836,788,788,,,0,0,0,,,,,,
838,810,235,838,810,235,,,0,0,0,,,,,,
838,810,235,838,810,235,,,0,0,0,,,,,,
838,810,238,838,810,238,,,0,0,0,,,,,,
838,810,242,838,810,243,,,0,0,-1,,,,,,
838,810,249,838,810,249,,,0,0,0,,,,,,
838,810,257,838,810,258,,,0,0,-1,,,,,,
838,810,268,838,810,267,,,0,0,1,,,,,,
838,810,280,838,810,280,,,0,0,0,,,,,,
838,810,294,838,810,293,,,0,0,1,,,,,,
838,810,309,838,810,309,,,0,0,0,,,,,,
838,810,325,838,810,325,,,0,0,0,,,,,,
838,811,343,838,810,343,,,0,1,0,,,,,,
838,811,361,839,810,361,,,-1,1,0,,,,,,
839,811,380,839,810,380,,,0,1,0,,,,,,
839,811,400,839,811,400,,,0,0,0,,,,,,
839,811,420,839,811,420,,,0,0,0,,,,,,
839,811,441,839,811,441,,,0,0,0,,,,,,
839,812,463,839,811,462,,,0,1,1,,,,,,
840,812,484,840,812,484,,,0,0,0,,,,,,
840,812,507,840,812,506,,,0,0,1,,,,,,
840,812,529,840,812,529,,,0,0,0,,,,,,
840,813,552,840,812,552,,,0,1,0,,,,,,
841,813,575,841,813,575,,,0,0,0,,,,,,
841,813,598,841,813,598,,,0,0,0,,,,,,
841,814,622,841,813,621,,,0,1,1,,,,,,
842,814,645,841,814,645,,,1,0,0,,,,,,
842,815,669,842,814,669,,,0,1,0,,,,,,
842,815,693,842,815,693,,,0,0,0,,,,,,
843,815,717,843,815,717,,,0,0,0,,,,,,
843,816,741,843,816,741,,,0,0,0,,,,,,
843,816,766,844,816,765,,,-1,0,1,,,,,,
844,817,790,844,817,790,,,0,0,0,,,,,,
846,838,242,846,838,242,,,0,0,0,,,,,,
846,838,242,846,838,242,,,0,0,0,,,,,,
846,838,245,846,838,244,,,0,0,1,,,,,,
846,838,249,846,838,250,,,0,0,-1,,,,,,
846,839,255,846,838,255,,,0,1,0,,,,,,
846,839,264,846,838,264,,,0,1,0,,,,,,
846,839,274,846,838,274,,,0,1,0,,,,,,
846,839,286,846,838,286,,,0,1,0,,,,,,
846,839,299,846,839,299,,,0,0,0,,,,,,
846,839,314,846,839,314,,,0,0,0,,,,,,
846,839,330,846,839,330,,,0,0,0,,,,,,
846,839,347,846,839,347,,,0,0,0,,,,,,
847,839,365,847,839,365,,,0,0,0,,,,,,
847,839,384,847,839,384,,,0,0,0,,,,,,
847,840,404,847,839,404,,,0,1,0,,,,,,
847,840,424,847,839,424,,,0,1,0,,,,,,
847,840,445,847,840,444,,,0,0,1,,,,,,
847,840,466,847,840,466,,,0,0,0,,,,,,
848,840,488,848,840,487,,,0,0,1,,,,,,
848,841,510,848,840,509,,,0,1,1,,,,,,
848,841,532,848,841,532,,,0,0,0,,,,,,
848,841,555,848,841,554,,,0,0,1,,,,,,
849,842,578,849,841,577,,,0,1,1,,,,,,
849,842,601,849,841,600,,,0,1,1,,,,,,
849,842,624,849,842,624,,,0,0,0,,,,,,
850,843,648,849,842,647,,,1,1,1,,,,,,
850,843,671,850,843,671,,,0,0,0,,,,,,
850,843,695,850,843,695,,,0,0,0,,,,,,
851,844,719,851,844,719,,,0,0,0,,,,,,
851,844,743,851,844,743,,,0,0,0,,,,,,
852,845,768,852,845,767,,,0,0,1,,,,,,
852,845,792,852,845,792,,,0,0,0,,,,,,
854,867,249,854,867,249,,,0,0,0,,,,,,
854,867,249,854,867,249,,,0,0,0,,,,,,
854,867,252,854,867,251,,,0,0,1,,,,,,
854,867,256,854,867,256,,,0,0,0,,,,,,
854,867,262,854,867,262,,,0,0,0,,,,,,
854,867,270,854,867,271,,,0,0,-1,,,,,,
854,867,280,854,867,280,,,0,0,0,,,,,,
854,867,292,854,867,292,,,0,0,0,,,,,,
854,867,305,854,867,304,,,0,0,1,,,,,,
855,868,319,854,867,319,,,1,1,0,,,,,,
855,868,335,854,867,335,,,1,1,0,,,,,,
855,868,352,855,867,352,,,0,1,0,,,,,,
855,868,370,855,867,370,,,0,1,0,,,,,,
855,868,388,855,868,389,,,0,0,-1,,,,,,
855,868,408,855,868,408,,,0,0,0,,,,,,
855,868,428,855,868,428,,,0,0,0,,,,,,
856,869,448,855,868,448,,,1,1,0,,,,,,
856,869,469,856,869,469,,,0,0,0,,,,,,
856,869,491,856,869,491,,,0,0,0,,,,,,
856,869,513,856,869,513,,,0,0,0,,,,,,
856,870,535,856,869,535,,,0,1,0,,,,,,
857,870,557,857,870,557,,,0,0,0,,,,,,
857,870,580,857,870,580,,,0,0,0,,,,,,
857,870,603,857,870,603,,,0,0,0,,,,,,
858,871,626,857,870,626,,,1,1,0,,,,,,
858,871,650,858,871,650,,,0,0,0,,,,,,
858,871,674,858,871,673,,,0,0,1,,,,,,
859,872,697,859,872,697,,,0,0,0,,,,,,
859,872,721,859,872,721,,,0,0,0,,,,,,
859,873,745,859,873,745,,,0,0,0,,,,,,
860,873,769,860,873,769,,,0,0,0,,,,,,
860,873,794,860,873,794,,,0,0,0,,,,,,
863,896,256,863,896,256,,,0,0,0,,,,,,
863,896,257,863,896,256,,,0,0,1,,,,,,
863,896,259,863,896,258,,,0,0,1,,,,,,
863,896,263,863,896,263,,,0,0,0,,,,,,
863,896,269,863,896,268,,,0,0,1,,,,,,
863,896,277,863,896,277,,,0,0,0,,,,,,
863,896,286,863,896,286,,,0,0,0,,,,,,
863,896,298,863,896,298,,,0,0,0,,,,,,
863,896,311,863,896,310,,,0,0,1,,,,,,
863,896,325,863,896,325,,,0,0,0,,,,,,
863,896,340,863,896,340,,,0,0,0,,,,,,
863,897,357,863,896,357,,,0,1,0,,,,,,
864,897,374,864,896,374,,,0,1,0,,,,,,
864,897,393,864,896,393,,,0,1,0,,,,,,
864,897,412,864,897,412,,,0,0,0,,,,,,
864,897,432,864,897,432,,,0,0,0,,,,,,
864,897,452,864,897,452,,,0,0,0,,,,,,
864,898,473,864,897,473,,,0,1,0,,,,,,
865,898,494,865,898,494,,,0,0,0,,,,,,
865,898,516,865,898,516,,,0,0,0,,,,,,
865,898,538,865,898,538,,,0,0,0,,,,,,
865,899,560,865,898,560,,,0,1,0,,,,,,
866,899,583,866,899,583,,,0,0,0,,,,,,
866,899,606,866,899,606,,,0,0,0,,,,,,
866,899,629,866,899,629,,,0,0,0,,,,,,
867,900,652,866,899,652,,,1,1,0,,,,,,
867,900,676,867,900,676,,,0,0,0,,,,,,
867,900,700,867,900,699,,,0,0,1,,,,,,
868,901,723,868,901,723,,,0,0,0,,,,,,
868,901,747,868,901,747,,,0,0,0,,,,,,
868,902,772,868,902,771,,,0,0,1,,,,,,
869,902,796,869,902,796,,,0,0,0,,,,,,
757,209,115,757,209,115,,,0,0,0,,,,,,
757,209,116,757,209,115,,,0,0,1,,,,,,
757,209,121,757,209,121,,,0,0,0,,,,,,
757,209,130,757,209,132,,,0,0,-2,,,,,,
757,210,143,757,210,143,,,0,0,0,,,,,,
757,210,158,757,210,159,,,0,0,-1,,,,,,
757,210,175,757,210,175,,,0,0,0,,,,,,
757,210,194,757,210,194,,,0,0,0,,,,,,
757,211,214,757,211,214,,,0,0,0,,,,,,
757,211,235,757,211,235,,,0,0,0,,,,,,
757,212,257,757,212,257,,,0,0,0,,,,,,
757,212,279,757,212,279,,,0,0,0,,,,,,
757,213,302,757,213,302,,,0,0,0,,,,,,
758,214,325,757,214,325,,,1,0,0,,,,,,
758,215,348,758,215,348,,,0,0,0,,,,,,
758,215,372,758,215,372,,,0,0,0,,,,,,
758,216,396,758,216,396,,,0,0,0,,,,,,
758,217,420,758,217,420,,,0,0,0,,,,,,
759,218,444,759,218,444,,,0,0,0,,,,,,
759,219,468,759,219,468,,,0,0,0,,,,,,
759,221,493,759,221,493,,,0,0,0,,,,,,
759,222,517,759,222,517,,,0,0,0,,,,,,
760,223,542,760,223,542,,,0,0,0,,,,,,
760,225,567,760,224,567,,,0,1,0,,,,,,
760,226,592,760,226,592,,,0,0,0,,,,,,
761,228,616,760,227,616,,,1,1,0,,,,,,
761,229,641,761,229,641,,,0,0,0,,,,,,
762,231,666,761,231,666,,,1,0,0,,,,,,
762,233,692,762,233,692,,,0,0,0,,,,,,
763,234,717,762,234,717,,,1,0,0,,,,,,
763,236,742,763,236,742,,,0,0,0,,,,,,
763,238,767,763,238,767,,,0,0,0,,,,,,
757,210,115,757,209,115,,,0,1,0,,,,,,
757,210,116,757,209,115,,,0,1,1,,,,,,
757,210,121,757,209,121,,,0,1,0,,,,,,
757,210,131,757,209,132,,,0,1,-1,,,,,,
757,211,143,757,210,143,,,0,1,0,,,,,,
757,211,158,757,210,159,,,0,1,-1,,,,,,
757,211,176,757,210,175,,,0,1,1,,,,,,
757,211,194,757,210,194,,,0,1,0,,,,,,
757,212,215,757,211,214,,,0,1,1,,,,,,
757,212,235,757,211,235,,,0,1,0,,,,,,
757,213,257,757,212,257,,,0,1,0,,,,,,
757,213,279,757,212,279,,,0,1,0,,,,,,
757,214,302,757,213,302,,,0,1,0,,,,,,
758,215,325,757,214,325,,,1,1,0,,,,,,
758,215,348,758,215,348,,,0,0,0,,,,,,
758,216,372,758,215,372,,,0,1,0,,,,,,
758,217,396,758,216,396,,,0,1,0,,,,,,
758,218,420,758,217,420,,,0,1,0,,,,,,
759,219,444,759,218,444,,,0,1,0,,,,,,
759,220,468,759,219,468,,,0,1,0,,,,,,
759,222,493,759,221,493,,,0,1,0,,,,,,
760,223,517,759,222,517,,,1,1,0,,,,,,
760,224,542,760,223,542,,,0,1,0,,,,,,
760,226,567,760,224,567,,,0,2,0,,,,,,
761,227,592,760,226,592,,,1,1,0,,,,,,
761,229,616,760,227,616,,,1,2,0,,,,,,
761,230,641,761,229,641,,,0,1,0,,,,,,
762,232,666,761,231,666,,,1,1,0,,,,,,
762,233,692,762,233,692,,,0,0,0,,,,,,
763,235,717,762,234,717,,,1,1,0,,,,,,
763,237,742,763,236,742,,,0,1,0,,,,,,
764,239,767,763,238,767,,,1,1,0,,,,,,
757,214,115,757,214,115,,,0,0,0,,,,,,
757,214,117,757,214,115,,,0,0,2,,,,,,
757,214,122,757,214,122,,,0,0,0,,,,,,
757,214,131,757,214,132,,,0,0,-1,,,,,,
757,214,143,757,214,143,,,0,0,0,,,,,,
757,214,159,757,214,159,,,0,0,0,,,,,,
757,215,176,757,215,176,,,0,0,0,,,,,,
757,215,195,757,215,195,,,0,0,0,,,,,,
757,215,215,757,215,215,,,0,0,0,,,,,,
757,216,236,757,215,236,,,0,1,0,,,,,,
757,216,257,757,216,257,,,0,0,0,,,,,,
758,217,280,757,217,279,,,1,0,1,,,,,,
758,218,302,758,218,302,,,0,0,0,,,,,,
758,218,325,758,218,325,,,0,0,0,,,,,,
758,219,349,758,219,349,,,0,0,0,,,,,,
758,220,372,758,220,372,,,0,0,0,,,,,,
758,221,396,758,221,396,,,0,0,0,,,,,,
759,222,420,758,222,420,,,1,0,0,,,,,,
759,223,444,759,223,444,,,0,0,0,,,,,,
759,224,468,759,224,468,,,0,0,0,,,,,,
760,225,493,760,225,493,,,0,0,0,,,,,,
760,226,517,760,226,517,,,0,0,0,,,,,,
760,228,542,760,228,542,,,0,0,0,,,,,,
760,229,567,760,229,567,,,0,0,0,,,,,,
761,230,592,761,230,592,,,0,0,0,,,,,,
761,232,617,761,231,616,,,0,1,1,,,,,,
762,233,641,762,233,641,,,0,0,0,,,,,,
762,235,667,762,235,666,,,0,0,1,,,,,,
762,237,692,762,237,692,,,0,0,0,,,,,,
763,238,717,762,238,717,,,1,0,0,,,,,,
763,240,742,763,240,742,,,0,0,0,,,,,,
764,242,767,763,242,767,,,1,0,0,,,,,,
757,221,116,757,222,116,,,0,-1,0,,,,,,
757,221,117,757,222,116,,,0,-1,1,,,,,,
757,221,123,757,222,123,,,0,-1,0,,,,,,
757,221,132,757,222,133,,,0,-1,-1,,,,,,
757,221,144,757,222,144,,,0,-1,0,,,,,,
757,221,159,757,222,160,,,0,-1,-1,,,,,,
758,221,176,757,223,176,,,1,-2,0,,,,,,
758,222,195,757,223,196,,,1,-1,-1,,,,,,
758,222,215,757,223,215,,,1,-1,0,,,,,,
758,223,236,757,224,236,,,1,-1,0,,,,,,
758,223,258,758,224,257,,,0,-1,1,,,,,,
758,224,280,758,225,280,,,0,-1,0,,,,,,
758,224,302,758,226,302,,,0,-2,0,,,,,,
758,225,325,758,226,325,,,0,-1,0,,,,,,
759,226,349,758,227,349,,,1,-1,0,,,,,,
759,226,372,758,228,372,,,1,-2,0,,,,,,
759,227,396,759,229,396,,,0,-2,0,,,,,,
759,228,420,759,230,420,,,0,-2,0,,,,,,
759,229,444,759,231,444,,,0,-2,0,,,,,,
760,230,469,760,232,468,,,0,-2,1,,,,,,
760,231,493,760,233,493,,,0,-2,0,,,,,,
760,233,518,760,234,517,,,0,-1,1,,,,,,
761,234,542,760,235,542,,,1,-1,0,,,,,,
761,235,567,761,236,567,,,0,-1,0,,,,,,
761,237,592,761,238,592,,,0,-1,0,,,,,,
762,238,617,762,239,616,,,0,-1,1,,,,,,
762,240,642,762,240,641,,,0,0,1,,,,,,
762,241,667,762,242,666,,,0,-1,1,,,,,,
763,243,692,763,244,692,,,0,-1,0,,,,,,
763,244,717,763,246,717,,,0,-2,0,,,,,,
764,246,742,764,247,742,,,0,-1,0,,,,,,
764,248,767,764,249,767,,,0,-1,0,,,,,,
758,230,117,758,230,117,,,0,0,0,,,,,,
758,230,119,758,230,117,,,0,0,2,,,,,,
758,230,124,758,230,124,,,0,0,0,,,,,,
758,231,133,758,230,134,,,0,1,-1,,,,,,
758,231,145,758,231,145,,,0,0,0,,,,,,
758,231,160,758,231,161,,,0,0,-1,,,,,,
758,231,177,758,231,177,,,0,0,0,,,,,,
758,231,196,758,231,196,,,0,0,0,,,,,,
758,232,216,758,232,216,,,0,0,0,,,,,,
759,232,237,758,232,237,,,1,0,0,,,,,,
759,233,258,759,233,258,,,0,0,0,,,,,,
759,233,280,759,233,280,,,0,0,0,,,,,,
759,234,303,759,234,303,,,0,0,0,,,,,,
759,234,326,759,234,326,,,0,0,0,,,,,,
759,235,349,759,235,349,,,0,0,0,,,,,,
759,236,373,759,236,372,,,0,0,1,,,,,,
760,237,396,760,237,396,,,0,0,0,,,,,,
760,238,420,760,238,420,,,0,0,0,,,,,,
760,239,445,760,239,445,,,0,0,0,,,,,,
760,240,469,760,240,469,,,0,0,0,,,,,,
761,241,493,761,241,493,,,0,0,0,,,,,,
761,242,518,761,242,517,,,0,0,1,,,,,,
761,243,542,761,243,542,,,0,0,0,,,,,,
762,244,567,761,244,567,,,1,0,0,,,,,,
762,246,592,762,246,592,,,0,0,0,,,,,,
762,247,617,762,247,617,,,0,0,0,,,,,,
763,248,642,763,248,642,,,0,0,0,,,,,,
763,250,667,763,250,667,,,0,0,0,,,,,,
764,252,692,764,252,692,,,0,0,0,,,,,,
764,253,717,764,253,717,,,0,0,0,,,,,,
765,255,742,765,255,742,,,0,0,0,,,,,,
765,257,768,765,256,767,,,0,1,1,,,,,,
759,243,119,759,244,119,,,0,-1,0,,,,,,
759,243,120,759,244,119,,,0,-1,1,,,,,,
759,243,125,759,244,125,,,0,-1,0,,,,,,
759,243,134,759,244,136,,,0,-1,-2,,,,,,
759,243,146,759,244,146,,,0,-1,0,,,,,,
759,243,161,759,244,162,,,0,-1,-1,,,,,,
759,244,178,759,244,178,,,0,0,0,,,,,,
759,244,197,759,245,197,,,0,-1,0,,,,,,
759,244,217,759,245,217,,,0,-1,0,,,,,,
759,245,237,759,246,238,,,0,-1,-1,,,,,,
760,245,259,760,246,259,,,0,-1,0,,,,,,
760,245,281,760,247,281,,,0,-2,0,,,,,,
760,246,303,760,247,303,,,0,-1,0,,,,,,
760,247,326,760,248,326,,,0,-1,0,,,,,,
760,247,350,760,248,349,,,0,-1,1,,,,,,
760,248,373,760,249,373,,,0,-1,0,,,,,,
761,249,397,761,250,396,,,0,-1,1,,,,,,
761,250,421,761,251,420,,,0,-1,1,,,,,,
761,251,445,761,252,445,,,0,-1,0,,,,,,
761,252,469,761,253,469,,,0,-1,0,,,,,,
762,253,494,762,254,493,,,0,-1,1,,,,,,
762,254,518,762,255,518,,,0,-1,0,,,,,,
762,255,543,762,256,542,,,0,-1,1,,,,,,
763,256,567,762,257,567,,,1,-1,0,,,,,,
763,257,592,763,258,592,,,0,-1,0,,,,,,
763,259,617,763,259,617,,,0,0,0,,,,,,
764,260,642,764,261,642,,,0,-1,0,,,,,,
764,261,667,764,262,667,,,0,-1,0,,,,,,
765,263,692,765,264,692,,,0,-1,0,,,,,,
765,264,717,765,266,717,,,0,-2,0,,,,,,
766,266,743,766,267,742,,,0,-1,1,,,,,,
766,268,768,766,269,767,,,0,-1,1,,,,,,
760,258,121,760,258,121,,,0,0,0,,,,,,
760,258,122,760,258,121,,,0,0,1,,,,,,
760,258,127,760,258,127,,,0,0,0,,,,,,
760,258,136,760,258,137,,,0,0,-1,,,,,,
760,258,148,760,258,148,,,0,0,0,,,,,,
760,258,163,760,258,164,,,0,0,-1,,,,,,
760,258,180,760,258,180,,,0,0,0,,,,,,
761,259,198,760,258,199,,,1,1,-1,,,,,,
761,259,218,761,259,218,,,0,0,0,,,,,,
761,259,238,761,259,239,,,0,0,-1,,,,,,
761,260,260,761,260,260,,,0,0,0,,,,,,
761,260,282,761,260,282,,,0,0,0,,,,,,
761,261,304,761,261,304,,,0,0,0,,,,,,
761,261,327,761,261,327,,,0,0,0,,,,,,
762,262,350,762,262,350,,,0,0,0,,,,,,
762,263,374,762,262,373,,,0,1,1,,,,,,
762,263,397,762,263,397,,,0,0,0,,,,,,
762,264,421,762,264,421,,,0,0,0,,,,,,
762,265,445,762,265,445,,,0,0,0,,,,,,
763,266,470,762,266,469,,,1,0,1,,,,,,
763,267,494,763,267,494,,,0,0,0,,,,,,
763,268,518,763,268,518,,,0,0,0,,,,,,
764,269,543,764,269,543,,,0,0,0,,,,,,
764,270,568,764,270,568,,,0,0,0,,,,,,
764,271,593,764,271,593,,,0,0,0,,,,,,
765,273,617,764,272,617,,,1,1,0,,,,,,
765,274,642,765,274,642,,,0,0,0,,,,,,
765,275,667,765,275,667,,,0,0,0,,,,,,
766,277,692,766,277,692,,,0,0,0,,,,,,
766,278,718,766,278,717,,,0,0,1,,,,,,
767,280,743,767,280,743,,,0,0,0,,,,,,
767,281,768,767,281,768,,,0,0,0,,,,,,
762,275,123,762,276,123,,,0,-1,0,,,,,,
762,275,125,762,276,123,,,0,-1,2,,,,,,
762,275,130,762,276,129,,,0,-1,1,,,,,,
762,275,138,762,276,139,,,0,-1,-1,,,,,,
762,275,150,762,276,150,,,0,-1,0,,,,,,
762,275,164,762,276,165,,,0,-1,-1,,,,,,
762,275,181,762,276,181,,,0,-1,0,,,,,,
762,276,199,762,276,200,,,0,0,-1,,,,,,
762,276,219,762,277,219,,,0,-1,0,,,,,,
762,276,240,762,277,240,,,0,-1,0,,,,,,
762,277,261,762,277,261,,,0,0,0,,,,,,
763,277,283,762,278,283,,,1,-1,0,,,,,,
763,278,305,763,278,305,,,0,0,0,,,,,,
763,278,328,763,279,328,,,0,-1,0,,,,,,
763,279,351,763,279,351,,,0,0,0,,,,,,
763,279,374,763,280,374,,,0,-1,0,,,,,,
763,280,398,763,280,398,,,0,0,0,,,,,,
764,281,422,763,281,422,,,1,0,0,,,,,,
764,282,446,764,282,446,,,0,0,0,,,,,,
764,282,470,764,283,470,,,0,-1,0,,,,,,
764,283,495,764,284,494,,,0,-1,1,,,,,,
765,284,519,765,285,519,,,0,-1,0,,,,,,
765,285,544,765,286,543,,,0,-1,1,,,,,,
765,286,568,765,287,568,,,0,-1,0,,,,,,
766,287,593,766,288,593,,,0,-1,0,,,,,,
766,289,618,766,289,617,,,0,0,1,,,,,,
767,290,643,766,291,642,,,1,-1,1,,,,,,
767,291,668,767,292,667,,,0,-1,1,,,,,,
767,292,693,767,293,692,,,0,-1,1,,,,,,
768,294,718,768,295,718,,,0,-1,0,,,,,,
768,295,743,768,296,743,,,0,-1,0,,,,,,
769,297,768,769,297,768,,,0,0,0,,,,,,
764,294,126,764,294,126,,,0,0,0,,,,,,
764,294,128,764,294,126,,,0,0,2,,,,,,
764,294,132,764,294,132,,,0,0,0,,,,,,
764,294,141,764,294,142,,,0,0,-1,,,,,,
764,294,152,764,294,152,,,0,0,0,,,,,,
764,294,167,764,294,167,,,0,0,0,,,,,,
764,294,183,764,294,183,,,0,0,0,,,,,,
764,294,201,764,294,202,,,0,0,-1,,,,,,
764,295,221,764,295,221,,,0,0,0,,,,,,
764,295,241,764,295,241,,,0,0,0,,,,,,
764,295,262,764,295,262,,,0,0,0,,,,,,
764,296,284,764,295,284,,,0,1,0,,,,,,
765,296,306,765,296,306,,,0,0,0,,,,,,
765,297,329,765,296,329,,,0,1,0,,,,,,
765,297,352,765,297,352,,,0,0,0,,,,,,
765,298,375,765,297,375,,,0,1,0,,,,,,
765,298,399,765,298,399,,,0,0,0,,,,,,
765,299,423,765,299,423,,,0,0,0,,,,,,
766,300,447,766,300,447,,,0,0,0,,,,,,
766,301,471,766,301,471,,,0,0,0,,,,,,
766,302,495,766,302,495,,,0,0,0,,,,,,
767,302,520,766,302,519,,,1,0,1,,,,,,
767,303,544,767,303,544,,,0,0,0,,,,,,
767,304,569,767,304,568,,,0,0,1,,,,,,
768,305,593,768,305,593,,,0,0,0,,,,,,
768,306,618,768,306,618,,,0,0,0,,,,,,
768,308,643,768,308,643,,,0,0,0,,,,,,
769,309,668,768,309,668,,,1,0,0,,,,,,
769,310,693,769,310,693,,,0,0,0,,,,,,
770,311,718,769,311,718,,,1,0,0,,,,,,
770,313,744,770,313,744,,,0,0,0,,,,,,
771,314,769,770,314,769,,,1,0,0,,,,,,
766,314,130,766,314,129,,,0,0,1,,,,,,
766,314,131,766,314,129,,,0,0,2,,,,,,
766,314,135,766,314,135,,,0,0,0,,,,,,
766,314,144,766,314,145,,,0,0,-1,,,,,,
766,314,155,766,315,155,,,0,-1,0,,,,,,
766,314,169,766,315,170,,,0,-1,-1,,,,,,
766,314,185,766,315,185,,,0,-1,0,,,,,,
766,315,203,766,315,204,,,0,0,-1,,,,,,
766,315,222,766,315,222,,,0,0,0,,,,,,
766,315,243,766,315,243,,,0,0,0,,,,,,
766,315,264,766,316,263,,,0,-1,1,,,,,,
766,316,285,766,316,285,,,0,0,0,,,,,,
767,316,307,767,317,307,,,0,-1,0,,,,,,
767,317,330,767,317,330,,,0,0,0,,,,,,
767,317,353,767,318,353,,,0,-1,0,,,,,,
767,318,376,767,318,376,,,0,0,0,,,,,,
767,318,400,767,319,400,,,0,-1,0,,,,,,
768,319,424,767,319,423,,,1,0,1,,,,,,
768,320,448,768,320,447,,,0,0,1,,,,,,
768,320,472,768,321,471,,,0,-1,1,,,,,,
768,321,496,768,322,496,,,0,-1,0,,,,,,
769,322,520,768,322,520,,,1,0,0,,,,,,
769,323,545,769,323,545,,,0,0,0,,,,,,
769,324,569,769,324,569,,,0,0,0,,,,,,
770,325,594,770,325,594,,,0,0,0,,,,,,
770,326,619,770,326,618,,,0,0,1,,,,,,
770,327,644,770,328,643,,,0,-1,1,,,,,,
771,328,669,771,329,668,,,0,-1,1,,,,,,
771,329,694,771,330,693,,,0,-1,1,,,,,,
772,330,719,772,331,719,,,0,-1,0,,,,,,
772,332,744,772,332,744,,,0,0,0,,,,,,
773,333,769,773,333,769,,,0,0,0,,,,,,
768,335,133,768,335,133,,,0,0,0,,,,,,
768,335,134,768,335,133,,,0,0,1,,,,,,
768,335,139,768,335,139,,,0,0,0,,,,,,
768,336,147,768,335,148,,,0,1,-1,,,,,,
768,336,158,768,336,158,,,0,0,0,,,,,,
768,336,172,768,336,173,,,0,0,-1,,,,,,
768,336,188,768,336,188,,,0,0,0,,,,,,
768,336,205,768,336,206,,,0,0,-1,,,,,,
768,336,224,768,336,224,,,0,0,0,,,,,,
769,337,244,768,336,244,,,1,1,0,,,,,,
769,337,265,769,337,265,,,0,0,0,,,,,,
769,337,287,769,337,287,,,0,0,0,,,,,,
769,338,309,769,338,309,,,0,0,0,,,,,,
769,338,331,769,338,331,,,0,0,0,,,,,,
769,339,354,769,339,354,,,0,0,0,,,,,,
770,339,377,769,339,377,,,1,0,0,,,,,,
770,340,401,770,340,401,,,0,0,0,,,,,,
770,340,425,770,340,424,,,0,0,1,,,,,,
770,341,448,770,341,448,,,0,0,0,,,,,,
770,342,472,770,341,472,,,0,1,0,,,,,,
771,342,497,771,342,497,,,0,0,0,,,,,,
771,343,521,771,343,521,,,0,0,0,,,,,,
771,344,546,771,344,546,,,0,0,0,,,,,,
772,345,570,771,345,570,,,1,0,0,,,,,,
772,346,595,772,346,595,,,0,0,0,,,,,,
772,347,620,772,347,619,,,0,0,1,,,,,,
773,348,644,773,348,644,,,0,0,0,,,,,,
773,349,669,773,349,669,,,0,0,0,,,,,,
774,350,694,774,350,694,,,0,0,0,,,,,,
774,351,719,774,351,719,,,0,0,0,,,,,,
775,352,745,775,352,745,,,0,0,0,,,,,,
775,353,770,775,353,770,,,0,0,0,,,,,,
771,358,137,771,358,137,,,0,0,0,,,,,,
771,358,138,771,358,137,,,0,0,1,,,,,,
771,358,143,771,358,143,,,0,0,0,,,,,,
771,358,150,771,358,152,,,0,0,-2,,,,,,
771,358,161,771,359,161,,,0,-1,0,,,,,,
771,358,175,771,359,176,,,0,-1,-1,,,,,,
771,358,190,771,359,190,,,0,-1,0,,,,,,
771,359,208,771,359,208,,,0,0,0,,,,,,
771,359,227,771,359,226,,,0,0,1,,,,,,
771,359,246,771,359,246,,,0,0,0,,,,,,
771,359,267,771,360,267,,,0,-1,0,,,,,,
772,360,288,771,360,288,,,1,0,0,,,,,,
772,360,310,772,360,310,,,0,0,0,,,,,,
772,361,333,772,361,333,,,0,0,0,,,,,,
772,361,356,772,361,355,,,0,0,1,,,,,,
772,361,379,772,362,378,,,0,-1,1,,,,,,
772,362,402,772,362,402,,,0,0,0,,,,,,
773,363,426,772,363,425,,,1,0,1,,,,,,
773,363,449,773,363,449,,,0,0,0,,,,,,
773,364,473,773,364,473,,,0,0,0,,,,,,
773,364,498,773,364,498,,,0,0,0,,,,,,
774,365,522,773,365,522,,,1,0,0,,,,,,
774,366,546,774,366,546,,,0,0,0,,,,,,
774,367,571,774,367,571,,,0,0,0,,,,,,
775,368,596,775,368,595,,,0,0,1,,,,,,
775,368,620,775,369,620,,,0,-1,0,,,,,,
775,369,645,775,370,645,,,0,-1,0,,,,,,
776,370,670,776,371,670,,,0,-1,0,,,,,,
776,371,695,776,372,695,,,0,-1,0,,,,,,
777,372,720,777,373,720,,,0,-1,0,,,,,,
777,373,745,777,374,745,,,0,-1,0,,,,,,
778,375,770,778,375,770,,,0,0,0,,,,,,
774,381,141,774,381,141,,,0,0,0,,,,,,
774,381,143,774,381,141,,,0,0,2,,,,,,
774,382,147,774,382,147,,,0,0,0,,,,,,
774,382,154,774,382,156,,,0,0,-2,,,,,,
774,382,165,774,382,165,,,0,0,0,,,,,,
774,382,178,774,382,179,,,0,0,-1,,,,,,
774,382,193,774,382,193,,,0,0,0,,,,,,
774,382,211,774,382,211,,,0,0,0,,,,,,
774,382,229,774,382,229,,,0,0,0,,,,,,
774,383,249,774,382,249,,,0,1,0,,,,,,
774,383,269,774,383,269,,,0,0,0,,,,,,
775,383,290,774,383,290,,,1,0,0,,,,,,
775,383,312,775,383,312,,,0,0,0,,,,,,
775,384,334,775,383,334,,,0,1,0,,,,,,
775,384,357,775,384,357,,,0,0,0,,,,,,
775,385,380,775,384,380,,,0,1,0,,,,,,
775,385,403,775,385,403,,,0,0,0,,,,,,
776,386,427,775,385,427,,,1,1,0,,,,,,
776,386,451,776,386,451,,,0,0,0,,,,,,
776,387,475,776,386,475,,,0,1,0,,,,,,
776,387,499,776,387,499,,,0,0,0,,,,,,
777,388,523,776,388,523,,,1,0,0,,,,,,
777,389,547,777,389,547,,,0,0,0,,,,,,
777,390,572,777,389,571,,,0,1,1,,,,,,
778,390,596,778,390,596,,,0,0,0,,,,,,
778,391,621,778,391,621,,,0,0,0,,,,,,
778,392,646,778,392,646,,,0,0,0,,,,,,
779,393,671,778,393,671,,,1,0,0,,,,,,
779,394,696,779,394,696,,,0,0,0,,,,,,
780,395,721,779,395,721,,,1,0,0,,,,,,
780,396,746,780,396,746,,,0,0,0,,,,,,
781,397,771,780,397,771,,,1,0,0,,,,,,
777,406,146,777,405,146,,,0,1,0,,,,,,
777,406,147,777,405,146,,,0,1,1,,,,,,
777,406,151,777,406,151,,,0,0,0,,,,,,
777,406,158,777,406,160,,,0,0,-2,,,,,,
777,406,169,777,406,169,,,0,0,0,,,,,,
777,406,182,777,406,182,,,0,0,0,,,,,,
777,406,197,777,406,196,,,0,0,1,,,,,,
777,406,213,777,406,214,,,0,0,-1,,,,,,
777,406,232,777,406,232,,,0,0,0,,,,,,
778,407,251,777,407,251,,,1,0,0,,,,,,
778,407,271,777,407,271,,,1,0,0,,,,,,
778,407,292,778,407,292,,,0,0,0,,,,,,
778,407,314,778,407,314,,,0,0,0,,,,,,
778,408,336,778,408,336,,,0,0,0,,,,,,
778,408,359,778,408,359,,,0,0,0,,,,,,
779,409,382,778,409,381,,,1,0,1,,,,,,
779,409,405,778,409,404,,,1,0,1,,,,,,
779,410,428,779,410,428,,,0,0,0,,,,,,
779,410,452,779,410,452,,,0,0,0,,,,,,
779,411,476,779,411,476,,,0,0,0,,,,,,
780,411,500,779,411,500,,,1,0,0,,,,,,
780,412,524,780,412,524,,,0,0,0,,,,,,
780,413,548,780,413,548,,,0,0,0,,,,,,
781,413,573,781,413,572,,,0,0,1,,,,,,
781,414,597,781,414,597,,,0,0,0,,,,,,
781,415,622,781,415,622,,,0,0,0,,,,,,
782,416,647,781,416,647,,,1,0,0,,,,,,
782,416,672,782,416,671,,,0,0,1,,,,,,
783,417,696,782,417,696,,,1,0,0,,,,,,
783,418,721,783,418,721,,,0,0,0,,,,,,
783,419,747,783,419,746,,,0,0,1,,,,,,
784,420,772,784,420,771,,,0,0,1,,,,,,
781,430,151,781,430,151,,,0,0,0,,,,,,
781,430,152,781,430,151,,,0,0,1,,,,,,
781,431,156,781,431,156,,,0,0,0,,,,,,
781,431,163,781,431,164,,,0,0,-1,,,,,,
781,431,173,781,431,173,,,0,0,0,,,,,,
781,431,185,781,431,186,,,0,0,-1,,,,,,
781,431,200,781,431,200,,,0,0,0,,,,,,
781,431,217,781,431,217,,,0,0,0,,,,,,
781,431,235,781,431,235,,,0,0,0,,,,,,
781,431,254,781,431,254,,,0,0,0,,,,,,
781,432,274,781,432,274,,,0,0,0,,,,,,
781,432,295,781,432,295,,,0,0,0,,,,,,
782,432,316,782,432,316,,,0,0,0,,,,,,
782,433,338,782,432,338,,,0,1,0,,,,,,
782,433,361,782,433,361,,,0,0,0,,,,,,
782,433,383,782,433,383,,,0,0,0,,,,,,
782,434,406,782,434,406,,,0,0,0,,,,,,
783,434,430,782,434,429,,,1,0,1,,,,,,
783,435,453,783,435,453,,,0,0,0,,,,,,
783,435,477,783,435,477,,,0,0,0,,,,,,
783,436,501,783,436,501,,,0,0,0,,,,,,
784,436,525,783,436,525,,,1,0,0,,,,,,
784,437,549,784,437,549,,,0,0,0,,,,,,
784,438,574,784,437,573,,,0,1,1,,,,,,
785,438,598,785,438,598,,,0,0,0,,,,,,
785,439,623,785,439,623,,,0,0,0,,,,,,
785,440,648,785,440,648,,,0,0,0,,,,,,
786,441,672,785,440,672,,,1,1,0,,,,,,
786,441,697,786,441,697,,,0,0,0,,,,,,
787,442,722,786,442,722,,,1,0,0,,,,,,
787,443,747,787,443,747,,,0,0,0,,,,,,
787,444,772,787,444,772,,,0,0,0,,,,,,
785,456,156,785,456,156,,,0,0,0,,,,,,
785,456,157,785,456,156,,,0,0,1,,,,,,
785,456,161,785,456,161,,,0,0,0,,,,,,
785,456,168,785,456,169,,,0,0,-1,,,,,,
785,456,177,785,456,177,,,0,0,0,,,,,,
785,456,189,785,456,190,,,0,0,-1,,,,,,
785,456,204,785,456,204,,,0,0,0,,,,,,
785,456,220,785,456,221,,,0,0,-1,,,,,,
785,456,238,785,456,238,,,0,0,0,,,,,,
785,457,257,785,457,257,,,0,0,0,,,,,,
785,457,276,785,457,276,,,0,0,0,,,,,,
785,457,297,785,457,297,,,0,0,0,,,,,,
785,457,318,786,457,318,,,-1,0,0,,,,,,
786,458,340,786,458,340,,,0,0,0,,,,,,
786,458,362,786,458,363,,,0,0,-1,,,,,,
786,458,385,786,458,385,,,0,0,0,,,,,,
786,459,408,786,459,408,,,0,0,0,,,,,,
786,459,431,786,459,431,,,0,0,0,,,,,,
787,460,455,787,460,454,,,0,0,1,,,,,,
787,460,479,787,460,478,,,0,0,1,,,,,,
787,461,502,787,461,502,,,0,0,0,,,,,,
787,461,526,787,461,526,,,0,0,0,,,,,,
788,462,551,788,462,550,,,0,0,1,,,,,,
788,462,575,788,462,575,,,0,0,0,,,,,,
788,463,599,789,463,599,,,-1,0,0,,,,,,
789,464,624,789,464,624,,,0,0,0,,,,,,
789,465,649,789,465,649,,,0,0,0,,,,,,
790,465,673,789,465,673,,,1,0,0,,,,,,
790,466,698,790,466,698,,,0,0,0,,,,,,
790,467,723,790,467,723,,,0,0,0,,,,,,
791,468,748,791,468,748,,,0,0,0,,,,,,
791,469,773,791,469,773,,,0,0,0,,,,,,
789,482,161,789,482,161,,,0,0,0,,,,,,
789,482,162,789,482,161,,,0,0,1,,,,,,
789,482,166,789,482,166,,,0,0,0,,,,,,
789,482,172,789,482,174,,,0,0,-2,,,,,,
789,482,182,789,482,182,,,0,0,0,,,,,,
789,482,194,789,482,195,,,0,0,-1,,,,,,
789,482,208,789,482,208,,,0,0,0,,,,,,
789,482,224,789,482,224,,,0,0,0,,,,,,
789,482,241,789,482,241,,,0,0,0,,,,,,
789,482,260,789,482,260,,,0,0,0,,,,,,
789,483,279,789,483,279,,,0,0,0,,,,,,
790,483,300,789,483,300,,,1,0,0,,,,,,
790,483,321,790,483,321,,,0,0,0,,,,,,
790,483,342,790,483,343,,,0,0,-1,,,,,,
790,484,365,790,484,365,,,0,0,0,,,,,,
790,484,387,790,484,387,,,0,0,0,,,,,,
790,484,410,790,484,410,,,0,0,0,,,,,,
791,485,433,790,484,433,,,1,1,0,,,,,,
791,485,456,791,485,456,,,0,0,0,,,,,,
791,486,480,791,485,480,,,0,1,0,,,,,,
791,486,504,791,486,504,,,0,0,0,,,,,,
792,487,528,791,486,528,,,1,1,0,,,,,,
792,487,552,792,487,552,,,0,0,0,,,,,,
792,488,576,792,488,576,,,0,0,0,,,,,,
793,489,601,793,489,601,,,0,0,0,,,,,,
793,489,625,793,489,625,,,0,0,0,,,,,,
793,490,650,793,490,650,,,0,0,0,,,,,,
794,491,674,793,490,674,,,1,1,0,,,,,,
794,491,699,794,491,699,,,0,0,0,,,,,,
795,492,724,794,492,724,,,1,0,0,,,,,,
795,493,749,795,493,749,,,0,0,0,,,,,,
796,494,774,795,494,774,,,1,0,0,,,,,,
793,508,167,793,508,166,,,0,0,1,,,,,,
793,508,168,793,508,166,,,0,0,2,,,,,,
793,508,171,793,508,171,,,0,0,0,,,,,,
793,508,178,793,508,179,,,0,0,-1,,,,,,
793,508,187,793,508,187,,,0,0,0,,,,,,
793,508,198,793,508,199,,,0,0,-1,,,,,,
794,508,212,793,508,212,,,1,0,0,,,,,,
794,508,228,793,508,228,,,1,0,0,,,,,,
794,508,245,793,508,244,,,1,0,1,,,,,,
794,509,263,793,508,263,,,1,1,0,,,,,,
794,509,282,794,509,282,,,0,0,0,,,,,,
794,509,303,794,509,303,,,0,0,0,,,,,,
794,509,323,794,509,323,,,0,0,0,,,,,,
794,509,345,794,509,345,,,0,0,0,,,,,,
794,510,367,794,510,367,,,0,0,0,,,,,,
795,510,389,794,510,389,,,1,0,0,,,,,,
795,510,412,795,510,412,,,0,0,0,,,,,,
795,511,435,795,511,435,,,0,0,0,,,,,,
795,511,458,795,511,458,,,0,0,0,,,,,,
796,512,482,795,511,481,,,1,1,1,,,,,,
796,512,505,796,512,505,,,0,0,0,,,,,,
796,513,529,796,512,529,,,0,1,0,,,,,,
796,513,553,796,513,553,,,0,0,0,,,,,,
797,514,578,797,513,577,,,0,1,1,,,,,,
797,514,602,797,514,602,,,0,0,0,,,,,,
797,515,626,797,515,626,,,0,0,0,,,,,,
798,516,651,798,516,651,,,0,0,0,,,,,,
798,516,676,798,516,675,,,0,0,1,,,,,,
799,517,700,798,517,700,,,1,0,0,,,,,,
799,518,725,799,517,725,,,0,1,0,,,,,,
800,518,750,799,518,750,,,1,0,0,,,,,,
800,519,775,800,519,775,,,0,0,0,,,,,,
798,534,172,798,534,172,,,0,0,0,,,,,,
798,534,173,798,534,172,,,0,0,1,,,,,,
798,534,177,798,534,177,,,0,0,0,,,,,,
798,534,183,798,534,184,,,0,0,-1,,,,,,
798,534,192,798,534,192,,,0,0,0,,,,,,
798,535,203,798,534,204,,,0,1,-1,,,,,,
798,535,216,798,535,216,,,0,0,0,,,,,,
798,535,232,798,535,232,,,0,0,0,,,,,,
798,535,248,798,535,248,,,0,0,0,,,,,,
799,535,266,798,535,267,,,1,0,-1,,,,,,
799,535,286,799,535,286,,,0,0,0,,,,,,
799,535,305,799,535,306,,,0,0,-1,,,,,,
799,536,326,799,536,326,,,0,0,0,,,,,,
799,536,347,799,536,347,,,0,0,0,,,,,,
799,536,369,799,536,369,,,0,0,0,,,,,,
799,537,391,799,536,391,,,0,1,0,,,,,,
800,537,414,800,537,414,,,0,0,0,,,,,,
800,537,437,800,537,437,,,0,0,0,,,,,,
800,538,460,800,538,460,,,0,0,0,,,,,,
800,538,483,800,538,483,,,0,0,0,,,,,,
801,538,507,801,538,507,,,0,0,0,,,,,,
801,539,531,801,538,531,,,0,1,0,,,,,,
801,539,555,801,539,555,,,0,0,0,,,,,,
802,540,579,801,539,579,,,1,1,0,,,,,,
802,540,603,802,540,603,,,0,0,0,,,,,,
802,541,628,802,541,627,,,0,0,1,,,,,,
803,542,652,803,542,652,,,0,0,0,,,,,,
803,542,677,803,542,677,,,0,0,0,,,,,,
803,543,702,803,543,702,,,0,0,0,,,,,,
804,544,726,803,543,726,,,1,1,0,,,,,,
804,544,751,804,544,751,,,0,0,0,,,,,,
805,545,776,804,545,776,,,1,0,0,,,,,,
803,561,178,803,561,178,,,0,0,0,,,,,,
803,561,179,803,561,178,,,0,0,1,,,,,,
803,561,182,803,561,182,,,0,0,0,,,,,,
803,561,188,803,561,189,,,0,0,-1,,,,,,
803,561,197,803,561,197,,,0,0,0,,,,,,
803,561,208,803,561,209,,,0,0,-1,,,,,,
803,561,221,803,561,221,,,0,0,0,,,,,,
803,562,236,803,561,236,,,0,1,0,,,,,,
804,562,252,803,562,252,,,1,0,0,,,,,,
804,562,270,803,562,270,,,1,0,0,,,,,,
804,562,289,804,562,289,,,0,0,0,,,,,,
804,562,309,804,562,309,,,0,0,0,,,,,,
804,562,329,804,562,329,,,0,0,0,,,,,,
804,563,350,804,562,350,,,0,1,0,,,,,,
804,563,372,804,563,371,,,0,0,1,,,,,,
805,563,394,804,563,394,,,1,0,0,,,,,,
805,564,416,805,563,416,,,0,1,0,,,,,,
805,564,439,805,564,439,,,0,0,0,,,,,,
805,564,462,805,564,462,,,0,0,0,,,,,,
805,565,485,805,564,485,,,0,1,0,,,,,,
806,565,509,806,565,509,,,0,0,0,,,,,,
806,565,533,806,565,532,,,0,0,1,,,,,,
806,566,557,806,566,556,,,0,0,1,,,,,,
807,566,581,806,566,580,,,1,0,1,,,,,,
807,567,605,807,567,604,,,0,0,1,,,,,,
807,568,629,807,567,629,,,0,1,0,,,,,,
808,568,654,808,568,653,,,0,0,1,,,,,,
808,569,678,808,569,678,,,0,0,0,,,,,,
808,569,703,808,569,703,,,0,0,0,,,,,,
809,570,728,809,570,727,,,0,0,1,,,,,,
809,571,752,809,570,752,,,0,1,0,,,,,,
810,571,777,810,571,777,,,0,0,0,,,,,,
809,588,184,809,588,184,,,0,0,0,,,,,,
809,588,185,809,588,184,,,0,0,1,,,,,,
809,588,188,809,588,188,,,0,0,0,,,,,,
809,588,194,809,588,195,,,0,0,-1,,,,,,
809,588,202,809,588,202,,,0,0,0,,,,,,
809,588,213,809,588,214,,,0,0,-1,,,,,,
809,588,226,809,588,226,,,0,0,0,,,,,,
809,589,240,809,588,241,,,0,1,-1,,,,,,
809,589,256,809,589,256,,,0,0,0,,,,,,
809,589,274,809,589,274,,,0,0,0,,,,,,
809,589,292,809,589,292,,,0,0,0,,,,,,
809,589,312,809,589,312,,,0,0,0,,,,,,
809,589,332,809,589,332,,,0,0,0,,,,,,
810,590,353,809,589,353,,,1,1,0,,,,,,
810,590,374,810,590,374,,,0,0,0,,,,,,
810,590,396,810,590,396,,,0,0,0,,,,,,
810,590,419,810,590,419,,,0,0,0,,,,,,
810,591,441,810,590,441,,,0,1,0,,,,,,
811,591,464,811,591,464,,,0,0,0,,,,,,
811,592,487,811,591,487,,,0,1,0,,,,,,
811,592,511,811,592,511,,,0,0,0,,,,,,
811,592,534,811,592,534,,,0,0,0,,,,,,
812,593,558,812,593,558,,,0,0,0,,,,,,
812,593,582,812,593,582,,,0,0,0,,,,,,
812,594,606,812,594,606,,,0,0,0,,,,,,
813,594,631,812,594,630,,,1,0,1,,,,,,
813,595,655,813,595,655,,,0,0,0,,,,,,
813,595,680,813,595,679,,,0,0,1,,,,,,
814,596,704,814,596,704,,,0,0,0,,,,,,
814,597,729,814,596,729,,,0,1,0,,,,,,
815,597,754,815,597,754,,,0,0,0,,,,,,
815,598,778,815,598,778,,,0,0,0,,,,,,
814,616,190,814,615,190,,,0,1,0,,,,,,
814,616,191,814,615,190,,,0,1,1,,,,,,
814,616,194,814,615,194,,,0,1,0,,,,,,
814,616,200,814,615,201,,,0,1,-1,,,,,,
814,616,208,814,615,208,,,0,1,0,,,,,,
814,616,218,814,615,219,,,0,1,-1,,,,,,
814,616,231,814,615,231,,,0,1,0,,,,,,
815,616,245,814,615,245,,,1,1,0,,,,,,
815,616,261,815,616,260,,,0,0,1,,,,,,
815,616,278,815,616,278,,,0,0,0,,,,,,
815,616,296,815,616,296,,,0,0,0,,,,,,
815,616,315,815,616,315,,,0,0,0,,,,,,
815,617,335,815,616,335,,,0,1,0,,,,,,
815,617,356,815,617,356,,,0,0,0,,,,,,
815,617,377,815,617,377,,,0,0,0,,,,,,
816,617,399,815,617,399,,,1,0,0,,,,,,
816,618,421,816,617,421,,,0,1,0,,,,,,
816,618,444,816,618,444,,,0,0,0,,,,,,
816,618,466,816,618,466,,,0,0,0,,,,,,
817,619,489,816,618,489,,,1,1,0,,,,,,
817,619,513,817,619,513,,,0,0,0,,,,,,
817,619,536,817,619,536,,,0,0,0,,,,,,
817,620,560,817,620,560,,,0,0,0,,,,,,
818,620,584,817,620,584,,,1,0,0,,,,,,
818,621,608,818,621,608,,,0,0,0,,,,,,
818,621,632,818,621,632,,,0,0,0,,,,,,
819,622,657,819,622,656,,,0,0,1,,,,,,
819,622,681,819,622,681,,,0,0,0,,,,,,
819,623,706,819,623,705,,,0,0,1,,,,,,
820,623,730,820,623,730,,,0,0,0,,,,,,
820,624,755,820,624,755,,,0,0,0,,,,,,
821,625,780,821,624,779,,,0,1,1,,,,,,
820,643,197,820,643,197,,,0,0,0,,,,,,
820,643,198,820,643,197,,,0,0,1,,,,,,
820,643,200,820,643,200,,,0,0,0,,,,,,
820,643,206,820,643,207,,,0,0,-1,,,,,,
820,643,214,820,643,214,,,0,0,0,,,,,,
820,643,224,820,643,225,,,0,0,-1,,,,,,
820,643,236,820,643,236,,,0,0,0,,,,,,
821,643,250,820,643,250,,,1,0,0,,,,,,
821,643,265,821,643,265,,,0,0,0,,,,,,
821,644,282,821,643,282,,,0,1,0,,,,,,
821,644,300,821,644,300,,,0,0,0,,,,,,
821,644,319,821,644,319,,,0,0,0,,,,,,
821,644,339,821,644,339,,,0,0,0,,,,,,
821,644,359,821,644,359,,,0,0,0,,,,,,
821,645,380,821,645,380,,,0,0,0,,,,,,
822,645,402,821,645,402,,,1,0,0,,,,,,
822,645,424,822,645,424,,,0,0,0,,,,,,
822,645,446,822,645,446,,,0,0,0,,,,,,
822,646,469,822,646,469,,,0,0,0,,,,,,
822,646,492,822,646,492,,,0,0,0,,,,,,
823,646,515,823,646,515,,,0,0,0,,,,,,
823,647,538,823,646,538,,,0,1,0,,,,,,
823,647,562,823,647,562,,,0,0,0,,,,,,
824,648,586,823,647,586,,,1,1,0,,,,,,
824,648,610,824,648,610,,,0,0,0,,,,,,
824,649,634,824,648,634,,,0,1,0,,,,,,
825,649,658,825,649,658,,,0,0,0,,,,,,
825,650,683,825,649,682,,,0,1,1,,,,,,
825,650,707,825,650,707,,,0,0,0,,,,,,
826,651,732,825,650,731,,,1,1,1,,,,,,
826,651,756,826,651,756,,,0,0,0,,,,,,
827,652,781,826,651,781,,,1,1,0,,,,,,
827,671,203,826,671,203,,,1,0,0,,,,,,
827,671,204,826,671,203,,,1,0,1,,,,,,
827,671,207,826,671,206,,,1,0,1,,,,,,
827,671,212,826,671,213,,,1,0,-1,,,,,,
827,671,219,826,671,219,,,1,0,0,,,,,,
827,671,229,826,671,230,,,1,0,-1,,,,,,
827,671,241,826,671,241,,,1,0,0,,,,,,
827,671,255,826,671,255,,,1,0,0,,,,,,
827,671,270,827,671,270,,,0,0,0,,,,,,
827,671,286,827,671,287,,,0,0,-1,,,,,,
827,671,304,827,671,304,,,0,0,0,,,,,,
827,672,323,827,671,323,,,0,1,0,,,,,,
827,672,342,827,672,342,,,0,0,0,,,,,,
827,672,363,827,672,363,,,0,0,0,,,,,,
828,672,383,827,672,383,,,1,0,0,,,,,,
828,672,405,828,672,405,,,0,0,0,,,,,,
828,673,427,828,673,426,,,0,0,1,,,,,,
828,673,449,828,673,449,,,0,0,0,,,,,,
828,673,471,828,673,471,,,0,0,0,,,,,,
829,674,494,828,673,494,,,1,1,0,,,,,,
829,674,517,829,674,517,,,0,0,0,,,,,,
829,674,540,829,674,540,,,0,0,0,,,,,,
830,675,564,829,674,564,,,1,1,0,,,,,,
830,675,588,830,675,588,,,0,0,0,,,,,,
830,676,612,830,675,612,,,0,1,0,,,,,,
830,676,636,830,676,636,,,0,0,0,,,,,,
831,676,660,831,676,660,,,0,0,0,,,,,,
831,677,684,831,677,684,,,0,0,0,,,,,,
832,677,709,831,677,708,,,1,0,1,,,,,,
832,678,733,832,678,733,,,0,0,0,,,,,,
832,679,758,832,678,757,,,0,1,1,,,,,,
833,679,782,833,679,782,,,0,0,0,,,,,,
833,699,210,833,699,210,,,0,0,0,,,,,,
833,699,210,833,699,210,,,0,0,0,,,,,,
833,699,213,833,699,213,,,0,0,0,,,,,,
833,699,218,833,699,219,,,0,0,-1,,,,,,
833,699,225,833,699,225,,,0,0,0,,,,,,
833,699,235,833,699,235,,,0,0,0,,,,,,
833,699,246,833,699,246,,,0,0,0,,,,,,
833,699,260,833,699,260,,,0,0,0,,,,,,
833,699,275,833,699,275,,,0,0,0,,,,,,
833,699,291,833,699,291,,,0,0,0,,,,,,
834,699,308,834,699,308,,,0,0,0,,,,,,
834,699,327,834,699,327,,,0,0,0,,,,,,
834,700,346,834,700,346,,,0,0,0,,,,,,
834,700,366,834,700,366,,,0,0,0,,,,,,
834,700,387,834,700,387,,,0,0,0,,,,,,
834,700,408,834,700,408,,,0,0,0,,,,,,
835,701,429,835,701,429,,,0,0,0,,,,,,
835,701,451,835,701,451,,,0,0,0,,,,,,
835,701,474,835,701,474,,,0,0,0,,,,,,
835,701,497,835,701,496,,,0,0,1,,,,,,
835,702,519,835,702,519,,,0,0,0,,,,,,
836,702,543,835,702,542,,,1,0,1,,,,,,
836,702,566,836,702,566,,,0,0,0,,,,,,
836,703,590,836,702,590,,,0,1,0,,,,,,
837,703,614,837,703,614,,,0,0,0,,,,,,
837,704,638,837,703,638,,,0,1,0,,,,,,
837,704,662,837,704,662,,,0,0,0,,,,,,
838,705,686,837,704,686,,,1,1,0,,,,,,
838,705,710,838,705,710,,,0,0,0,,,,,,
838,706,735,838,705,734,,,0,1,1,,,,,,
839,706,759,839,706,759,,,0,0,0,,,,,,
839,707,784,839,706,784,,,0,1,0,,,,,,
840,727,216,840,727,216,,,0,0,0,,,,,,
840,727,217,840,727,216,,,0,0,1,,,,,,
840,727,220,840,727,219,,,0,0,1,,,,,,
840,727,224,840,727,225,,,0,0,-1,,,,,,
840,727,232,840,727,231,,,0,0,1,,,,,,
840,727,241,840,727,241,,,0,0,0,,,,,,
840,727,252,840,727,252,,,0,0,0,,,,,,
840,727,265,840,727,266,,,0,0,-1,,,,,,
840,727,280,840,727,280,,,0,0,0,,,,,,
840,727,296,840,727,296,,,0,0,0,,,,,,
840,727,313,840,727,312,,,0,0,1,,,,,,
841,727,331,840,727,331,,,1,0,0,,,,,,
841,728,350,841,728,350,,,0,0,0,,,,,,
841,728,370,841,728,370,,,0,0,0,,,,,,
841,728,390,841,728,390,,,0,0,0,,,,,,
841,728,411,841,728,411,,,0,0,0,,,,,,
841,728,432,841,729,432,,,0,-1,0,,,,,,
842,729,454,841,729,454,,,1,0,0,,,,,,
842,729,477,842,729,476,,,0,0,1,,,,,,
842,729,499,842,729,499,,,0,0,0,,,,,,
842,730,522,842,730,521,,,0,0,1,,,,,,
843,730,545,842,730,545,,,1,0,0,,,,,,
843,730,568,843,730,568,,,0,0,0,,,,,,
843,731,592,843,730,592,,,0,1,0,,,,,,
843,731,616,843,731,616,,,0,0,0,,,,,,
844,731,639,843,731,639,,,1,0,0,,,,,,
844,732,663,844,732,663,,,0,0,0,,,,,,
844,732,688,844,732,687,,,0,0,1,,,,,,
845,733,712,845,733,712,,,0,0,0,,,,,,
845,733,736,845,733,736,,,0,0,0,,,,,,
846,734,761,846,734,761,,,0,0,0,,,,,,
846,734,785,846,734,785,,,0,0,0,,,,,,
847,755,223,847,755,223,,,0,0,0,,,,,,
847,755,224,847,755,223,,,0,0,1,,,,,,
847,755,226,847,755,226,,,0,0,0,,,,,,
847,755,231,847,755,232,,,0,0,-1,,,,,,
847,755,238,847,755,238,,,0,0,0,,,,,,
847,755,247,847,755,248,,,0,0,-1,,,,,,
847,755,258,847,755,258,,,0,0,0,,,,,,
847,755,270,847,755,271,,,0,0,-1,,,,,,
847,755,285,847,755,285,,,0,0,0,,,,,,
847,755,300,847,755,301,,,0,0,-1,,,,,,
847,755,317,847,755,317,,,0,0,0,,,,,,
848,756,335,847,755,335,,,1,1,0,,,,,,
848,756,354,848,756,354,,,0,0,0,,,,,,
848,756,373,848,756,374,,,0,0,-1,,,,,,
848,756,394,848,756,394,,,0,0,0,,,,,,
848,756,414,848,756,415,,,0,0,-1,,,,,,
848,757,436,848,757,436,,,0,0,0,,,,,,
849,757,457,848,757,457,,,1,0,0,,,,,,
849,757,479,849,757,479,,,0,0,0,,,,,,
849,757,502,849,757,501,,,0,0,1,,,,,,
849,758,524,849,758,524,,,0,0,0,,,,,,
850,758,547,849,758,547,,,1,0,0,,,,,,
850,758,571,850,758,571,,,0,0,0,,,,,,
850,759,594,850,758,594,,,0,1,0,,,,,,
850,759,618,850,759,618,,,0,0,0,,,,,,
851,759,641,850,759,641,,,1,0,0,,,,,,
851,760,665,851,760,665,,,0,0,0,,,,,,
851,760,690,851,760,689,,,0,0,1,,,,,,
852,761,714,852,761,714,,,0,0,0,,,,,,
852,761,738,852,761,738,,,0,0,0,,,,,,
853,762,763,853,762,763,,,0,0,0,,,,,,
853,762,787,853,762,787,,,0,0,0,,,,,,
854,783,230,854,783,230,,,0,0,0,,,,,,
854,783,230,854,783,230,,,0,0,0,,,,,,
854,783,233,854,783,233,,,0,0,0,,,,,,
854,783,237,854,783,238,,,0,0,-1,,,,,,
854,783,244,854,783,244,,,0,0,0,,,,,,
854,783,253,854,783,254,,,0,0,-1,,,,,,
854,783,263,854,783,263,,,0,0,0,,,,,,
855,783,276,854,783,276,,,1,0,0,,,,,,
855,783,290,854,783,290,,,1,0,0,,,,,,
855,784,305,854,783,306,,,1,1,-1,,,,,,
855,784,322,854,783,322,,,1,1,0,,,,,,
855,784,339,855,783,340,,,0,1,-1,,,,,,
855,784,358,855,784,358,,,0,0,0,,,,,,
855,784,377,855,784,377,,,0,0,0,,,,,,
855,784,397,855,784,397,,,0,0,0,,,,,,
856,785,418,855,784,418,,,1,1,0,,,,,,
856,785,439,855,785,439,,,1,0,0,,,,,,
856,785,460,856,785,460,,,0,0,0,,,,,,
856,785,482,856,785,482,,,0,0,0,,,,,,
856,786,505,856,785,504,,,0,1,1,,,,,,
857,786,527,856,786,527,,,1,0,0,,,,,,
857,786,550,857,786,550,,,0,0,0,,,,,,
857,786,573,857,786,573,,,0,0,0,,,,,,
857,787,596,857,786,596,,,0,1,0,,,,,,
858,787,620,857,787,620,,,1,0,0,,,,,,
858,788,644,858,787,643,,,0,1,1,,,,,,
858,788,667,858,788,667,,,0,0,0,,,,,,
859,788,691,859,788,691,,,0,0,0,,,,,,
859,789,716,859,789,716,,,0,0,0,,,,,,
860,789,740,860,789,740,,,0,0,0,,,,,,
860,790,764,860,790,764,,,0,0,0,,,,,,
860,790,789,860,790,789,,,0,0,0,,,,,,
862,812,237,862,812,237,,,0,0,0,,,,,,
862,812,237,862,812,237,,,0,0,0,,,,,,
862,812,240,862,812,240,,,0,0,0,,,,,,
862,812,244,862,812,245,,,0,0,-1,,,,,,
862,812,251,862,812,251,,,0,0,0,,,,,,
862,812,259,862,812,260,,,0,0,-1,,,,,,
862,812,269,862,812,269,,,0,0,0,,,,,,
862,812,282,862,812,282,,,0,0,0,,,,,,
862,812,295,862,812,295,,,0,0,0,,,,,,
862,812,310,862,812,311,,,0,0,-1,,,,,,
862,812,327,862,812,327,,,0,0,0,,,,,,
863,812,344,862,812,344,,,1,0,0,,,,,,
863,812,362,863,812,362,,,0,0,0,,,,,,
863,813,381,863,812,381,,,0,1,0,,,,,,
863,813,401,863,813,401,,,0,0,0,,,,,,
863,813,421,863,813,421,,,0,0,0,,,,,,
863,813,442,863,813,442,,,0,0,0,,,,,,
864,813,464,863,813,463,,,1,0,1,,,,,,
864,814,485,864,814,485,,,0,0,0,,,,,,
864,814,507,864,814,507,,,0,0,0,,,,,,
864,814,530,864,814,530,,,0,0,0,,,,,,
864,814,553,864,814,553,,,0,0,0,,,,,,
865,815,576,865,815,576,,,0,0,0,,,,,,
865,815,599,865,815,599,,,0,0,0,,,,,,
865,815,622,865,815,622,,,0,0,0,,,,,,
866,816,646,865,815,646,,,1,1,0,,,,,,
866,816,670,866,816,670,,,0,0,0,,,,,,
866,817,694,866,816,694,,,0,1,0,,,,,,
867,817,718,867,817,718,,,0,0,0,,,,,,
867,817,742,867,817,742,,,0,0,0,,,,,,
868,818,766,868,818,766,,,0,0,0,,,,,,
868,818,791,868,818,790,,,0,0,1,,,,,,
870,840,244,870,840,244,,,0,0,0,,,,,,
870,840,244,870,840,244,,,0,0,0,,,,,,
870,840,246,870,840,246,,,0,0,0,,,,,,
870,840,251,870,840,252,,,0,0,-1,,,,,,
870,840,257,870,840,257,,,0,0,0,,,,,,
870,840,265,870,840,266,,,0,0,-1,,,,,,
870,840,275,870,840,275,,,0,0,0,,,,,,
870,840,287,870,840,288,,,0,0,-1,,,,,,
870,840,301,870,840,300,,,0,0,1,,,,,,
870,841,315,870,840,316,,,0,1,-1,,,,,,
870,841,331,870,840,331,,,0,1,0,,,,,,
870,841,348,870,840,349,,,0,1,-1,,,,,,
870,841,366,871,840,366,,,-1,1,0,,,,,,
871,841,385,871,841,385,,,0,0,0,,,,,,
871,841,405,871,841,405,,,0,0,0,,,,,,
871,841,425,871,841,425,,,0,0,0,,,,,,
871,842,446,871,841,445,,,0,1,1,,,,,,
871,842,467,871,842,467,,,0,0,0,,,,,,
872,842,488,872,842,488,,,0,0,0,,,,,,
872,842,510,872,842,510,,,0,0,0,,,,,,
872,843,533,872,842,533,,,0,1,0,,,,,,
872,843,555,872,843,555,,,0,0,0,,,,,,
873,843,578,873,843,578,,,0,0,0,,,,,,
873,843,601,873,843,601,,,0,0,0,,,,,,
873,844,625,873,843,624,,,0,1,1,,,,,,
873,844,648,873,844,648,,,0,0,0,,,,,,
874,845,672,874,844,672,,,0,1,0,,,,,,
874,845,696,874,845,696,,,0,0,0,,,,,,
875,845,720,875,845,720,,,0,0,0,,,,,,
875,846,744,875,846,744,,,0,0,0,,,,,,
875,846,768,875,846,768,,,0,0,0,,,,,,
876,847,792,875,846,792,,,1,1,0,,,,,,
878,869,251,878,869,251,,,0,0,0,,,,,,
878,869,251,878,869,251,,,0,0,0,,,,,,
878,869,253,878,869,253,,,0,0,0,,,,,,
878,869,258,878,869,258,,,0,0,0,,,,,,
878,869,264,878,869,264,,,0,0,0,,,,,,
878,869,272,878,869,273,,,0,0,-1,,,,,,
878,869,282,878,869,282,,,0,0,0,,,,,,
878,869,293,878,869,294,,,0,0,-1,,,,,,
878,869,306,878,869,306,,,0,0,0,,,,,,
878,869,321,878,869,321,,,0,0,0,,,,,,
878,869,336,878,869,336,,,0,0,0,,,,,,
878,869,353,878,869,353,,,0,0,0,,,,,,
879,869,371,879,869,371,,,0,0,0,,,,,,
879,870,390,879,869,390,,,0,1,0,,,,,,
879,870,409,879,870,409,,,0,0,0,,,,,,
879,870,429,879,870,429,,,0,0,0,,,,,,
879,870,449,879,870,449,,,0,0,0,,,,,,
879,870,470,879,870,470,,,0,0,0,,,,,,
880,871,492,880,871,492,,,0,0,0,,,,,,
880,871,514,880,871,514,,,0,0,0,,,,,,
880,871,536,880,871,536,,,0,0,0,,,,,,
880,871,558,880,871,558,,,0,0,0,,,,,,
881,872,581,881,872,581,,,0,0,0,,,,,,
881,872,604,881,872,604,,,0,0,0,,,,,,
881,872,627,881,872,627,,,0,0,0,,,,,,
882,873,651,881,872,650,,,1,1,1,,,,,,
882,873,674,882,873,674,,,0,0,0,,,,,,
882,873,698,882,873,698,,,0,0,0,,,,,,
883,874,722,883,874,722,,,0,0,0,,,,,,
883,874,746,883,874,746,,,0,0,0,,,,,,
883,875,770,883,875,770,,,0,0,0,,,,,,
884,875,794,883,875,794,,,1,0,0,,,,,,
886,897,258,886,897,258,,,0,0,0,,,,,,
886,897,258,886,897,258,,,0,0,0,,,,,,
886,897,260,886,897,260,,,0,0,0,,,,,,
886,897,264,886,897,265,,,0,0,-1,,,,,,
886,897,270,886,897,270,,,0,0,0,,,,,,
886,898,278,886,897,279,,,0,1,-1,,,,,,
886,898,288,886,897,288,,,0,1,0,,,,,,
886,898,299,886,897,300,,,0,1,-1,,,,,,
886,898,312,886,898,312,,,0,0,0,,,,,,
887,898,326,886,898,326,,,1,0,0,,,,,,
887,898,342,886,898,341,,,1,0,1,,,,,,
887,898,358,886,898,358,,,1,0,0,,,,,,
887,898,376,887,898,375,,,0,0,1,,,,,,
887,898,394,887,898,394,,,0,0,0,,,,,,
887,898,413,887,898,413,,,0,0,0,,,,,,
887,899,433,887,898,433,,,0,1,0,,,,,,
888,899,453,887,899,453,,,1,0,0,,,,,,
888,899,474,888,899,474,,,0,0,0,,,,,,
888,899,495,888,899,495,,,0,0,0,,,,,,
888,899,517,888,899,517,,,0,0,0,,,,,,
888,900,539,888,899,539,,,0,1,0,,,,,,
889,900,561,889,900,561,,,0,0,0,,,,,,
889,900,584,889,900,584,,,0,0,0,,,,,,
889,901,607,889,900,606,,,0,1,1,,,,,,
890,901,630,889,901,629,,,1,0,1,,,,,,
890,901,653,890,901,653,,,0,0,0,,,,,,
890,902,676,890,901,676,,,0,1,0,,,,,,
891,902,700,890,902,700,,,1,0,0,,,,,,
891,902,724,891,902,724,,,0,0,0,,,,,,
891,903,748,891,903,748,,,0,0,0,,,,,,
892,903,772,891,903,772,,,1,0,0,,,,,,
892,904,796,892,903,796,,,0,1,0,,,,,,
785,217,119,785,217,119,,,0,0,0,,,,,,
785,217,120,785,217,119,,,0,0,1,,,,,,
785,217,125,785,217,125,,,0,0,0,,,,,,
785,217,134,785,217,135,,,0,0,-1,,,,,,
785,217,146,785,217,146,,,0,0,0,,,,,,
785,218,161,785,217,162,,,0,1,-1,,,,,,
785,218,178,785,218,178,,,0,0,0,,,,,,
785,218,197,785,218,197,,,0,0,0,,,,,,
785,219,217,785,218,216,,,0,1,1,,,,,,
785,219,237,785,219,237,,,0,0,0,,,,,,
785,219,259,785,219,259,,,0,0,0,,,,,,
785,220,281,785,220,281,,,0,0,0,,,,,,
786,221,303,785,220,303,,,1,1,0,,,,,,
786,221,326,785,221,326,,,1,0,0,,,,,,
786,222,350,786,222,349,,,0,0,1,,,,,,
786,223,373,786,223,373,,,0,0,0,,,,,,
786,224,397,786,223,397,,,0,1,0,,,,,,
786,225,421,786,224,421,,,0,1,0,,,,,,
787,226,445,787,225,445,,,0,1,0,,,,,,
787,227,469,787,226,469,,,0,1,0,,,,,,
787,228,494,787,228,493,,,0,0,1,,,,,,
788,229,518,787,229,518,,,1,0,0,,,,,,
788,231,543,788,230,542,,,0,1,1,,,,,,
788,232,567,788,231,567,,,0,1,0,,,,,,
788,233,592,788,233,592,,,0,0,0,,,,,,
789,235,617,788,234,617,,,1,1,0,,,,,,
789,236,642,789,236,642,,,0,0,0,,,,,,
790,238,667,789,237,667,,,1,1,0,,,,,,
790,239,692,790,239,692,,,0,0,0,,,,,,
790,241,717,790,241,717,,,0,0,0,,,,,,
791,243,743,791,243,742,,,0,0,1,,,,,,
791,245,768,791,244,768,,,0,1,0,,,,,,
785,218,119,785,217,119,,,0,1,0,,,,,,
785,218,120,785,217,119,,,0,1,1,,,,,,
785,218,125,785,217,125,,,0,1,0,,,,,,
785,218,134,785,217,135,,,0,1,-1,,,,,,
785,218,146,785,217,146,,,0,1,0,,,,,,
785,218,161,785,217,162,,,0,1,-1,,,,,,
785,219,178,785,218,178,,,0,1,0,,,,,,
785,219,197,785,218,197,,,0,1,0,,,,,,
785,219,217,785,218,216,,,0,1,1,,,,,,
785,220,237,785,219,237,,,0,1,0,,,,,,
785,220,259,785,219,259,,,0,1,0,,,,,,
785,221,281,785,220,281,,,0,1,0,,,,,,
786,222,304,785,220,303,,,1,2,1,,,,,,
786,222,326,785,221,326,,,1,1,0,,,,,,
786,223,350,786,222,349,,,0,1,1,,,,,,
786,224,373,786,223,373,,,0,1,0,,,,,,
786,225,397,786,223,397,,,0,2,0,,,,,,
787,226,421,786,224,421,,,1,2,0,,,,,,
787,227,445,787,225,445,,,0,2,0,,,,,,
787,228,469,787,226,469,,,0,2,0,,,,,,
787,229,494,787,228,493,,,0,1,1,,,,,,
788,230,518,787,229,518,,,1,1,0,,,,,,
788,231,543,788,230,542,,,0,1,1,,,,,,
788,233,567,788,231,567,,,0,2,0,,,,,,
789,234,592,788,233,592,,,1,1,0,,,,,,
789,236,617,788,234,617,,,1,2,0,,,,,,
789,237,642,789,236,642,,,0,1,0,,,,,,
790,239,667,789,237,667,,,1,2,0,,,,,,
790,240,692,790,239,692,,,0,1,0,,,,,,
791,242,717,790,241,717,,,1,1,0,,,,,,
791,244,743,791,243,742,,,0,1,1,,,,,,
791,246,768,791,244,768,,,0,2,0,,,,,,
785,222,119,785,221,119,,,0,1,0,,,,,,
785,222,121,785,221,119,,,0,1,2,,,,,,
785,222,126,785,221,126,,,0,1,0,,,,,,
785,222,135,785,221,136,,,0,1,-1,,,,,,
785,222,147,785,221,146,,,0,1,1,,,,,,
785,222,162,785,222,162,,,0,0,0,,,,,,
785,222,179,785,222,178,,,0,0,1,,,,,,
785,223,197,785,222,197,,,0,1,0,,,,,,
785,223,217,785,223,217,,,0,0,0,,,,,,
785,223,238,785,223,238,,,0,0,0,,,,,,
786,224,259,785,223,259,,,1,1,0,,,,,,
786,224,281,785,224,281,,,1,0,0,,,,,,
786,225,304,786,225,303,,,0,0,1,,,,,,
786,226,327,786,226,326,,,0,0,1,,,,,,
786,227,350,786,226,350,,,0,1,0,,,,,,
786,227,373,786,227,373,,,0,0,0,,,,,,
787,228,397,786,228,397,,,1,0,0,,,,,,
787,229,421,786,229,421,,,1,0,0,,,,,,
787,230,445,787,230,445,,,0,0,0,,,,,,
787,231,469,787,231,469,,,0,0,0,,,,,,
788,232,494,788,232,494,,,0,0,0,,,,,,
788,233,518,788,233,518,,,0,0,0,,,,,,
788,235,543,788,235,543,,,0,0,0,,,,,,
788,236,567,788,236,567,,,0,0,0,,,,,,
789,237,592,789,237,592,,,0,0,0,,,,,,
789,239,617,789,238,617,,,0,1,0,,,,,,
790,240,642,790,240,642,,,0,0,0,,,,,,
790,242,667,790,241,667,,,0,1,0,,,,,,
790,244,692,790,243,692,,,0,1,0,,,,,,
791,245,717,790,245,717,,,1,0,0,,,,,,
791,247,743,791,247,742,,,0,0,1,,,,,,
792,249,768,791,248,768,,,1,1,0,,,,,,
785,228,120,785,229,120,,,0,-1,0,,,,,,
785,228,122,785,229,120,,,0,-1,2,,,,,,
785,228,127,785,229,127,,,0,-1,0,,,,,,
785,228,135,785,229,137,,,0,-1,-2,,,,,,
786,228,147,785,229,147,,,1,-1,0,,,,,,
786,229,162,785,230,163,,,1,-1,-1,,,,,,
786,229,179,785,230,179,,,1,-1,0,,,,,,
786,229,198,785,230,198,,,1,-1,0,,,,,,
786,229,217,786,231,217,,,0,-2,0,,,,,,
786,230,238,786,231,238,,,0,-1,0,,,,,,
786,230,259,786,231,259,,,0,-1,0,,,,,,
786,231,281,786,232,281,,,0,-1,0,,,,,,
786,231,304,786,233,304,,,0,-2,0,,,,,,
786,232,327,786,233,327,,,0,-1,0,,,,,,
787,233,350,786,234,350,,,1,-1,0,,,,,,
787,234,374,786,235,373,,,1,-1,1,,,,,,
787,234,397,787,236,397,,,0,-2,0,,,,,,
787,235,421,787,236,421,,,0,-1,0,,,,,,
787,236,445,787,237,445,,,0,-1,0,,,,,,
788,237,469,788,238,469,,,0,-1,0,,,,,,
788,238,494,788,240,494,,,0,-2,0,,,,,,
788,240,518,788,241,518,,,0,-1,0,,,,,,
789,241,543,788,242,543,,,1,-1,0,,,,,,
789,242,568,789,243,567,,,0,-1,1,,,,,,
789,243,592,789,245,592,,,0,-2,0,,,,,,
790,245,617,790,246,617,,,0,-1,0,,,,,,
790,246,642,790,247,642,,,0,-1,0,,,,,,
790,248,667,790,249,667,,,0,-1,0,,,,,,
791,249,692,790,250,692,,,1,-1,0,,,,,,
791,251,718,791,252,717,,,0,-1,1,,,,,,
792,253,743,791,254,742,,,1,-1,1,,,,,,
792,254,768,792,255,768,,,0,-1,0,,,,,,
786,237,121,786,237,121,,,0,0,0,,,,,,
786,237,123,786,237,121,,,0,0,2,,,,,,
786,237,128,786,237,128,,,0,0,0,,,,,,
786,238,136,786,237,138,,,0,1,-2,,,,,,
786,238,148,786,238,148,,,0,0,0,,,,,,
786,238,163,786,238,164,,,0,0,-1,,,,,,
786,238,180,786,238,180,,,0,0,0,,,,,,
786,238,198,786,238,199,,,0,0,-1,,,,,,
786,239,218,786,239,218,,,0,0,0,,,,,,
787,239,239,786,239,239,,,1,0,0,,,,,,
787,240,260,787,240,260,,,0,0,0,,,,,,
787,240,282,787,240,282,,,0,0,0,,,,,,
787,241,304,787,241,304,,,0,0,0,,,,,,
787,241,327,787,241,327,,,0,0,0,,,,,,
787,242,350,787,242,350,,,0,0,0,,,,,,
788,243,374,787,242,374,,,1,1,0,,,,,,
788,244,398,788,243,397,,,0,1,1,,,,,,
788,244,421,788,244,421,,,0,0,0,,,,,,
788,245,446,788,245,446,,,0,0,0,,,,,,
788,246,470,788,246,470,,,0,0,0,,,,,,
789,247,494,789,247,494,,,0,0,0,,,,,,
789,249,519,789,248,518,,,0,1,1,,,,,,
789,250,543,789,249,543,,,0,1,0,,,,,,
790,251,568,789,251,567,,,1,0,1,,,,,,
790,252,593,790,252,592,,,0,0,1,,,,,,
790,254,617,790,253,617,,,0,1,0,,,,,,
791,255,642,791,254,642,,,0,1,0,,,,,,
791,256,667,791,256,667,,,0,0,0,,,,,,
792,258,693,791,258,692,,,1,0,1,,,,,,
792,259,718,792,259,717,,,0,0,1,,,,,,
792,261,743,792,261,742,,,0,0,1,,,,,,
793,263,768,793,262,768,,,0,1,0,,,,,,
787,249,123,787,250,123,,,0,-1,0,,,,,,
787,249,124,787,250,123,,,0,-1,1,,,,,,
787,250,129,787,250,129,,,0,0,0,,,,,,
787,250,138,787,251,139,,,0,-1,-1,,,,,,
787,250,150,787,251,150,,,0,-1,0,,,,,,
787,250,164,787,251,165,,,0,-1,-1,,,,,,
787,250,181,787,251,181,,,0,-1,0,,,,,,
787,250,199,787,251,200,,,0,-1,-1,,,,,,
787,251,219,787,252,219,,,0,-1,0,,,,,,
788,251,239,787,252,239,,,1,-1,0,,,,,,
788,252,261,788,253,260,,,0,-1,1,,,,,,
788,252,283,788,253,282,,,0,-1,1,,,,,,
788,253,305,788,254,305,,,0,-1,0,,,,,,
788,253,328,788,254,328,,,0,-1,0,,,,,,
788,254,351,788,255,351,,,0,-1,0,,,,,,
788,255,374,788,255,374,,,0,0,0,,,,,,
789,255,398,789,256,398,,,0,-1,0,,,,,,
789,256,422,789,257,422,,,0,-1,0,,,,,,
789,257,446,789,258,446,,,0,-1,0,,,,,,
789,258,470,789,259,470,,,0,-1,0,,,,,,
790,259,494,790,260,494,,,0,-1,0,,,,,,
790,260,519,790,261,519,,,0,-1,0,,,,,,
790,261,543,790,262,543,,,0,-1,0,,,,,,
791,262,568,790,263,568,,,1,-1,0,,,,,,
791,263,593,791,264,593,,,0,-1,0,,,,,,
791,265,618,791,266,617,,,0,-1,1,,,,,,
792,266,643,792,267,642,,,0,-1,1,,,,,,
792,267,668,792,268,667,,,0,-1,1,,,,,,
792,269,693,792,270,692,,,0,-1,1,,,,,,
793,270,718,793,271,717,,,0,-1,1,,,,,,
793,272,743,793,273,743,,,0,-1,0,,,,,,
794,274,768,794,274,768,,,0,0,0,,,,,,
788,264,125,788,264,125,,,0,0,0,,,,,,
788,264,126,788,264,125,,,0,0,1,,,,,,
788,264,131,788,264,131,,,0,0,0,,,,,,
788,264,140,788,264,141,,,0,0,-1,,,,,,
788,264,151,788,264,151,,,0,0,0,,,,,,
788,264,166,788,264,167,,,0,0,-1,,,,,,
788,265,182,788,264,182,,,0,1,0,,,,,,
789,265,200,788,264,201,,,1,1,-1,,,,,,
789,265,220,789,265,220,,,0,0,0,,,,,,
789,266,240,789,265,240,,,0,1,0,,,,,,
789,266,261,789,266,261,,,0,0,0,,,,,,
789,266,283,789,266,283,,,0,0,0,,,,,,
789,267,306,789,267,305,,,0,0,1,,,,,,
789,267,328,789,267,328,,,0,0,0,,,,,,
789,268,352,789,268,351,,,0,0,1,,,,,,
790,269,375,789,268,375,,,1,1,0,,,,,,
790,269,399,790,269,398,,,0,0,1,,,,,,
790,270,422,790,270,422,,,0,0,0,,,,,,
790,271,446,790,271,446,,,0,0,0,,,,,,
791,272,471,790,272,470,,,1,0,1,,,,,,
791,273,495,791,273,495,,,0,0,0,,,,,,
791,274,519,791,274,519,,,0,0,0,,,,,,
791,275,544,791,275,544,,,0,0,0,,,,,,
792,276,569,791,276,568,,,1,0,1,,,,,,
792,277,593,792,277,593,,,0,0,0,,,,,,
792,278,618,792,278,618,,,0,0,0,,,,,,
793,280,643,793,280,643,,,0,0,0,,,,,,
793,281,668,793,281,668,,,0,0,0,,,,,,
794,282,693,793,282,693,,,1,0,0,,,,,,
794,284,718,794,284,718,,,0,0,0,,,,,,
795,285,743,794,285,743,,,1,0,0,,,,,,
795,287,769,795,287,768,,,0,0,1,,,,,,
790,281,127,789,281,127,,,1,0,0,,,,,,
790,281,129,789,281,127,,,1,0,2,,,,,,
790,281,133,789,281,133,,,1,0,0,,,,,,
790,281,142,789,281,143,,,1,0,-1,,,,,,
790,281,153,790,282,153,,,0,-1,0,,,,,,
790,281,167,790,282,168,,,0,-1,-1,,,,,,
790,281,184,790,282,184,,,0,-1,0,,,,,,
790,281,202,790,282,202,,,0,-1,0,,,,,,
790,282,221,790,282,221,,,0,0,0,,,,,,
790,282,241,790,282,242,,,0,0,-1,,,,,,
790,282,263,790,283,262,,,0,-1,1,,,,,,
790,283,284,790,283,284,,,0,0,0,,,,,,
791,283,307,790,284,306,,,1,-1,1,,,,,,
791,284,329,791,284,329,,,0,0,0,,,,,,
791,284,352,791,285,352,,,0,-1,0,,,,,,
791,285,376,791,285,375,,,0,0,1,,,,,,
791,286,399,791,286,399,,,0,0,0,,,,,,
792,286,423,791,287,423,,,1,-1,0,,,,,,
792,287,447,791,288,447,,,1,-1,0,,,,,,
792,288,471,792,289,471,,,0,-1,0,,,,,,
792,289,495,792,290,495,,,0,-1,0,,,,,,
793,290,520,792,290,520,,,1,0,0,,,,,,
793,291,544,793,291,544,,,0,0,0,,,,,,
793,292,569,793,292,569,,,0,0,0,,,,,,
794,293,594,793,293,593,,,1,0,1,,,,,,
794,294,619,794,295,618,,,0,-1,1,,,,,,
794,295,643,794,296,643,,,0,-1,0,,,,,,
795,297,668,794,297,668,,,1,0,0,,,,,,
795,298,693,795,298,693,,,0,0,0,,,,,,
796,299,719,795,300,718,,,1,-1,1,,,,,,
796,301,744,796,301,744,,,0,0,0,,,,,,
796,302,769,796,303,769,,,0,-1,0,,,,,,
792,299,130,791,299,130,,,1,0,0,,,,,,
792,299,131,791,299,130,,,1,0,1,,,,,,
792,299,136,791,299,136,,,1,0,0,,,,,,
792,299,144,791,299,145,,,1,0,-1,,,,,,
792,299,155,792,299,155,,,0,0,0,,,,,,
792,299,169,792,299,170,,,0,0,-1,,,,,,
792,300,186,792,299,185,,,0,1,1,,,,,,
792,300,203,792,299,204,,,0,1,-1,,,,,,
792,300,223,792,300,223,,,0,0,0,,,,,,
792,300,243,792,300,243,,,0,0,0,,,,,,
792,301,264,792,300,264,,,0,1,0,,,,,,
792,301,285,792,301,285,,,0,0,0,,,,,,
792,302,308,792,301,307,,,0,1,1,,,,,,
793,302,330,792,302,330,,,1,0,0,,,,,,
793,303,353,793,302,353,,,0,1,0,,,,,,
793,303,376,793,303,376,,,0,0,0,,,,,,
793,304,400,793,303,400,,,0,1,0,,,,,,
793,304,424,793,304,424,,,0,0,0,,,,,,
794,305,448,793,305,448,,,1,0,0,,,,,,
794,306,472,793,306,472,,,1,0,0,,,,,,
794,307,496,794,307,496,,,0,0,0,,,,,,
794,308,520,794,307,520,,,0,1,0,,,,,,
795,309,545,794,308,545,,,1,1,0,,,,,,
795,310,569,795,309,569,,,0,1,0,,,,,,
795,311,594,795,310,594,,,0,1,0,,,,,,
796,312,619,795,311,619,,,1,1,0,,,,,,
796,313,644,796,313,644,,,0,0,0,,,,,,
796,314,669,796,314,668,,,0,0,1,,,,,,
797,315,694,797,315,693,,,0,0,1,,,,,,
797,316,719,797,316,719,,,0,0,0,,,,,,
798,318,744,797,318,744,,,1,0,0,,,,,,
798,319,769,798,319,769,,,0,0,0,,,,,,
794,319,133,793,319,133,,,1,0,0,,,,,,
794,319,135,793,319,133,,,1,0,2,,,,,,
794,319,139,793,319,139,,,1,0,0,,,,,,
794,319,147,793,319,148,,,1,0,-1,,,,,,
794,319,158,794,320,158,,,0,-1,0,,,,,,
794,319,172,794,320,173,,,0,-1,-1,,,,,,
794,319,188,794,320,188,,,0,-1,0,,,,,,
794,320,205,794,320,206,,,0,0,-1,,,,,,
794,320,224,794,320,224,,,0,0,0,,,,,,
794,320,244,794,320,245,,,0,0,-1,,,,,,
794,320,265,794,321,265,,,0,-1,0,,,,,,
794,321,287,794,321,287,,,0,0,0,,,,,,
794,321,309,794,322,309,,,0,-1,0,,,,,,
795,322,331,794,322,331,,,1,0,0,,,,,,
795,322,354,795,323,354,,,0,-1,0,,,,,,
795,323,377,795,323,377,,,0,0,0,,,,,,
795,323,401,795,324,401,,,0,-1,0,,,,,,
795,324,425,795,324,424,,,0,0,1,,,,,,
796,325,448,795,325,448,,,1,0,0,,,,,,
796,325,473,796,326,472,,,0,-1,1,,,,,,
796,326,497,796,327,496,,,0,-1,1,,,,,,
796,327,521,796,327,521,,,0,0,0,,,,,,
797,328,546,796,328,545,,,1,0,1,,,,,,
797,329,570,797,329,570,,,0,0,0,,,,,,
797,330,595,797,330,594,,,0,0,1,,,,,,
798,331,620,797,331,619,,,1,0,1,,,,,,
798,332,644,798,332,644,,,0,0,0,,,,,,
798,333,669,798,333,669,,,0,0,0,,,,,,
799,334,694,799,334,694,,,0,0,0,,,,,,
799,335,719,799,336,719,,,0,-1,0,,,,,,
800,336,745,800,337,745,,,0,-1,0,,,,,,
800,338,770,800,338,770,,,0,0,0,,,,,,
796,340,137,796,340,137,,,0,0,0,,,,,,
796,340,138,796,340,137,,,0,0,1,,,,,,
796,340,142,796,340,142,,,0,0,0,,,,,,
796,340,150,796,340,151,,,0,0,-1,,,,,,
796,340,161,796,340,161,,,0,0,0,,,,,,
796,340,174,796,340,175,,,0,0,-1,,,,,,
796,341,190,796,340,190,,,0,1,0,,,,,,
796,341,208,796,340,208,,,0,1,0,,,,,,
796,341,226,796,341,226,,,0,0,0,,,,,,
796,341,246,796,341,246,,,0,0,0,,,,,,
796,342,267,796,341,267,,,0,1,0,,,,,,
797,342,288,796,342,288,,,1,0,0,,,,,,
797,342,310,796,342,310,,,1,0,0,,,,,,
797,343,333,796,343,333,,,1,0,0,,,,,,
797,343,355,797,343,355,,,0,0,0,,,,,,
797,344,379,797,344,378,,,0,0,1,,,,,,
797,344,402,797,344,402,,,0,0,0,,,,,,
798,345,426,797,345,425,,,1,0,1,,,,,,
798,345,449,798,345,449,,,0,0,0,,,,,,
798,346,473,798,346,473,,,0,0,0,,,,,,
798,347,498,798,347,497,,,0,0,1,,,,,,
799,348,522,798,347,522,,,1,1,0,,,,,,
799,348,546,799,348,546,,,0,0,0,,,,,,
799,349,571,799,349,571,,,0,0,0,,,,,,
800,350,595,799,350,595,,,1,0,0,,,,,,
800,351,620,800,351,620,,,0,0,0,,,,,,
800,352,645,800,352,645,,,0,0,0,,,,,,
801,353,670,801,353,670,,,0,0,0,,,,,,
801,354,695,801,354,695,,,0,0,0,,,,,,
802,355,720,802,355,720,,,0,0,0,,,,,,
802,356,745,802,356,745,,,0,0,0,,,,,,
802,358,770,802,357,770,,,0,1,0,,,,,,
798,362,141,798,362,140,,,0,0,1,,,,,,
798,362,142,798,362,140,,,0,0,2,,,,,,
798,362,146,798,363,146,,,0,-1,0,,,,,,
798,362,154,798,363,155,,,0,-1,-1,,,,,,
799,363,164,798,363,164,,,1,0,0,,,,,,
799,363,177,798,363,178,,,1,0,-1,,,,,,
799,363,193,798,363,193,,,1,0,0,,,,,,
799,363,210,798,363,210,,,1,0,0,,,,,,
799,363,229,798,363,228,,,1,0,1,,,,,,
799,363,248,798,363,248,,,1,0,0,,,,,,
799,364,269,799,364,269,,,0,0,0,,,,,,
799,364,290,799,364,290,,,0,0,0,,,,,,
799,364,312,799,365,312,,,0,-1,0,,,,,,
799,365,334,799,365,334,,,0,0,0,,,,,,
800,365,357,799,365,357,,,1,0,0,,,,,,
800,366,380,799,366,380,,,1,0,0,,,,,,
800,366,403,800,366,403,,,0,0,0,,,,,,
800,367,427,800,367,426,,,0,0,1,,,,,,
800,367,450,800,367,450,,,0,0,0,,,,,,
801,368,474,800,368,474,,,1,0,0,,,,,,
801,369,498,801,369,498,,,0,0,0,,,,,,
801,369,523,801,370,522,,,0,-1,1,,,,,,
802,370,547,801,370,547,,,1,0,0,,,,,,
802,371,572,802,371,571,,,0,0,1,,,,,,
802,372,596,802,372,596,,,0,0,0,,,,,,
803,373,621,802,373,621,,,1,0,0,,,,,,
803,374,646,803,374,645,,,0,0,1,,,,,,
803,374,671,803,375,670,,,0,-1,1,,,,,,
804,375,696,804,376,695,,,0,-1,1,,,,,,
804,377,721,804,377,720,,,0,0,1,,,,,,
805,378,746,805,378,746,,,0,0,0,,,,,,
805,379,771,805,379,771,,,0,0,0,,,,,,
801,386,145,801,385,144,,,0,1,1,,,,,,
801,386,146,801,385,144,,,0,1,2,,,,,,
801,386,150,801,386,150,,,0,0,0,,,,,,
801,386,157,801,386,159,,,0,0,-2,,,,,,
801,386,168,801,386,168,,,0,0,0,,,,,,
801,386,181,801,386,181,,,0,0,0,,,,,,
802,386,196,801,386,195,,,1,0,1,,,,,,
802,386,213,801,386,213,,,1,0,0,,,,,,
802,386,231,801,386,231,,,1,0,0,,,,,,
802,387,250,801,386,251,,,1,1,-1,,,,,,
802,387,271,801,387,271,,,1,0,0,,,,,,
802,387,292,802,387,292,,,0,0,0,,,,,,
802,387,314,802,387,313,,,0,0,1,,,,,,
802,388,336,802,387,336,,,0,1,0,,,,,,
802,388,358,802,388,358,,,0,0,0,,,,,,
803,389,381,802,388,381,,,1,1,0,,,,,,
803,389,404,802,389,404,,,1,0,0,,,,,,
803,390,428,803,389,428,,,0,1,0,,,,,,
803,390,452,803,390,452,,,0,0,0,,,,,,
804,391,475,803,390,475,,,1,1,0,,,,,,
804,391,499,803,391,499,,,1,0,0,,,,,,
804,392,524,804,392,523,,,0,0,1,,,,,,
804,393,548,804,393,548,,,0,0,0,,,,,,
805,394,572,804,393,572,,,1,1,0,,,,,,
805,394,597,805,394,597,,,0,0,0,,,,,,
805,395,622,805,395,621,,,0,0,1,,,,,,
806,396,646,805,396,646,,,1,0,0,,,,,,
806,397,671,806,397,671,,,0,0,0,,,,,,
807,398,696,806,398,696,,,1,0,0,,,,,,
807,399,721,807,399,721,,,0,0,0,,,,,,
807,400,746,807,400,746,,,0,0,0,,,,,,
808,401,771,808,401,771,,,0,0,0,,,,,,
805,409,149,804,409,149,,,1,0,0,,,,,,
805,409,150,804,409,149,,,1,0,1,,,,,,
805,409,154,804,410,154,,,1,-1,0,,,,,,
805,410,161,804,410,163,,,1,0,-2,,,,,,
805,410,172,804,410,171,,,1,0,1,,,,,,
805,410,184,804,410,185,,,1,0,-1,,,,,,
805,410,199,804,410,199,,,1,0,0,,,,,,
805,410,216,804,410,216,,,1,0,0,,,,,,
805,410,234,805,410,234,,,0,0,0,,,,,,
805,410,253,805,410,253,,,0,0,0,,,,,,
805,411,273,805,411,273,,,0,0,0,,,,,,
805,411,294,805,411,294,,,0,0,0,,,,,,
805,411,315,805,411,315,,,0,0,0,,,,,,
805,412,337,805,411,337,,,0,1,0,,,,,,
806,412,360,805,412,360,,,1,0,0,,,,,,
806,412,383,805,412,383,,,1,0,0,,,,,,
806,413,406,806,413,406,,,0,0,0,,,,,,
806,413,429,806,413,429,,,0,0,0,,,,,,
806,414,453,806,414,453,,,0,0,0,,,,,,
807,414,477,806,414,476,,,1,0,1,,,,,,
807,415,501,807,415,500,,,0,0,1,,,,,,
807,416,525,807,416,524,,,0,0,1,,,,,,
808,416,549,807,416,549,,,1,0,0,,,,,,
808,417,573,808,417,573,,,0,0,0,,,,,,
808,418,598,808,417,598,,,0,1,0,,,,,,
809,418,623,808,418,622,,,1,0,1,,,,,,
809,419,647,809,419,647,,,0,0,0,,,,,,
809,420,672,809,420,672,,,0,0,0,,,,,,
810,421,697,809,421,697,,,1,0,0,,,,,,
810,422,722,810,422,722,,,0,0,0,,,,,,
811,423,747,810,423,747,,,1,0,0,,,,,,
811,424,772,811,424,772,,,0,0,0,,,,,,
808,434,154,808,434,154,,,0,0,0,,,,,,
808,434,155,808,434,154,,,0,0,1,,,,,,
808,434,159,808,434,159,,,0,0,0,,,,,,
808,434,166,808,434,167,,,0,0,-1,,,,,,
808,434,176,808,434,175,,,0,0,1,,,,,,
808,434,188,808,434,189,,,0,0,-1,,,,,,
808,434,202,808,434,202,,,0,0,0,,,,,,
808,435,219,808,434,219,,,0,1,0,,,,,,
808,435,237,808,434,237,,,0,1,0,,,,,,
808,435,256,808,435,256,,,0,0,0,,,,,,
809,435,275,808,435,275,,,1,0,0,,,,,,
809,435,296,808,435,296,,,1,0,0,,,,,,
809,436,318,809,435,317,,,0,1,1,,,,,,
809,436,339,809,436,339,,,0,0,0,,,,,,
809,436,362,809,436,362,,,0,0,0,,,,,,
809,437,384,809,437,384,,,0,0,0,,,,,,
809,437,407,809,437,407,,,0,0,0,,,,,,
810,438,431,809,438,430,,,1,0,1,,,,,,
810,438,454,810,438,454,,,0,0,0,,,,,,
810,439,478,810,439,478,,,0,0,0,,,,,,
810,439,502,810,439,502,,,0,0,0,,,,,,
811,440,526,810,440,526,,,1,0,0,,,,,,
811,440,550,811,440,550,,,0,0,0,,,,,,
811,441,575,811,441,574,,,0,0,1,,,,,,
812,442,599,812,441,599,,,0,1,0,,,,,,
812,442,624,812,442,623,,,0,0,1,,,,,,
812,443,648,812,443,648,,,0,0,0,,,,,,
813,444,673,812,444,673,,,1,0,0,,,,,,
813,445,698,813,444,698,,,0,1,0,,,,,,
814,446,723,813,445,722,,,1,1,1,,,,,,
814,447,748,814,446,747,,,0,1,1,,,,,,
814,448,773,814,447,773,,,0,1,0,,,,,,
812,459,159,812,459,159,,,0,0,0,,,,,,
812,459,160,812,459,159,,,0,0,1,,,,,,
812,459,164,812,459,164,,,0,0,0,,,,,,
812,459,170,812,459,172,,,0,0,-2,,,,,,
812,459,180,812,459,180,,,0,0,0,,,,,,
812,459,192,812,459,193,,,0,0,-1,,,,,,
812,459,206,812,459,206,,,0,0,0,,,,,,
812,460,222,812,459,223,,,0,1,-1,,,,,,
812,460,240,812,460,240,,,0,0,0,,,,,,
812,460,258,812,460,259,,,0,0,-1,,,,,,
812,460,278,812,460,278,,,0,0,0,,,,,,
812,460,299,812,460,299,,,0,0,0,,,,,,
813,461,320,813,460,320,,,0,1,0,,,,,,
813,461,342,813,461,342,,,0,0,0,,,,,,
813,461,364,813,461,364,,,0,0,0,,,,,,
813,462,386,813,462,386,,,0,0,0,,,,,,
813,462,409,813,462,409,,,0,0,0,,,,,,
813,463,432,813,463,432,,,0,0,0,,,,,,
814,463,456,814,463,455,,,0,0,1,,,,,,
814,463,479,814,464,479,,,0,-1,0,,,,,,
814,464,503,814,464,503,,,0,0,0,,,,,,
814,465,527,814,465,527,,,0,0,0,,,,,,
815,465,551,815,465,551,,,0,0,0,,,,,,
815,466,576,815,466,575,,,0,0,1,,,,,,
815,466,600,815,466,600,,,0,0,0,,,,,,
816,467,625,816,467,624,,,0,0,1,,,,,,
816,468,649,816,468,649,,,0,0,0,,,,,,
816,469,674,816,468,674,,,0,1,0,,,,,,
817,469,699,817,469,698,,,0,0,1,,,,,,
817,470,724,817,470,723,,,0,0,1,,,,,,
818,471,749,818,471,748,,,0,0,1,,,,,,
818,472,774,818,472,773,,,0,0,1,,,,,,
816,485,164,816,485,164,,,0,0,0,,,,,,
816,485,165,816,485,164,,,0,0,1,,,,,,
816,485,169,816,485,169,,,0,0,0,,,,,,
816,485,175,816,485,176,,,0,0,-1,,,,,,
816,485,184,816,485,184,,,0,0,0,,,,,,
816,485,196,816,485,197,,,0,0,-1,,,,,,
816,485,210,816,485,210,,,0,0,0,,,,,,
816,485,226,816,485,226,,,0,0,0,,,,,,
816,485,243,816,485,243,,,0,0,0,,,,,,
816,486,261,816,485,262,,,0,1,-1,,,,,,
816,486,281,816,486,281,,,0,0,0,,,,,,
816,486,301,816,486,301,,,0,0,0,,,,,,
817,486,322,817,486,322,,,0,0,0,,,,,,
817,487,344,817,486,344,,,0,1,0,,,,,,
817,487,366,817,487,366,,,0,0,0,,,,,,
817,487,388,817,487,388,,,0,0,0,,,,,,
817,488,411,817,487,411,,,0,1,0,,,,,,
817,488,434,817,488,434,,,0,0,0,,,,,,
818,488,457,818,488,457,,,0,0,0,,,,,,
818,489,481,818,489,481,,,0,0,0,,,,,,
818,489,505,818,489,505,,,0,0,0,,,,,,
818,490,529,818,490,529,,,0,0,0,,,,,,
819,490,553,819,490,553,,,0,0,0,,,,,,
819,491,577,819,491,577,,,0,0,0,,,,,,
819,492,601,819,492,601,,,0,0,0,,,,,,
820,492,626,819,492,626,,,1,0,0,,,,,,
820,493,650,820,493,650,,,0,0,0,,,,,,
821,494,675,820,493,675,,,1,1,0,,,,,,
821,494,700,821,494,699,,,0,0,1,,,,,,
821,495,725,821,495,724,,,0,0,1,,,,,,
822,496,750,822,496,749,,,0,0,1,,,,,,
822,497,775,822,497,774,,,0,0,1,,,,,,
820,511,170,820,511,169,,,0,0,1,,,,,,
820,511,170,820,511,169,,,0,0,1,,,,,,
820,511,174,820,511,174,,,0,0,0,,,,,,
820,511,180,820,511,181,,,0,0,-1,,,,,,
820,511,189,820,511,189,,,0,0,0,,,,,,
820,511,201,820,511,201,,,0,0,0,,,,,,
820,511,214,820,511,214,,,0,0,0,,,,,,
820,511,230,820,511,230,,,0,0,0,,,,,,
820,511,247,820,511,246,,,0,0,1,,,,,,
821,511,265,820,511,265,,,1,0,0,,,,,,
821,512,284,820,512,284,,,1,0,0,,,,,,
821,512,304,821,512,304,,,0,0,0,,,,,,
821,512,325,821,512,325,,,0,0,0,,,,,,
821,512,346,821,512,346,,,0,0,0,,,,,,
821,513,368,821,513,368,,,0,0,0,,,,,,
821,513,390,821,513,390,,,0,0,0,,,,,,
822,513,413,821,513,413,,,1,0,0,,,,,,
822,514,436,822,514,436,,,0,0,0,,,,,,
822,514,459,822,514,459,,,0,0,0,,,,,,
822,515,483,822,514,482,,,0,1,1,,,,,,
823,515,506,822,515,506,,,1,0,0,,,,,,
823,516,530,823,515,530,,,0,1,0,,,,,,
823,516,554,823,516,554,,,0,0,0,,,,,,
823,517,578,823,516,578,,,0,1,0,,,,,,
824,517,603,824,517,602,,,0,0,1,,,,,,
824,518,627,824,518,627,,,0,0,0,,,,,,
824,518,652,824,518,651,,,0,0,1,,,,,,
825,519,676,825,519,676,,,0,0,0,,,,,,
825,520,701,825,520,701,,,0,0,0,,,,,,
826,521,726,825,520,725,,,1,1,1,,,,,,
826,521,751,826,521,750,,,0,0,1,,,,,,
826,522,776,826,522,775,,,0,0,1,,,,,,
825,537,175,824,537,175,,,1,0,0,,,,,,
825,537,176,824,537,175,,,1,0,1,,,,,,
825,537,179,824,537,179,,,1,0,0,,,,,,
825,537,185,824,537,187,,,1,0,-2,,,,,,
825,537,194,825,537,194,,,0,0,0,,,,,,
825,537,205,825,537,206,,,0,0,-1,,,,,,
825,537,219,825,537,218,,,0,0,1,,,,,,
825,538,234,825,537,234,,,0,1,0,,,,,,
825,538,250,825,538,250,,,0,0,0,,,,,,
825,538,268,825,538,268,,,0,0,0,,,,,,
825,538,287,825,538,287,,,0,0,0,,,,,,
825,538,307,825,538,307,,,0,0,0,,,,,,
826,538,328,825,538,327,,,1,0,1,,,,,,
826,539,349,825,538,349,,,1,1,0,,,,,,
826,539,370,826,539,370,,,0,0,0,,,,,,
826,539,393,826,539,392,,,0,0,1,,,,,,
826,540,415,826,539,415,,,0,1,0,,,,,,
826,540,438,826,540,438,,,0,0,0,,,,,,
827,540,461,826,540,461,,,1,0,0,,,,,,
827,541,484,827,540,484,,,0,1,0,,,,,,
827,541,508,827,541,508,,,0,0,0,,,,,,
827,542,532,827,541,531,,,0,1,1,,,,,,
828,542,556,827,542,555,,,1,0,1,,,,,,
828,543,580,828,542,579,,,0,1,1,,,,,,
828,543,604,828,543,604,,,0,0,0,,,,,,
829,544,628,829,543,628,,,0,1,0,,,,,,
829,544,653,829,544,652,,,0,0,1,,,,,,
829,545,677,829,545,677,,,0,0,0,,,,,,
830,546,702,829,546,702,,,1,0,0,,,,,,
830,546,727,830,546,727,,,0,0,0,,,,,,
831,547,752,830,547,751,,,1,0,1,,,,,,
831,548,777,831,547,776,,,0,1,1,,,,,,
830,564,181,829,563,180,,,1,1,1,,,,,,
830,564,182,829,563,180,,,1,1,2,,,,,,
830,564,185,829,563,185,,,1,1,0,,,,,,
830,564,191,829,563,192,,,1,1,-1,,,,,,
830,564,199,830,563,199,,,0,1,0,,,,,,
830,564,210,830,564,211,,,0,0,-1,,,,,,
830,564,223,830,564,223,,,0,0,0,,,,,,
830,564,238,830,564,238,,,0,0,0,,,,,,
830,564,254,830,564,254,,,0,0,0,,,,,,
830,564,272,830,564,272,,,0,0,0,,,,,,
830,565,290,830,564,290,,,0,1,0,,,,,,
830,565,310,830,565,310,,,0,0,0,,,,,,
830,565,330,830,565,330,,,0,0,0,,,,,,
831,565,351,830,565,351,,,1,0,0,,,,,,
831,566,373,831,565,373,,,0,1,0,,,,,,
831,566,395,831,566,395,,,0,0,0,,,,,,
831,566,417,831,566,417,,,0,0,0,,,,,,
831,566,440,831,566,440,,,0,0,0,,,,,,
832,567,463,831,567,463,,,1,0,0,,,,,,
832,567,486,832,567,486,,,0,0,0,,,,,,
832,568,510,832,567,509,,,0,1,1,,,,,,
832,568,533,832,568,533,,,0,0,0,,,,,,
833,569,557,832,568,557,,,1,1,0,,,,,,
833,569,581,833,569,581,,,0,0,0,,,,,,
833,570,605,833,569,605,,,0,1,0,,,,,,
834,570,630,833,570,629,,,1,0,1,,,,,,
834,571,654,834,571,654,,,0,0,0,,,,,,
834,571,679,834,571,678,,,0,0,1,,,,,,
835,572,703,834,572,703,,,1,0,0,,,,,,
835,573,728,835,572,728,,,0,1,0,,,,,,
836,573,753,835,573,753,,,1,0,0,,,,,,
836,574,778,836,574,777,,,0,0,1,,,,,,
835,591,187,835,590,186,,,0,1,1,,,,,,
835,591,188,835,590,186,,,0,1,2,,,,,,
835,591,191,835,590,190,,,0,1,1,,,,,,
835,591,196,835,590,197,,,0,1,-1,,,,,,
835,591,205,835,590,204,,,0,1,1,,,,,,
835,591,215,835,590,216,,,0,1,-1,,,,,,
835,591,228,835,591,228,,,0,0,0,,,,,,
835,591,242,835,591,243,,,0,0,-1,,,,,,
835,591,258,835,591,258,,,0,0,0,,,,,,
835,591,276,835,591,276,,,0,0,0,,,,,,
835,592,294,835,591,294,,,0,1,0,,,,,,
835,592,313,835,591,313,,,0,1,0,,,,,,
836,592,333,835,592,333,,,1,0,0,,,,,,
836,592,354,835,592,354,,,1,0,0,,,,,,
836,592,376,836,592,375,,,0,0,1,,,,,,
836,593,397,836,592,397,,,0,1,0,,,,,,
836,593,420,836,593,420,,,0,0,0,,,,,,
837,593,442,836,593,442,,,1,0,0,,,,,,
837,594,465,837,593,465,,,0,1,0,,,,,,
837,594,488,837,594,488,,,0,0,0,,,,,,
837,594,512,837,594,511,,,0,0,1,,,,,,
838,595,535,837,595,535,,,1,0,0,,,,,,
838,595,559,838,595,559,,,0,0,0,,,,,,
838,596,583,838,596,583,,,0,0,0,,,,,,
838,596,607,838,596,607,,,0,0,0,,,,,,
839,597,631,838,597,631,,,1,0,0,,,,,,
839,597,656,839,597,655,,,0,0,1,,,,,,
839,598,680,839,598,680,,,0,0,0,,,,,,
840,598,705,840,598,704,,,0,0,1,,,,,,
840,599,729,840,599,729,,,0,0,0,,,,,,
841,600,754,841,599,754,,,0,1,0,,,,,,
841,600,779,841,600,779,,,0,0,0,,,,,,
840,618,193,840,618,193,,,0,0,0,,,,,,
840,618,194,840,618,193,,,0,0,1,,,,,,
840,618,197,840,618,196,,,0,0,1,,,,,,
840,618,202,840,618,203,,,0,0,-1,,,,,,
840,618,210,840,618,210,,,0,0,0,,,,,,
840,618,220,840,618,221,,,0,0,-1,,,,,,
841,618,233,840,618,233,,,1,0,0,,,,,,
841,618,247,840,618,247,,,1,0,0,,,,,,
841,618,263,841,618,262,,,0,0,1,,,,,,
841,619,280,841,618,280,,,0,1,0,,,,,,
841,619,298,841,618,297,,,0,1,1,,,,,,
841,619,317,841,619,317,,,0,0,0,,,,,,
841,619,337,841,619,336,,,0,0,1,,,,,,
841,619,357,841,619,357,,,0,0,0,,,,,,
841,620,378,841,619,378,,,0,1,0,,,,,,
842,620,400,841,620,400,,,1,0,0,,,,,,
842,620,422,842,620,422,,,0,0,0,,,,,,
842,620,445,842,620,445,,,0,0,0,,,,,,
842,621,467,842,620,467,,,0,1,0,,,,,,
842,621,490,842,621,490,,,0,0,0,,,,,,
843,621,514,843,621,513,,,0,0,1,,,,,,
843,622,537,843,622,537,,,0,0,0,,,,,,
843,622,561,843,622,560,,,0,0,1,,,,,,
844,623,585,843,623,584,,,1,0,1,,,,,,
844,623,609,844,623,608,,,0,0,1,,,,,,
844,624,633,844,624,632,,,0,0,1,,,,,,
845,624,657,844,624,657,,,1,0,0,,,,,,
845,625,682,845,625,681,,,0,0,1,,,,,,
845,625,706,845,625,706,,,0,0,0,,,,,,
846,626,731,846,626,730,,,0,0,1,,,,,,
846,626,755,846,626,755,,,0,0,0,,,,,,
847,627,780,846,627,780,,,1,0,0,,,,,,
846,645,199,846,645,199,,,0,0,0,,,,,,
846,645,200,846,645,199,,,0,0,1,,,,,,
846,645,203,846,645,202,,,0,0,1,,,,,,
846,645,208,846,645,209,,,0,0,-1,,,,,,
846,645,216,846,645,216,,,0,0,0,,,,,,
846,645,226,846,645,227,,,0,0,-1,,,,,,
846,646,238,846,645,238,,,0,1,0,,,,,,
846,646,252,846,645,252,,,0,1,0,,,,,,
846,646,267,846,645,267,,,0,1,0,,,,,,
847,646,284,846,645,284,,,1,1,0,,,,,,
847,646,302,847,646,301,,,0,0,1,,,,,,
847,646,320,847,646,320,,,0,0,0,,,,,,
847,646,340,847,646,340,,,0,0,0,,,,,,
847,647,360,847,646,360,,,0,1,0,,,,,,
847,647,381,847,647,381,,,0,0,0,,,,,,
847,647,403,847,647,403,,,0,0,0,,,,,,
848,647,425,847,647,425,,,1,0,0,,,,,,
848,648,447,847,647,447,,,1,1,0,,,,,,
848,648,470,848,648,470,,,0,0,0,,,,,,
848,648,493,848,648,493,,,0,0,0,,,,,,
848,649,516,848,648,516,,,0,1,0,,,,,,
849,649,539,848,649,539,,,1,0,0,,,,,,
849,649,563,849,649,562,,,0,0,1,,,,,,
849,650,587,849,650,586,,,0,0,1,,,,,,
850,650,610,850,650,610,,,0,0,0,,,,,,
850,651,635,850,651,634,,,0,0,1,,,,,,
850,651,659,850,651,658,,,0,0,1,,,,,,
851,652,683,850,652,683,,,1,0,0,,,,,,
851,652,708,851,652,707,,,0,0,1,,,,,,
851,653,732,851,653,732,,,0,0,0,,,,,,
852,653,757,852,653,756,,,0,0,1,,,,,,
852,654,782,852,654,781,,,0,0,1,,,,,,
852,673,205,852,673,205,,,0,0,0,,,,,,
852,673,206,852,673,205,,,0,0,1,,,,,,
852,673,209,852,673,209,,,0,0,0,,,,,,
852,673,214,852,673,215,,,0,0,-1,,,,,,
852,673,222,852,673,221,,,0,0,1,,,,,,
852,673,231,852,673,232,,,0,0,-1,,,,,,
852,673,243,852,673,243,,,0,0,0,,,,,,
852,673,256,852,673,257,,,0,0,-1,,,,,,
852,673,272,852,673,271,,,0,0,1,,,,,,
853,673,288,852,673,288,,,1,0,0,,,,,,
853,674,306,853,673,305,,,0,1,1,,,,,,
853,674,324,853,674,324,,,0,0,0,,,,,,
853,674,344,853,674,343,,,0,0,1,,,,,,
853,674,364,853,674,364,,,0,0,0,,,,,,
853,674,385,853,674,384,,,0,0,1,,,,,,
853,675,406,853,674,406,,,0,1,0,,,,,,
854,675,428,853,675,427,,,1,0,1,,,,,,
854,675,450,854,675,450,,,0,0,0,,,,,,
854,675,472,854,675,472,,,0,0,0,,,,,,
854,676,495,854,675,495,,,0,1,0,,,,,,
854,676,518,854,676,518,,,0,0,0,,,,,,
855,676,541,854,676,541,,,1,0,0,,,,,,
855,677,565,855,677,564,,,0,0,1,,,,,,
855,677,588,855,677,588,,,0,0,0,,,,,,
856,678,612,856,677,612,,,0,1,0,,,,,,
856,678,636,856,678,636,,,0,0,0,,,,,,
856,679,660,856,678,660,,,0,1,0,,,,,,
857,679,685,856,679,684,,,1,0,1,,,,,,
857,680,709,857,679,709,,,0,1,0,,,,,,
857,680,734,857,680,733,,,0,0,1,,,,,,
858,681,758,858,680,758,,,0,1,0,,,,,,
858,681,783,858,681,783,,,0,0,0,,,,,,
858,701,212,858,701,212,,,0,0,0,,,,,,
858,701,213,858,701,212,,,0,0,1,,,,,,
858,701,215,858,701,215,,,0,0,0,,,,,,
858,701,220,858,701,221,,,0,0,-1,,,,,,
859,701,227,858,701,227,,,1,0,0,,,,,,
859,701,237,858,701,237,,,1,0,0,,,,,,
859,701,248,858,701,248,,,1,0,0,,,,,,
859,701,262,858,701,262,,,1,0,0,,,,,,
859,701,276,858,701,276,,,1,0,0,,,,,,
859,701,292,859,701,293,,,0,0,-1,,,,,,
859,701,310,859,701,309,,,0,0,1,,,,,,
859,702,328,859,701,328,,,0,1,0,,,,,,
859,702,347,859,702,347,,,0,0,0,,,,,,
859,702,367,859,702,367,,,0,0,0,,,,,,
860,702,388,859,702,388,,,1,0,0,,,,,,
860,702,409,859,702,409,,,1,0,0,,,,,,
860,703,430,860,703,430,,,0,0,0,,,,,,
860,703,452,860,703,452,,,0,0,0,,,,,,
860,703,475,860,703,475,,,0,0,0,,,,,,
861,703,497,860,703,497,,,1,0,0,,,,,,
861,704,520,860,704,520,,,1,0,0,,,,,,
861,704,543,861,704,543,,,0,0,0,,,,,,
861,704,567,861,704,567,,,0,0,0,,,,,,
862,705,590,861,704,590,,,1,1,0,,,,,,
862,705,614,862,705,614,,,0,0,0,,,,,,
862,706,638,862,705,638,,,0,1,0,,,,,,
863,706,662,862,706,662,,,1,0,0,,,,,,
863,707,686,863,706,686,,,0,1,0,,,,,,
863,707,711,863,707,710,,,0,0,1,,,,,,
864,708,735,864,707,735,,,0,1,0,,,,,,
864,708,760,864,708,759,,,0,0,1,,,,,,
865,709,784,864,708,784,,,1,1,0,,,,,,
865,729,218,865,729,218,,,0,0,0,,,,,,
865,729,219,865,729,218,,,0,0,1,,,,,,
865,729,222,865,729,221,,,0,0,1,,,,,,
865,729,227,865,729,227,,,0,0,0,,,,,,
865,729,234,865,729,233,,,0,0,1,,,,,,
865,729,243,865,729,243,,,0,0,0,,,,,,
865,729,254,865,729,253,,,0,0,1,,,,,,
865,729,267,865,729,267,,,0,0,0,,,,,,
865,729,281,865,729,281,,,0,0,0,,,,,,
865,729,297,865,729,297,,,0,0,0,,,,,,
866,729,314,866,729,314,,,0,0,0,,,,,,
866,729,332,866,729,332,,,0,0,0,,,,,,
866,730,351,866,730,351,,,0,0,0,,,,,,
866,730,371,866,730,371,,,0,0,0,,,,,,
866,730,391,866,730,391,,,0,0,0,,,,,,
866,730,412,866,730,412,,,0,0,0,,,,,,
866,730,433,866,730,433,,,0,0,0,,,,,,
867,731,455,866,730,455,,,1,1,0,,,,,,
867,731,477,867,731,477,,,0,0,0,,,,,,
867,731,500,867,731,500,,,0,0,0,,,,,,
867,732,523,867,732,522,,,0,0,1,,,,,,
868,732,546,867,732,545,,,1,0,1,,,,,,
868,732,569,868,732,569,,,0,0,0,,,,,,
868,733,593,868,732,592,,,0,1,1,,,,,,
868,733,616,868,733,616,,,0,0,0,,,,,,
869,733,640,868,733,640,,,1,0,0,,,,,,
869,734,664,869,734,664,,,0,0,0,,,,,,
869,734,688,869,734,688,,,0,0,0,,,,,,
870,735,713,870,735,712,,,0,0,1,,,,,,
870,735,737,870,735,737,,,0,0,0,,,,,,
871,736,761,871,736,761,,,0,0,0,,,,,,
871,736,786,871,736,786,,,0,0,0,,,,,,
872,757,225,872,757,225,,,0,0,0,,,,,,
872,757,226,872,757,225,,,0,0,1,,,,,,
872,757,228,872,757,228,,,0,0,0,,,,,,
872,757,233,872,757,234,,,0,0,-1,,,,,,
872,757,240,872,757,240,,,0,0,0,,,,,,
872,757,249,872,757,249,,,0,0,0,,,,,,
872,757,259,872,757,259,,,0,0,0,,,,,,
872,757,272,872,757,273,,,0,0,-1,,,,,,
872,757,286,872,757,286,,,0,0,0,,,,,,
872,757,302,872,757,302,,,0,0,0,,,,,,
872,757,319,872,757,318,,,0,0,1,,,,,,
872,757,336,872,757,336,,,0,0,0,,,,,,
873,758,355,873,758,355,,,0,0,0,,,,,,
873,758,374,873,758,375,,,0,0,-1,,,,,,
873,758,395,873,758,395,,,0,0,0,,,,,,
873,758,415,873,758,416,,,0,0,-1,,,,,,
873,758,437,873,758,437,,,0,0,0,,,,,,
873,759,458,873,758,458,,,0,1,0,,,,,,
874,759,480,874,759,480,,,0,0,0,,,,,,
874,759,503,874,759,502,,,0,0,1,,,,,,
874,760,525,874,760,525,,,0,0,0,,,,,,
874,760,548,874,760,548,,,0,0,0,,,,,,
875,760,571,875,760,571,,,0,0,0,,,,,,
875,761,595,875,760,595,,,0,1,0,,,,,,
875,761,618,875,761,618,,,0,0,0,,,,,,
876,761,642,875,761,642,,,1,0,0,,,,,,
876,762,666,876,762,666,,,0,0,0,,,,,,
876,762,690,876,762,690,,,0,0,0,,,,,,
877,763,714,877,763,714,,,0,0,0,,,,,,
877,763,739,877,763,739,,,0,0,0,,,,,,
877,764,763,877,764,763,,,0,0,0,,,,,,
878,764,788,878,764,788,,,0,0,0,,,,,,
879,785,232,879,785,232,,,0,0,0,,,,,,
879,785,232,879,785,232,,,0,0,0,,,,,,
879,785,235,879,785,235,,,0,0,0,,,,,,
879,785,239,879,785,240,,,0,0,-1,,,,,,
879,785,246,879,785,246,,,0,0,0,,,,,,
879,785,255,879,785,255,,,0,0,0,,,,,,
879,785,265,879,785,265,,,0,0,0,,,,,,
879,785,278,879,785,278,,,0,0,0,,,,,,
879,785,291,879,785,291,,,0,0,0,,,,,,
879,785,307,879,785,307,,,0,0,0,,,,,,
879,786,323,879,785,323,,,0,1,0,,,,,,
880,786,341,880,785,341,,,0,1,0,,,,,,
880,786,359,880,786,359,,,0,0,0,,,,,,
880,786,378,880,786,378,,,0,0,0,,,,,,
880,786,398,880,786,398,,,0,0,0,,,,,,
880,786,419,880,786,419,,,0,0,0,,,,,,
880,787,440,880,786,440,,,0,1,0,,,,,,
881,787,461,880,787,461,,,1,0,0,,,,,,
881,787,483,881,787,483,,,0,0,0,,,,,,
881,787,505,881,787,505,,,0,0,0,,,,,,
881,788,528,881,788,527,,,0,0,1,,,,,,
882,788,551,881,788,550,,,1,0,1,,,,,,
882,788,574,882,788,574,,,0,0,0,,,,,,
882,789,597,882,788,597,,,0,1,0,,,,,,
882,789,621,882,789,620,,,0,0,1,,,,,,
883,789,644,882,789,644,,,1,0,0,,,,,,
883,790,668,883,790,668,,,0,0,0,,,,,,
883,790,692,883,790,692,,,0,0,0,,,,,,
884,791,716,884,791,716,,,0,0,0,,,,,,
884,791,740,884,791,740,,,0,0,0,,,,,,
884,792,765,884,791,765,,,0,1,0,,,,,,
885,792,789,885,792,789,,,0,0,0,,,,,,
886,813,239,886,813,239,,,0,0,0,,,,,,
886,813,239,886,813,239,,,0,0,0,,,,,,
886,813,242,886,813,242,,,0,0,0,,,,,,
886,813,246,886,813,247,,,0,0,-1,,,,,,
886,813,252,886,813,252,,,0,0,0,,,,,,
886,813,261,886,813,261,,,0,0,0,,,,,,
887,813,271,886,813,271,,,1,0,0,,,,,,
887,814,283,886,813,283,,,1,1,0,,,,,,
887,814,297,886,813,296,,,1,1,1,,,,,,
887,814,312,886,813,312,,,1,1,0,,,,,,
887,814,328,887,814,328,,,0,0,0,,,,,,
887,814,345,887,814,345,,,0,0,0,,,,,,
887,814,363,887,814,363,,,0,0,0,,,,,,
887,814,382,887,814,382,,,0,0,0,,,,,,
887,814,402,887,814,402,,,0,0,0,,,,,,
888,815,422,887,814,422,,,1,1,0,,,,,,
888,815,443,887,815,443,,,1,0,0,,,,,,
888,815,464,888,815,464,,,0,0,0,,,,,,
888,815,486,888,815,486,,,0,0,0,,,,,,
888,816,508,888,815,508,,,0,1,0,,,,,,
889,816,531,888,816,530,,,1,0,1,,,,,,
889,816,553,889,816,553,,,0,0,0,,,,,,
889,817,576,889,816,576,,,0,1,0,,,,,,
889,817,599,889,816,599,,,0,1,0,,,,,,
890,817,623,889,817,623,,,1,0,0,,,,,,
890,818,646,890,817,646,,,0,1,0,,,,,,
890,818,670,890,818,670,,,0,0,0,,,,,,
891,818,694,891,818,694,,,0,0,0,,,,,,
891,819,718,891,819,718,,,0,0,0,,,,,,
891,819,742,891,819,742,,,0,0,0,,,,,,
892,820,767,892,819,766,,,0,1,1,,,,,,
892,820,791,892,820,791,,,0,0,0,,,,,,
894,842,245,894,842,245,,,0,0,0,,,,,,
894,842,246,894,842,245,,,0,0,1,,,,,,
894,842,248,894,842,248,,,0,0,0,,,,,,
894,842,253,894,842,253,,,0,0,0,,,,,,
894,842,259,894,842,259,,,0,0,0,,,,,,
894,842,267,894,842,268,,,0,0,-1,,,,,,
894,842,277,894,842,277,,,0,0,0,,,,,,
894,842,289,894,842,289,,,0,0,0,,,,,,
894,842,302,894,842,302,,,0,0,0,,,,,,
894,842,317,894,842,317,,,0,0,0,,,,,,
894,842,333,894,842,332,,,0,0,1,,,,,,
895,842,350,895,842,350,,,0,0,0,,,,,,
895,843,368,895,842,367,,,0,1,1,,,,,,
895,843,386,895,842,386,,,0,1,0,,,,,,
895,843,406,895,843,406,,,0,0,0,,,,,,
895,843,426,895,843,426,,,0,0,0,,,,,,
895,843,447,895,843,446,,,0,0,1,,,,,,
896,844,468,895,843,467,,,1,1,1,,,,,,
896,844,489,896,844,489,,,0,0,0,,,,,,
896,844,511,896,844,511,,,0,0,0,,,,,,
896,844,534,896,844,533,,,0,0,1,,,,,,
896,845,556,896,844,556,,,0,1,0,,,,,,
897,845,579,897,845,579,,,0,0,0,,,,,,
897,845,602,897,845,602,,,0,0,0,,,,,,
897,845,625,897,845,625,,,0,0,0,,,,,,
898,846,649,897,845,648,,,1,1,1,,,,,,
898,846,672,898,846,672,,,0,0,0,,,,,,
898,847,696,898,846,696,,,0,1,0,,,,,,
899,847,720,899,847,720,,,0,0,0,,,,,,
899,847,744,899,847,744,,,0,0,0,,,,,,
899,848,769,899,848,768,,,0,0,1,,,,,,
900,848,793,899,848,793,,,1,0,0,,,,,,
902,870,252,902,870,252,,,0,0,0,,,,,,
902,870,253,902,870,252,,,0,0,1,,,,,,
902,870,255,902,870,255,,,0,0,0,,,,,,
902,870,259,902,870,260,,,0,0,-1,,,,,,
902,870,265,902,870,265,,,0,0,0,,,,,,
902,870,273,902,870,274,,,0,0,-1,,,,,,
902,870,283,902,870,283,,,0,0,0,,,,,,
902,871,295,902,870,295,,,0,1,0,,,,,,
902,871,308,902,870,307,,,0,1,1,,,,,,
902,871,322,902,870,322,,,0,1,0,,,,,,
902,871,338,902,871,337,,,0,0,1,,,,,,
902,871,354,902,871,354,,,0,0,0,,,,,,
903,871,372,903,871,372,,,0,0,0,,,,,,
903,871,391,903,871,391,,,0,0,0,,,,,,
903,871,410,903,871,410,,,0,0,0,,,,,,
903,872,430,903,871,430,,,0,1,0,,,,,,
903,872,450,903,871,450,,,0,1,0,,,,,,
903,872,471,903,872,471,,,0,0,0,,,,,,
904,872,493,904,872,492,,,0,0,1,,,,,,
904,872,514,904,872,514,,,0,0,0,,,,,,
904,873,536,904,872,536,,,0,1,0,,,,,,
904,873,559,904,873,559,,,0,0,0,,,,,,
905,873,582,905,873,581,,,0,0,1,,,,,,
905,874,605,905,873,604,,,0,1,1,,,,,,
905,874,628,905,874,627,,,0,0,1,,,,,,
905,874,651,905,874,651,,,0,0,0,,,,,,
906,875,675,906,874,674,,,0,1,1,,,,,,
906,875,698,906,875,698,,,0,0,0,,,,,,
906,875,722,907,875,722,,,-1,0,0,,,,,,
907,876,746,907,876,746,,,0,0,0,,,,,,
907,876,771,907,876,770,,,0,0,1,,,,,,
908,877,795,907,876,795,,,1,1,0,,,,,,
910,899,259,910,899,259,,,0,0,0,,,,,,
910,899,260,910,899,259,,,0,0,1,,,,,,
910,899,262,910,899,262,,,0,0,0,,,,,,
910,899,266,910,899,267,,,0,0,-1,,,,,,
910,899,272,910,899,272,,,0,0,0,,,,,,
910,899,280,910,899,280,,,0,0,0,,,,,,
910,899,289,910,899,289,,,0,0,0,,,,,,
910,899,301,910,899,301,,,0,0,0,,,,,,
910,899,313,910,899,313,,,0,0,0,,,,,,
910,899,327,910,899,328,,,0,0,-1,,,,,,
910,899,343,910,899,342,,,0,0,1,,,,,,
911,900,359,910,899,359,,,1,1,0,,,,,,
911,900,377,911,899,376,,,0,1,1,,,,,,
911,900,395,911,899,395,,,0,1,0,,,,,,
911,900,414,911,900,414,,,0,0,0,,,,,,
911,900,434,911,900,434,,,0,0,0,,,,,,
911,900,454,911,900,454,,,0,0,0,,,,,,
911,901,475,911,900,475,,,0,1,0,,,,,,
912,901,496,912,901,496,,,0,0,0,,,,,,
912,901,518,912,901,517,,,0,0,1,,,,,,
912,901,540,912,901,539,,,0,0,1,,,,,,
912,902,562,912,901,562,,,0,1,0,,,,,,
913,902,584,913,902,584,,,0,0,0,,,,,,
913,902,607,913,902,607,,,0,0,0,,,,,,
913,902,630,913,902,630,,,0,0,0,,,,,,
913,903,654,913,902,653,,,0,1,1,,,,,,
914,903,677,914,903,677,,,0,0,0,,,,,,
914,903,701,914,903,700,,,0,0,1,,,,,,
914,904,725,914,904,724,,,0,0,1,,,,,,
915,904,748,915,904,748,,,0,0,0,,,,,,
915,905,773,915,905,772,,,0,0,1,,,,,,
916,905,797,915,905,797,,,1,0,0,,,,,,
813,225,123,813,225,123,,,0,0,0,,,,,,
813,225,124,813,225,123,,,0,0,1,,,,,,
813,225,129,813,225,129,,,0,0,0,,,,,,
813,225,138,813,225,139,,,0,0,-1,,,,,,
813,225,150,813,225,150,,,0,0,0,,,,,,
813,225,164,813,225,165,,,0,0,-1,,,,,,
813,226,181,813,226,181,,,0,0,0,,,,,,
813,226,199,813,226,200,,,0,0,-1,,,,,,
813,226,219,813,226,219,,,0,0,0,,,,,,
813,227,239,813,226,240,,,0,1,-1,,,,,,
813,227,261,813,227,261,,,0,0,0,,,,,,
814,228,283,813,227,283,,,1,1,0,,,,,,
814,228,305,814,228,305,,,0,0,0,,,,,,
814,229,328,814,229,328,,,0,0,0,,,,,,
814,230,351,814,230,351,,,0,0,0,,,,,,
814,230,374,814,230,374,,,0,0,0,,,,,,
814,231,398,814,231,398,,,0,0,0,,,,,,
815,232,422,814,232,422,,,1,0,0,,,,,,
815,233,446,815,233,446,,,0,0,0,,,,,,
815,234,470,815,234,470,,,0,0,0,,,,,,
815,235,494,815,235,494,,,0,0,0,,,,,,
816,237,519,815,236,518,,,1,1,1,,,,,,
816,238,543,816,238,543,,,0,0,0,,,,,,
816,239,568,816,239,568,,,0,0,0,,,,,,
817,240,593,817,240,593,,,0,0,0,,,,,,
817,242,618,817,241,618,,,0,1,0,,,,,,
817,243,643,817,243,643,,,0,0,0,,,,,,
818,245,668,817,244,668,,,1,1,0,,,,,,
818,246,693,818,246,693,,,0,0,0,,,,,,
818,248,718,818,248,718,,,0,0,0,,,,,,
819,250,743,819,250,743,,,0,0,0,,,,,,
819,252,768,819,251,768,,,0,1,0,,,,,,
813,226,123,813,225,123,,,0,1,0,,,,,,
813,226,125,813,225,123,,,0,1,2,,,,,,
813,226,129,813,225,129,,,0,1,0,,,,,,
813,226,138,813,225,139,,,0,1,-1,,,,,,
813,226,150,813,225,150,,,0,1,0,,,,,,
813,226,164,813,225,165,,,0,1,-1,,,,,,
813,226,181,813,226,181,,,0,0,0,,,,,,
813,227,199,813,226,200,,,0,1,-1,,,,,,
813,227,219,813,226,219,,,0,1,0,,,,,,
813,228,239,813,226,240,,,0,2,-1,,,,,,
813,228,261,813,227,261,,,0,1,0,,,,,,
814,229,283,813,227,283,,,1,2,0,,,,,,
814,229,305,814,228,305,,,0,1,0,,,,,,
814,230,328,814,229,328,,,0,1,0,,,,,,
814,231,351,814,230,351,,,0,1,0,,,,,,
814,231,374,814,230,374,,,0,1,0,,,,,,
814,232,398,814,231,398,,,0,1,0,,,,,,
815,233,422,814,232,422,,,1,1,0,,,,,,
815,234,446,815,233,446,,,0,1,0,,,,,,
815,235,470,815,234,470,,,0,1,0,,,,,,
815,236,494,815,235,494,,,0,1,0,,,,,,
816,237,519,815,236,518,,,1,1,1,,,,,,
816,239,544,816,238,543,,,0,1,1,,,,,,
816,240,568,816,239,568,,,0,1,0,,,,,,
817,241,593,817,240,593,,,0,1,0,,,,,,
817,243,618,817,241,618,,,0,2,0,,,,,,
817,244,643,817,243,643,,,0,1,0,,,,,,
818,246,668,817,244,668,,,1,2,0,,,,,,
818,247,693,818,246,693,,,0,1,0,,,,,,
819,249,718,818,248,718,,,1,1,0,,,,,,
819,251,743,819,250,743,,,0,1,0,,,,,,
819,252,768,819,251,768,,,0,1,0,,,,,,
813,229,124,813,229,124,,,0,0,0,,,,,,
813,229,125,813,229,124,,,0,0,1,,,,,,
813,229,130,813,229,130,,,0,0,0,,,,,,
813,229,138,813,229,140,,,0,0,-2,,,,,,
813,229,150,813,229,150,,,0,0,0,,,,,,
813,230,165,813,229,165,,,0,1,0,,,,,,
813,230,181,813,230,181,,,0,0,0,,,,,,
813,230,200,813,230,200,,,0,0,0,,,,,,
814,231,219,814,231,219,,,0,0,0,,,,,,
814,231,240,814,231,240,,,0,0,0,,,,,,
814,231,261,814,231,261,,,0,0,0,,,,,,
814,232,283,814,232,283,,,0,0,0,,,,,,
814,233,305,814,233,305,,,0,0,0,,,,,,
814,233,328,814,233,328,,,0,0,0,,,,,,
814,234,351,814,234,351,,,0,0,0,,,,,,
814,235,375,814,235,374,,,0,0,1,,,,,,
815,236,398,815,236,398,,,0,0,0,,,,,,
815,236,422,815,236,422,,,0,0,0,,,,,,
815,237,446,815,237,446,,,0,0,0,,,,,,
815,238,470,815,238,470,,,0,0,0,,,,,,
816,240,495,816,240,495,,,0,0,0,,,,,,
816,241,519,816,241,519,,,0,0,0,,,,,,
816,242,544,816,242,544,,,0,0,0,,,,,,
817,243,568,816,243,568,,,1,0,0,,,,,,
817,245,593,817,245,593,,,0,0,0,,,,,,
817,246,618,817,246,618,,,0,0,0,,,,,,
818,247,643,818,247,643,,,0,0,0,,,,,,
818,249,668,818,248,668,,,0,1,0,,,,,,
818,250,693,818,250,693,,,0,0,0,,,,,,
819,252,718,818,252,718,,,1,0,0,,,,,,
819,254,743,819,254,743,,,0,0,0,,,,,,
820,255,768,819,255,768,,,1,0,0,,,,,,
814,235,124,813,236,125,,,1,-1,-1,,,,,,
814,235,126,813,236,125,,,1,-1,1,,,,,,
814,235,131,813,237,131,,,1,-2,0,,,,,,
814,236,139,813,237,141,,,1,-1,-2,,,,,,
814,236,151,813,237,151,,,1,-1,0,,,,,,
814,236,165,813,237,166,,,1,-1,-1,,,,,,
814,236,182,813,237,182,,,1,-1,0,,,,,,
814,236,200,814,238,200,,,0,-2,0,,,,,,
814,237,220,814,238,219,,,0,-1,1,,,,,,
814,237,240,814,238,240,,,0,-1,0,,,,,,
814,238,261,814,239,261,,,0,-1,0,,,,,,
814,238,283,814,239,283,,,0,-1,0,,,,,,
814,239,305,814,240,305,,,0,-1,0,,,,,,
815,239,328,814,241,328,,,1,-2,0,,,,,,
815,240,351,814,241,351,,,1,-1,0,,,,,,
815,241,375,815,242,375,,,0,-1,0,,,,,,
815,242,398,815,243,398,,,0,-1,0,,,,,,
815,243,422,815,243,422,,,0,0,0,,,,,,
816,243,446,815,244,446,,,1,-1,0,,,,,,
816,244,470,816,245,470,,,0,-1,0,,,,,,
816,246,495,816,247,495,,,0,-1,0,,,,,,
816,247,519,816,248,519,,,0,-1,0,,,,,,
817,248,544,816,249,544,,,1,-1,0,,,,,,
817,249,568,817,250,568,,,0,-1,0,,,,,,
817,250,593,817,252,593,,,0,-2,0,,,,,,
818,252,618,818,253,618,,,0,-1,0,,,,,,
818,253,643,818,254,643,,,0,-1,0,,,,,,
818,255,668,818,255,668,,,0,0,0,,,,,,
819,256,693,818,257,693,,,1,-1,0,,,,,,
819,258,718,819,258,718,,,0,0,0,,,,,,
820,259,743,819,260,743,,,1,-1,0,,,,,,
820,261,769,820,262,768,,,0,-1,1,,,,,,
814,244,126,814,244,126,,,0,0,0,,,,,,
814,244,127,814,244,126,,,0,0,1,,,,,,
814,245,132,814,245,132,,,0,0,0,,,,,,
814,245,140,814,245,142,,,0,0,-2,,,,,,
814,245,152,814,245,152,,,0,0,0,,,,,,
814,245,166,814,245,167,,,0,0,-1,,,,,,
814,245,183,814,245,183,,,0,0,0,,,,,,
815,245,201,814,245,201,,,1,0,0,,,,,,
815,246,220,815,246,220,,,0,0,0,,,,,,
815,246,241,815,246,241,,,0,0,0,,,,,,
815,247,262,815,247,262,,,0,0,0,,,,,,
815,247,284,815,247,284,,,0,0,0,,,,,,
815,248,306,815,248,306,,,0,0,0,,,,,,
815,248,329,815,248,329,,,0,0,0,,,,,,
815,249,352,815,249,352,,,0,0,0,,,,,,
816,250,375,815,249,375,,,1,1,0,,,,,,
816,250,399,816,250,399,,,0,0,0,,,,,,
816,251,423,816,251,423,,,0,0,0,,,,,,
816,252,447,816,252,447,,,0,0,0,,,,,,
816,253,471,816,253,471,,,0,0,0,,,,,,
817,254,495,817,254,495,,,0,0,0,,,,,,
817,255,519,817,255,519,,,0,0,0,,,,,,
817,256,544,817,256,544,,,0,0,0,,,,,,
818,258,569,817,257,568,,,1,1,1,,,,,,
818,259,593,818,259,593,,,0,0,0,,,,,,
818,260,618,818,260,618,,,0,0,0,,,,,,
819,261,643,819,261,643,,,0,0,0,,,,,,
819,263,668,819,262,668,,,0,1,0,,,,,,
819,264,693,819,264,693,,,0,0,0,,,,,,
820,266,718,819,265,718,,,1,1,0,,,,,,
820,267,743,820,267,743,,,0,0,0,,,,,,
821,269,769,820,269,768,,,1,0,1,,,,,,
815,256,127,815,257,127,,,0,-1,0,,,,,,
815,256,128,815,257,127,,,0,-1,1,,,,,,
815,256,133,815,257,133,,,0,-1,0,,,,,,
815,256,141,815,257,143,,,0,-1,-2,,,,,,
815,256,153,815,258,153,,,0,-2,0,,,,,,
815,257,167,815,258,168,,,0,-1,-1,,,,,,
815,257,184,815,258,184,,,0,-1,0,,,,,,
815,257,202,815,258,202,,,0,-1,0,,,,,,
816,257,221,816,258,221,,,0,-1,0,,,,,,
816,258,241,816,259,241,,,0,-1,0,,,,,,
816,258,262,816,259,262,,,0,-1,0,,,,,,
816,259,284,816,260,284,,,0,-1,0,,,,,,
816,259,306,816,260,306,,,0,-1,0,,,,,,
816,260,329,816,261,329,,,0,-1,0,,,,,,
816,260,352,816,261,352,,,0,-1,0,,,,,,
817,261,376,816,262,376,,,1,-1,0,,,,,,
817,262,399,817,263,399,,,0,-1,0,,,,,,
817,263,423,817,263,423,,,0,0,0,,,,,,
817,264,447,817,264,447,,,0,0,0,,,,,,
817,264,471,817,265,471,,,0,-1,0,,,,,,
818,265,495,818,266,495,,,0,-1,0,,,,,,
818,266,520,818,267,520,,,0,-1,0,,,,,,
818,267,544,818,268,544,,,0,-1,0,,,,,,
819,269,569,818,269,569,,,1,0,0,,,,,,
819,270,594,819,271,593,,,0,-1,1,,,,,,
819,271,618,819,272,618,,,0,-1,0,,,,,,
820,272,643,820,273,643,,,0,-1,0,,,,,,
820,274,668,820,274,668,,,0,0,0,,,,,,
820,275,693,820,276,693,,,0,-1,0,,,,,,
821,277,718,820,277,718,,,1,0,0,,,,,,
821,278,744,821,279,743,,,0,-1,1,,,,,,
822,280,769,821,280,768,,,1,0,1,,,,,,
816,270,129,816,270,129,,,0,0,0,,,,,,
816,270,130,816,270,129,,,0,0,1,,,,,,
816,270,135,816,270,135,,,0,0,0,,,,,,
816,270,143,816,270,145,,,0,0,-2,,,,,,
816,271,155,816,271,155,,,0,0,0,,,,,,
816,271,169,816,271,170,,,0,0,-1,,,,,,
817,271,185,817,271,185,,,0,0,0,,,,,,
817,271,203,817,271,203,,,0,0,0,,,,,,
817,271,222,817,271,222,,,0,0,0,,,,,,
817,272,242,817,271,242,,,0,1,0,,,,,,
817,272,263,817,272,263,,,0,0,0,,,,,,
817,273,285,817,272,285,,,0,1,0,,,,,,
817,273,307,817,273,307,,,0,0,0,,,,,,
817,274,330,817,273,330,,,0,1,0,,,,,,
817,274,353,817,274,353,,,0,0,0,,,,,,
818,275,376,817,275,376,,,1,0,0,,,,,,
818,276,400,818,276,400,,,0,0,0,,,,,,
818,276,423,818,276,423,,,0,0,0,,,,,,
818,277,447,818,277,447,,,0,0,0,,,,,,
819,278,471,818,278,471,,,1,0,0,,,,,,
819,279,496,819,279,496,,,0,0,0,,,,,,
819,280,520,819,280,520,,,0,0,0,,,,,,
819,281,545,819,281,545,,,0,0,0,,,,,,
820,282,569,819,282,569,,,1,0,0,,,,,,
820,283,594,820,283,594,,,0,0,0,,,,,,
820,284,619,820,284,619,,,0,0,0,,,,,,
821,286,644,821,286,644,,,0,0,0,,,,,,
821,287,669,821,287,669,,,0,0,0,,,,,,
821,288,694,821,288,694,,,0,0,0,,,,,,
822,290,719,821,289,719,,,1,1,0,,,,,,
822,291,744,822,291,744,,,0,0,0,,,,,,
823,293,769,822,292,769,,,1,1,0,,,,,,
818,286,131,817,287,131,,,1,-1,0,,,,,,
818,286,133,817,287,131,,,1,-1,2,,,,,,
818,287,137,817,287,137,,,1,0,0,,,,,,
818,287,145,817,287,147,,,1,0,-2,,,,,,
818,287,156,818,288,157,,,0,-1,-1,,,,,,
818,287,170,818,288,171,,,0,-1,-1,,,,,,
818,287,186,818,288,186,,,0,-1,0,,,,,,
818,287,204,818,288,205,,,0,-1,-1,,,,,,
818,288,223,818,288,223,,,0,0,0,,,,,,
818,288,243,818,288,244,,,0,0,-1,,,,,,
818,288,264,818,289,264,,,0,-1,0,,,,,,
818,289,286,818,289,286,,,0,0,0,,,,,,
819,289,308,818,290,308,,,1,-1,0,,,,,,
819,290,331,818,290,330,,,1,0,1,,,,,,
819,290,354,819,291,353,,,0,-1,1,,,,,,
819,291,377,819,291,377,,,0,0,0,,,,,,
819,291,400,819,292,400,,,0,-1,0,,,,,,
819,292,424,819,293,424,,,0,-1,0,,,,,,
820,293,448,819,294,448,,,1,-1,0,,,,,,
820,294,472,820,294,472,,,0,0,0,,,,,,
820,295,496,820,295,496,,,0,0,0,,,,,,
821,296,521,820,296,521,,,1,0,0,,,,,,
821,297,545,820,297,545,,,1,0,0,,,,,,
821,298,570,821,298,570,,,0,0,0,,,,,,
821,299,594,821,299,594,,,0,0,0,,,,,,
822,300,619,822,300,619,,,0,0,0,,,,,,
822,301,644,822,302,644,,,0,-1,0,,,,,,
823,302,669,822,303,669,,,1,-1,0,,,,,,
823,303,694,823,304,694,,,0,-1,0,,,,,,
823,305,719,823,305,719,,,0,0,0,,,,,,
824,306,744,823,307,744,,,1,-1,0,,,,,,
824,307,769,824,308,769,,,0,-1,0,,,,,,
819,304,134,819,304,134,,,0,0,0,,,,,,
819,304,135,819,304,134,,,0,0,1,,,,,,
819,305,140,819,305,140,,,0,0,0,,,,,,
820,305,148,819,305,149,,,1,0,-1,,,,,,
820,305,159,820,305,159,,,0,0,0,,,,,,
820,305,172,820,305,173,,,0,0,-1,,,,,,
820,305,188,820,305,188,,,0,0,0,,,,,,
820,305,206,820,305,206,,,0,0,0,,,,,,
820,305,225,820,305,225,,,0,0,0,,,,,,
820,306,245,820,305,245,,,0,1,0,,,,,,
820,306,266,820,306,266,,,0,0,0,,,,,,
820,307,287,820,306,287,,,0,1,0,,,,,,
820,307,309,820,307,309,,,0,0,0,,,,,,
820,307,332,820,307,331,,,0,0,1,,,,,,
821,308,354,821,308,354,,,0,0,0,,,,,,
821,309,378,821,308,377,,,0,1,1,,,,,,
821,309,401,821,309,401,,,0,0,0,,,,,,
821,310,425,821,310,425,,,0,0,0,,,,,,
821,311,449,821,311,449,,,0,0,0,,,,,,
822,311,473,821,311,473,,,1,0,0,,,,,,
822,312,497,822,312,497,,,0,0,0,,,,,,
822,313,521,822,313,521,,,0,0,0,,,,,,
822,314,546,822,314,546,,,0,0,0,,,,,,
823,315,570,822,315,570,,,1,0,0,,,,,,
823,316,595,823,316,595,,,0,0,0,,,,,,
823,317,620,823,317,620,,,0,0,0,,,,,,
824,318,645,824,318,645,,,0,0,0,,,,,,
824,319,669,824,319,669,,,0,0,0,,,,,,
825,320,694,825,320,694,,,0,0,0,,,,,,
825,322,720,825,321,719,,,0,1,1,,,,,,
825,323,745,825,323,745,,,0,0,0,,,,,,
826,324,770,825,324,770,,,1,0,0,,,,,,
821,324,137,821,324,137,,,0,0,0,,,,,,
821,324,138,821,324,137,,,0,0,1,,,,,,
821,324,143,821,325,143,,,0,-1,0,,,,,,
821,324,150,821,325,152,,,0,-1,-2,,,,,,
821,324,161,822,325,161,,,-1,-1,0,,,,,,
822,324,175,822,325,176,,,0,-1,-1,,,,,,
822,325,190,822,325,190,,,0,0,0,,,,,,
822,325,208,822,325,208,,,0,0,0,,,,,,
822,325,227,822,325,226,,,0,0,1,,,,,,
822,325,246,822,325,247,,,0,0,-1,,,,,,
822,326,267,822,326,267,,,0,0,0,,,,,,
822,326,288,822,326,289,,,0,0,-1,,,,,,
822,326,310,822,327,310,,,0,-1,0,,,,,,
822,327,333,822,327,333,,,0,0,0,,,,,,
823,327,356,823,328,355,,,0,-1,1,,,,,,
823,328,379,823,328,378,,,0,0,1,,,,,,
823,328,402,823,329,402,,,0,-1,0,,,,,,
823,329,426,823,329,425,,,0,0,1,,,,,,
823,330,449,823,330,449,,,0,0,0,,,,,,
824,330,473,823,331,473,,,1,-1,0,,,,,,
824,331,498,824,332,497,,,0,-1,1,,,,,,
824,332,522,824,332,522,,,0,0,0,,,,,,
824,333,546,824,333,546,,,0,0,0,,,,,,
825,334,571,824,334,571,,,1,0,0,,,,,,
825,335,596,825,335,595,,,0,0,1,,,,,,
825,336,620,825,336,620,,,0,0,0,,,,,,
826,337,645,826,337,645,,,0,0,0,,,,,,
826,338,670,826,338,670,,,0,0,0,,,,,,
827,339,695,827,339,695,,,0,0,0,,,,,,
827,340,720,827,340,720,,,0,0,0,,,,,,
827,341,745,827,342,745,,,0,-1,0,,,,,,
828,342,770,827,343,770,,,1,-1,0,,,,,,
824,345,141,824,345,141,,,0,0,0,,,,,,
824,345,142,824,345,141,,,0,0,1,,,,,,
824,345,146,824,345,146,,,0,0,0,,,,,,
824,345,153,824,345,155,,,0,0,-2,,,,,,
824,345,164,824,345,164,,,0,0,0,,,,,,
824,345,177,824,345,178,,,0,0,-1,,,,,,
824,345,193,824,345,193,,,0,0,0,,,,,,
824,346,210,824,345,210,,,0,1,0,,,,,,
824,346,228,824,346,228,,,0,0,0,,,,,,
824,346,248,824,346,248,,,0,0,0,,,,,,
824,346,269,824,346,269,,,0,0,0,,,,,,
824,347,290,824,346,290,,,0,1,0,,,,,,
824,347,312,824,347,312,,,0,0,0,,,,,,
825,347,334,824,347,334,,,1,0,0,,,,,,
825,348,357,825,348,357,,,0,0,0,,,,,,
825,348,380,825,348,380,,,0,0,0,,,,,,
825,349,403,825,349,403,,,0,0,0,,,,,,
825,350,427,825,349,426,,,0,1,1,,,,,,
826,350,450,826,350,450,,,0,0,0,,,,,,
826,351,474,826,351,474,,,0,0,0,,,,,,
826,352,498,826,352,498,,,0,0,0,,,,,,
826,352,523,826,352,522,,,0,0,1,,,,,,
827,353,547,827,353,547,,,0,0,0,,,,,,
827,354,572,827,354,571,,,0,0,1,,,,,,
827,355,596,827,355,596,,,0,0,0,,,,,,
828,356,621,827,356,621,,,1,0,0,,,,,,
828,357,646,828,357,646,,,0,0,0,,,,,,
828,358,671,828,358,671,,,0,0,0,,,,,,
829,359,696,829,359,696,,,0,0,0,,,,,,
829,360,721,829,360,721,,,0,0,0,,,,,,
830,361,746,830,361,746,,,0,0,0,,,,,,
830,362,771,830,362,771,,,0,0,0,,,,,,
826,367,144,826,367,144,,,0,0,0,,,,,,
826,367,145,826,367,144,,,0,0,1,,,,,,
826,367,149,826,367,149,,,0,0,0,,,,,,
826,367,157,826,367,158,,,0,0,-1,,,,,,
826,367,167,826,367,167,,,0,0,0,,,,,,
826,367,180,826,367,181,,,0,0,-1,,,,,,
826,367,195,826,367,195,,,0,0,0,,,,,,
826,367,212,826,367,213,,,0,0,-1,,,,,,
826,368,231,826,368,230,,,0,0,1,,,,,,
827,368,250,826,368,250,,,1,0,0,,,,,,
827,368,271,826,368,271,,,1,0,0,,,,,,
827,368,292,826,369,292,,,1,-1,0,,,,,,
827,369,313,827,369,313,,,0,0,0,,,,,,
827,369,335,827,369,336,,,0,0,-1,,,,,,
827,370,358,827,370,358,,,0,0,0,,,,,,
827,370,381,827,370,381,,,0,0,0,,,,,,
828,371,404,827,371,404,,,1,0,0,,,,,,
828,371,428,828,371,428,,,0,0,0,,,,,,
828,372,451,828,372,451,,,0,0,0,,,,,,
828,372,475,828,373,475,,,0,-1,0,,,,,,
829,373,499,828,374,499,,,1,-1,0,,,,,,
829,374,524,829,374,523,,,0,0,1,,,,,,
829,374,548,829,375,548,,,0,-1,0,,,,,,
829,375,572,829,375,572,,,0,0,0,,,,,,
830,376,597,829,376,597,,,1,0,0,,,,,,
830,377,622,830,377,621,,,0,0,1,,,,,,
830,378,646,830,378,646,,,0,0,0,,,,,,
831,379,671,831,379,671,,,0,0,0,,,,,,
831,380,696,831,380,696,,,0,0,0,,,,,,
832,381,721,832,381,721,,,0,0,0,,,,,,
832,382,746,832,382,746,,,0,0,0,,,,,,
832,383,771,832,383,771,,,0,0,0,,,,,,
829,390,148,829,390,148,,,0,0,0,,,,,,
829,390,149,829,390,148,,,0,0,1,,,,,,
829,390,153,829,390,153,,,0,0,0,,,,,,
829,390,161,829,390,162,,,0,0,-1,,,,,,
829,390,171,829,390,171,,,0,0,0,,,,,,
829,390,183,829,390,184,,,0,0,-1,,,,,,
829,390,198,829,390,198,,,0,0,0,,,,,,
829,390,215,829,390,215,,,0,0,0,,,,,,
829,390,233,829,390,233,,,0,0,0,,,,,,
829,391,252,829,390,253,,,0,1,-1,,,,,,
829,391,273,829,391,273,,,0,0,0,,,,,,
830,391,293,829,391,294,,,1,0,-1,,,,,,
830,392,315,830,392,315,,,0,0,0,,,,,,
830,392,337,830,392,337,,,0,0,0,,,,,,
830,392,360,830,392,360,,,0,0,0,,,,,,
830,393,382,830,392,383,,,0,1,-1,,,,,,
830,393,406,830,393,406,,,0,0,0,,,,,,
831,394,429,830,393,429,,,1,1,0,,,,,,
831,394,453,831,394,453,,,0,0,0,,,,,,
831,395,476,831,395,476,,,0,0,0,,,,,,
831,396,500,831,396,500,,,0,0,0,,,,,,
832,396,525,831,396,524,,,1,0,1,,,,,,
832,397,549,832,397,549,,,0,0,0,,,,,,
832,398,573,832,397,573,,,0,1,0,,,,,,
832,398,598,832,398,598,,,0,0,0,,,,,,
833,399,622,832,399,622,,,1,0,0,,,,,,
833,400,647,833,400,647,,,0,0,0,,,,,,
834,401,672,833,401,672,,,1,0,0,,,,,,
834,402,697,834,402,697,,,0,0,0,,,,,,
834,403,722,834,403,722,,,0,0,0,,,,,,
835,404,747,835,404,747,,,0,0,0,,,,,,
835,405,772,835,405,772,,,0,0,0,,,,,,
832,413,153,832,414,152,,,0,-1,1,,,,,,
832,413,154,832,414,152,,,0,-1,2,,,,,,
832,413,158,832,414,157,,,0,-1,1,,,,,,
832,413,165,832,414,166,,,0,-1,-1,,,,,,
832,413,174,832,414,174,,,0,-1,0,,,,,,
832,414,187,832,414,188,,,0,0,-1,,,,,,
832,414,201,832,414,201,,,0,0,0,,,,,,
832,414,218,832,414,218,,,0,0,0,,,,,,
832,414,236,832,414,236,,,0,0,0,,,,,,
832,414,255,832,414,255,,,0,0,0,,,,,,
832,415,275,832,415,275,,,0,0,0,,,,,,
833,415,296,832,415,296,,,1,0,0,,,,,,
833,415,317,833,415,317,,,0,0,0,,,,,,
833,415,339,833,415,339,,,0,0,0,,,,,,
833,416,361,833,416,361,,,0,0,0,,,,,,
833,416,384,833,416,384,,,0,0,0,,,,,,
833,417,407,833,417,407,,,0,0,0,,,,,,
834,417,430,833,417,430,,,1,0,0,,,,,,
834,418,454,834,418,454,,,0,0,0,,,,,,
834,418,478,834,418,477,,,0,0,1,,,,,,
834,419,502,834,419,501,,,0,0,1,,,,,,
835,419,526,834,420,525,,,1,-1,1,,,,,,
835,420,550,835,420,550,,,0,0,0,,,,,,
835,421,574,835,421,574,,,0,0,0,,,,,,
836,421,599,835,421,599,,,1,0,0,,,,,,
836,422,623,836,422,623,,,0,0,0,,,,,,
836,423,648,836,423,648,,,0,0,0,,,,,,
837,424,673,836,424,673,,,1,0,0,,,,,,
837,425,698,837,425,698,,,0,0,0,,,,,,
837,426,723,837,426,722,,,0,0,1,,,,,,
838,427,748,838,427,747,,,0,0,1,,,,,,
838,428,773,838,428,772,,,0,0,1,,,,,,
835,438,157,835,438,157,,,0,0,0,,,,,,
835,438,158,835,438,157,,,0,0,1,,,,,,
835,438,162,835,438,162,,,0,0,0,,,,,,
835,438,169,835,438,170,,,0,0,-1,,,,,,
835,438,178,835,438,178,,,0,0,0,,,,,,
835,438,191,835,438,191,,,0,0,0,,,,,,
835,438,205,835,438,205,,,0,0,0,,,,,,
836,438,221,835,438,222,,,1,0,-1,,,,,,
836,438,239,836,438,239,,,0,0,0,,,,,,
836,439,257,836,438,258,,,0,1,-1,,,,,,
836,439,277,836,439,277,,,0,0,0,,,,,,
836,439,298,836,439,298,,,0,0,0,,,,,,
836,439,319,836,439,319,,,0,0,0,,,,,,
836,440,341,836,439,341,,,0,1,0,,,,,,
836,440,363,836,440,363,,,0,0,0,,,,,,
837,440,386,836,440,386,,,1,0,0,,,,,,
837,441,409,837,441,409,,,0,0,0,,,,,,
837,441,432,837,441,432,,,0,0,0,,,,,,
837,442,455,837,442,455,,,0,0,0,,,,,,
837,442,479,837,442,479,,,0,0,0,,,,,,
838,443,503,838,443,503,,,0,0,0,,,,,,
838,443,527,838,443,527,,,0,0,0,,,,,,
838,444,551,838,444,551,,,0,0,0,,,,,,
839,445,575,838,444,575,,,1,1,0,,,,,,
839,445,600,839,445,600,,,0,0,0,,,,,,
839,446,624,839,446,624,,,0,0,0,,,,,,
840,447,649,840,447,649,,,0,0,0,,,,,,
840,448,674,840,447,674,,,0,1,0,,,,,,
840,448,699,840,448,699,,,0,0,0,,,,,,
841,449,723,840,449,723,,,1,0,0,,,,,,
841,450,748,841,450,748,,,0,0,0,,,,,,
842,451,773,841,451,773,,,1,0,0,,,,,,
839,463,162,839,463,162,,,0,0,0,,,,,,
839,463,163,839,463,162,,,0,0,1,,,,,,
839,463,167,839,463,167,,,0,0,0,,,,,,
839,463,173,839,463,174,,,0,0,-1,,,,,,
839,463,183,839,463,182,,,0,0,1,,,,,,
839,463,194,839,463,195,,,0,0,-1,,,,,,
839,463,208,839,463,208,,,0,0,0,,,,,,
839,463,224,839,463,225,,,0,0,-1,,,,,,
839,463,242,839,463,242,,,0,0,0,,,,,,
839,463,260,839,463,261,,,0,0,-1,,,,,,
839,464,280,839,464,280,,,0,0,0,,,,,,
840,464,300,839,464,300,,,1,0,0,,,,,,
840,464,321,840,464,321,,,0,0,0,,,,,,
840,464,343,840,464,343,,,0,0,0,,,,,,
840,465,365,840,465,365,,,0,0,0,,,,,,
840,465,387,840,465,387,,,0,0,0,,,,,,
840,466,410,840,466,410,,,0,0,0,,,,,,
841,466,433,840,466,433,,,1,0,0,,,,,,
841,466,457,841,467,456,,,0,-1,1,,,,,,
841,467,480,841,467,480,,,0,0,0,,,,,,
841,467,504,841,468,504,,,0,-1,0,,,,,,
842,468,528,841,468,528,,,1,0,0,,,,,,
842,469,552,842,469,552,,,0,0,0,,,,,,
842,469,576,842,469,576,,,0,0,0,,,,,,
842,470,601,842,470,601,,,0,0,0,,,,,,
843,470,625,843,470,625,,,0,0,0,,,,,,
843,471,650,843,471,650,,,0,0,0,,,,,,
844,472,675,843,472,674,,,1,0,1,,,,,,
844,473,699,844,472,699,,,0,1,0,,,,,,
844,473,724,844,473,724,,,0,0,0,,,,,,
845,474,749,845,474,749,,,0,0,0,,,,,,
845,475,774,845,475,774,,,0,0,0,,,,,,
843,488,167,843,488,167,,,0,0,0,,,,,,
843,488,168,843,488,167,,,0,0,1,,,,,,
843,488,172,843,488,172,,,0,0,0,,,,,,
843,488,178,843,488,179,,,0,0,-1,,,,,,
843,488,187,843,488,187,,,0,0,0,,,,,,
843,488,199,843,488,199,,,0,0,0,,,,,,
843,488,212,843,488,212,,,0,0,0,,,,,,
843,488,228,843,488,228,,,0,0,0,,,,,,
843,489,245,843,489,245,,,0,0,0,,,,,,
843,489,263,843,489,264,,,0,0,-1,,,,,,
843,489,283,843,489,283,,,0,0,0,,,,,,
843,489,303,843,489,303,,,0,0,0,,,,,,
844,489,324,844,489,324,,,0,0,0,,,,,,
844,490,345,844,489,345,,,0,1,0,,,,,,
844,490,367,844,490,367,,,0,0,0,,,,,,
844,490,389,844,490,389,,,0,0,0,,,,,,
844,491,412,844,491,412,,,0,0,0,,,,,,
844,491,435,844,491,435,,,0,0,0,,,,,,
845,492,458,845,492,458,,,0,0,0,,,,,,
845,492,482,845,492,482,,,0,0,0,,,,,,
845,493,506,845,493,506,,,0,0,0,,,,,,
845,493,529,845,493,530,,,0,0,-1,,,,,,
846,494,554,846,494,554,,,0,0,0,,,,,,
846,494,578,846,494,578,,,0,0,0,,,,,,
846,495,602,846,495,602,,,0,0,0,,,,,,
847,495,626,846,495,626,,,1,0,0,,,,,,
847,496,651,847,496,651,,,0,0,0,,,,,,
847,497,676,847,496,675,,,0,1,1,,,,,,
848,497,700,848,497,700,,,0,0,0,,,,,,
848,498,725,848,498,725,,,0,0,0,,,,,,
849,499,750,849,499,750,,,0,0,0,,,,,,
849,500,775,849,500,775,,,0,0,0,,,,,,
847,514,172,847,514,172,,,0,0,0,,,,,,
847,514,173,847,514,172,,,0,0,1,,,,,,
847,514,177,847,514,177,,,0,0,0,,,,,,
847,514,183,847,514,184,,,0,0,-1,,,,,,
847,514,192,847,514,192,,,0,0,0,,,,,,
847,514,203,847,514,204,,,0,0,-1,,,,,,
847,514,216,847,514,216,,,0,0,0,,,,,,
847,514,232,847,514,232,,,0,0,0,,,,,,
847,514,248,847,515,248,,,0,-1,0,,,,,,
847,515,266,847,515,267,,,0,0,-1,,,,,,
848,515,286,847,515,286,,,1,0,0,,,,,,
848,515,306,847,515,306,,,1,0,0,,,,,,
848,515,326,848,515,326,,,0,0,0,,,,,,
848,515,347,848,515,348,,,0,0,-1,,,,,,
848,516,369,848,516,369,,,0,0,0,,,,,,
848,516,391,848,516,391,,,0,0,0,,,,,,
848,516,414,848,516,414,,,0,0,0,,,,,,
849,517,437,848,517,437,,,1,0,0,,,,,,
849,517,460,849,517,460,,,0,0,0,,,,,,
849,518,484,849,518,483,,,0,0,1,,,,,,
849,518,507,849,518,507,,,0,0,0,,,,,,
850,519,531,849,519,531,,,1,0,0,,,,,,
850,519,555,850,519,555,,,0,0,0,,,,,,
850,520,579,850,520,579,,,0,0,0,,,,,,
851,520,603,850,520,603,,,1,0,0,,,,,,
851,521,628,851,521,627,,,0,0,1,,,,,,
851,521,652,851,521,652,,,0,0,0,,,,,,
852,522,677,851,522,676,,,1,0,1,,,,,,
852,523,702,852,523,701,,,0,0,1,,,,,,
852,524,726,852,523,726,,,0,1,0,,,,,,
853,524,751,853,524,751,,,0,0,0,,,,,,
853,525,776,853,525,776,,,0,0,0,,,,,,
851,540,178,851,540,178,,,0,0,0,,,,,,
851,540,179,851,540,178,,,0,0,1,,,,,,
851,540,182,851,540,182,,,0,0,0,,,,,,
852,540,188,851,540,189,,,1,0,-1,,,,,,
852,540,197,852,540,197,,,0,0,0,,,,,,
852,540,208,852,540,209,,,0,0,-1,,,,,,
852,540,221,852,540,221,,,0,0,0,,,,,,
852,540,236,852,540,236,,,0,0,0,,,,,,
852,541,252,852,541,252,,,0,0,0,,,,,,
852,541,270,852,541,270,,,0,0,0,,,,,,
852,541,289,852,541,289,,,0,0,0,,,,,,
852,541,308,852,541,309,,,0,0,-1,,,,,,
852,541,329,852,541,329,,,0,0,0,,,,,,
852,542,350,852,541,350,,,0,1,0,,,,,,
853,542,372,853,542,372,,,0,0,0,,,,,,
853,542,394,853,542,394,,,0,0,0,,,,,,
853,542,416,853,542,416,,,0,0,0,,,,,,
853,543,439,853,542,439,,,0,1,0,,,,,,
853,543,462,853,543,462,,,0,0,0,,,,,,
854,544,485,853,543,485,,,1,1,0,,,,,,
854,544,509,854,544,509,,,0,0,0,,,,,,
854,545,533,854,544,532,,,0,1,1,,,,,,
854,545,556,854,545,556,,,0,0,0,,,,,,
855,546,580,854,545,580,,,1,1,0,,,,,,
855,546,605,855,546,605,,,0,0,0,,,,,,
855,547,629,855,546,629,,,0,1,0,,,,,,
856,547,653,856,547,653,,,0,0,0,,,,,,
856,548,678,856,548,678,,,0,0,0,,,,,,
856,549,703,856,549,703,,,0,0,0,,,,,,
857,549,727,856,549,727,,,1,0,0,,,,,,
857,550,752,857,550,752,,,0,0,0,,,,,,
858,551,777,857,550,777,,,1,1,0,,,,,,
856,567,184,856,566,183,,,0,1,1,,,,,,
856,567,184,856,566,183,,,0,1,1,,,,,,
856,567,188,856,566,187,,,0,1,1,,,,,,
856,567,193,856,566,194,,,0,1,-1,,,,,,
856,567,202,856,566,202,,,0,1,0,,,,,,
856,567,212,856,566,213,,,0,1,-1,,,,,,
856,567,225,856,567,225,,,0,0,0,,,,,,
856,567,240,856,567,240,,,0,0,0,,,,,,
857,567,256,857,567,256,,,0,0,0,,,,,,
857,567,273,857,567,274,,,0,0,-1,,,,,,
857,567,292,857,567,292,,,0,0,0,,,,,,
857,568,312,857,567,312,,,0,1,0,,,,,,
857,568,332,857,568,332,,,0,0,0,,,,,,
857,568,353,857,568,353,,,0,0,0,,,,,,
857,568,374,857,568,374,,,0,0,0,,,,,,
857,569,396,857,568,396,,,0,1,0,,,,,,
858,569,418,858,569,418,,,0,0,0,,,,,,
858,569,441,858,569,441,,,0,0,0,,,,,,
858,570,464,858,569,464,,,0,1,0,,,,,,
858,570,487,858,570,487,,,0,0,0,,,,,,
859,570,511,859,570,510,,,0,0,1,,,,,,
859,571,534,859,571,534,,,0,0,0,,,,,,
859,571,558,859,571,558,,,0,0,0,,,,,,
859,572,582,859,572,582,,,0,0,0,,,,,,
860,572,606,860,572,606,,,0,0,0,,,,,,
860,573,630,860,573,630,,,0,0,0,,,,,,
860,573,655,860,573,654,,,0,0,1,,,,,,
861,574,679,860,574,679,,,1,0,0,,,,,,
861,575,704,861,575,704,,,0,0,0,,,,,,
861,575,729,861,575,728,,,0,0,1,,,,,,
862,576,753,862,576,753,,,0,0,0,,,,,,
862,577,778,862,576,778,,,0,1,0,,,,,,
861,593,189,861,593,189,,,0,0,0,,,,,,
861,593,190,861,593,189,,,0,0,1,,,,,,
861,593,193,861,593,193,,,0,0,0,,,,,,
861,593,199,861,593,200,,,0,0,-1,,,,,,
861,593,207,861,593,207,,,0,0,0,,,,,,
861,593,217,861,593,218,,,0,0,-1,,,,,,
861,594,230,861,594,230,,,0,0,0,,,,,,
861,594,244,861,594,245,,,0,0,-1,,,,,,
862,594,260,862,594,260,,,0,0,0,,,,,,
862,594,277,862,594,278,,,0,0,-1,,,,,,
862,594,296,862,594,296,,,0,0,0,,,,,,
862,594,315,862,594,315,,,0,0,0,,,,,,
862,595,335,862,595,335,,,0,0,0,,,,,,
862,595,356,862,595,356,,,0,0,0,,,,,,
862,595,377,862,595,377,,,0,0,0,,,,,,
862,595,399,862,595,399,,,0,0,0,,,,,,
863,596,421,863,596,421,,,0,0,0,,,,,,
863,596,443,863,596,443,,,0,0,0,,,,,,
863,596,466,863,596,466,,,0,0,0,,,,,,
863,597,489,863,596,489,,,0,1,0,,,,,,
864,597,512,864,597,512,,,0,0,0,,,,,,
864,597,536,864,597,536,,,0,0,0,,,,,,
864,598,560,864,598,560,,,0,0,0,,,,,,
864,598,584,864,598,584,,,0,0,0,,,,,,
865,599,608,865,599,608,,,0,0,0,,,,,,
865,599,632,865,599,632,,,0,0,0,,,,,,
865,600,656,865,600,656,,,0,0,0,,,,,,
866,600,681,865,600,680,,,1,0,1,,,,,,
866,601,705,866,601,705,,,0,0,0,,,,,,
866,602,730,866,601,730,,,0,1,0,,,,,,
867,602,755,867,602,755,,,0,0,0,,,,,,
867,603,780,867,603,779,,,0,0,1,,,,,,
867,620,195,866,620,195,,,1,0,0,,,,,,
867,620,196,866,620,195,,,1,0,1,,,,,,
867,620,199,866,620,199,,,1,0,0,,,,,,
867,620,205,866,620,205,,,1,0,0,,,,,,
867,620,212,866,620,212,,,1,0,0,,,,,,
867,621,223,866,620,223,,,1,1,0,,,,,,
867,621,235,866,621,235,,,1,0,0,,,,,,
867,621,249,866,621,249,,,1,0,0,,,,,,
867,621,264,867,621,264,,,0,0,0,,,,,,
867,621,281,867,621,282,,,0,0,-1,,,,,,
867,621,299,867,621,299,,,0,0,0,,,,,,
867,621,318,867,621,318,,,0,0,0,,,,,,
867,622,338,867,622,338,,,0,0,0,,,,,,
867,622,359,867,622,359,,,0,0,0,,,,,,
868,622,380,867,622,380,,,1,0,0,,,,,,
868,622,401,867,622,401,,,1,0,0,,,,,,
868,623,423,868,623,423,,,0,0,0,,,,,,
868,623,446,868,623,446,,,0,0,0,,,,,,
868,623,468,868,623,468,,,0,0,0,,,,,,
869,624,491,868,623,491,,,1,1,0,,,,,,
869,624,514,869,624,514,,,0,0,0,,,,,,
869,624,538,869,624,538,,,0,0,0,,,,,,
869,625,562,869,625,561,,,0,0,1,,,,,,
870,625,585,870,625,585,,,0,0,0,,,,,,
870,626,609,870,626,609,,,0,0,0,,,,,,
870,626,634,870,626,633,,,0,0,1,,,,,,
871,627,658,870,627,657,,,1,0,1,,,,,,
871,627,682,871,627,682,,,0,0,0,,,,,,
871,628,707,871,628,706,,,0,0,1,,,,,,
872,628,731,872,628,731,,,0,0,0,,,,,,
872,629,756,872,629,756,,,0,0,0,,,,,,
873,630,781,872,629,780,,,1,1,1,,,,,,
872,648,202,872,648,202,,,0,0,0,,,,,,
872,648,202,872,648,202,,,0,0,0,,,,,,
872,648,205,872,648,205,,,0,0,0,,,,,,
872,648,210,872,648,211,,,0,0,-1,,,,,,
872,648,218,872,648,218,,,0,0,0,,,,,,
872,648,228,872,648,229,,,0,0,-1,,,,,,
872,648,240,872,648,240,,,0,0,0,,,,,,
872,648,253,872,648,254,,,0,0,-1,,,,,,
872,648,269,872,648,269,,,0,0,0,,,,,,
872,648,285,872,648,286,,,0,0,-1,,,,,,
873,648,303,873,648,303,,,0,0,0,,,,,,
873,649,322,873,648,322,,,0,1,0,,,,,,
873,649,341,873,649,341,,,0,0,0,,,,,,
873,649,362,873,649,362,,,0,0,0,,,,,,
873,649,383,873,649,383,,,0,0,0,,,,,,
873,649,404,873,649,404,,,0,0,0,,,,,,
873,650,426,873,650,426,,,0,0,0,,,,,,
874,650,448,873,650,448,,,1,0,0,,,,,,
874,650,471,874,650,471,,,0,0,0,,,,,,
874,651,493,874,650,494,,,0,1,-1,,,,,,
874,651,517,874,651,517,,,0,0,0,,,,,,
875,651,540,874,651,540,,,1,0,0,,,,,,
875,652,563,875,652,563,,,0,0,0,,,,,,
875,652,587,875,652,587,,,0,0,0,,,,,,
876,653,611,876,653,611,,,0,0,0,,,,,,
876,653,635,876,653,635,,,0,0,0,,,,,,
876,654,659,876,654,659,,,0,0,0,,,,,,
877,654,684,876,654,683,,,1,0,1,,,,,,
877,655,708,877,655,708,,,0,0,0,,,,,,
877,655,733,877,655,732,,,0,0,1,,,,,,
878,656,757,878,656,757,,,0,0,0,,,,,,
878,656,782,878,656,782,,,0,0,0,,,,,,
878,675,208,878,675,208,,,0,0,0,,,,,,
878,675,209,878,675,208,,,0,0,1,,,,,,
878,675,211,878,675,211,,,0,0,0,,,,,,
878,675,216,878,675,217,,,0,0,-1,,,,,,
878,675,224,878,675,224,,,0,0,0,,,,,,
878,675,233,878,675,234,,,0,0,-1,,,,,,
878,675,245,878,675,245,,,0,0,0,,,,,,
878,675,258,878,675,259,,,0,0,-1,,,,,,
878,676,273,878,675,273,,,0,1,0,,,,,,
878,676,290,878,675,290,,,0,1,0,,,,,,
878,676,307,879,676,307,,,-1,0,0,,,,,,
879,676,326,879,676,326,,,0,0,0,,,,,,
879,676,345,879,676,345,,,0,0,0,,,,,,
879,676,365,879,676,365,,,0,0,0,,,,,,
879,677,386,879,676,386,,,0,1,0,,,,,,
879,677,407,879,677,407,,,0,0,0,,,,,,
879,677,429,879,677,428,,,0,0,1,,,,,,
880,677,451,879,677,451,,,1,0,0,,,,,,
880,678,473,880,677,473,,,0,1,0,,,,,,
880,678,496,880,678,496,,,0,0,0,,,,,,
880,678,519,880,678,519,,,0,0,0,,,,,,
880,679,542,880,679,542,,,0,0,0,,,,,,
881,679,566,881,679,565,,,0,0,1,,,,,,
881,680,589,881,679,589,,,0,1,0,,,,,,
881,680,613,881,680,613,,,0,0,0,,,,,,
882,680,637,881,680,637,,,1,0,0,,,,,,
882,681,661,882,681,661,,,0,0,0,,,,,,
882,681,685,882,681,685,,,0,0,0,,,,,,
883,682,710,883,682,709,,,0,0,1,,,,,,
883,682,734,883,682,734,,,0,0,0,,,,,,
883,683,759,884,683,758,,,-1,0,1,,,,,,
884,684,784,884,683,783,,,0,1,1,,,,,,
884,703,214,884,703,214,,,0,0,0,,,,,,
884,703,215,884,703,214,,,0,0,1,,,,,,
884,703,218,884,703,218,,,0,0,0,,,,,,
884,703,222,884,703,224,,,0,0,-2,,,,,,
884,703,230,884,703,230,,,0,0,0,,,,,,
884,703,239,884,703,240,,,0,0,-1,,,,,,
884,703,250,884,703,250,,,0,0,0,,,,,,
884,703,263,884,703,264,,,0,0,-1,,,,,,
884,703,278,884,703,278,,,0,0,0,,,,,,
884,703,294,884,703,294,,,0,0,0,,,,,,
885,704,311,885,704,311,,,0,0,0,,,,,,
885,704,329,885,704,330,,,0,0,-1,,,,,,
885,704,349,885,704,349,,,0,0,0,,,,,,
885,704,368,885,704,369,,,0,0,-1,,,,,,
885,704,389,885,704,389,,,0,0,0,,,,,,
885,704,410,885,704,410,,,0,0,0,,,,,,
885,705,431,885,705,431,,,0,0,0,,,,,,
886,705,453,885,705,453,,,1,0,0,,,,,,
886,705,476,886,705,476,,,0,0,0,,,,,,
886,706,498,886,705,498,,,0,1,0,,,,,,
886,706,521,886,706,521,,,0,0,0,,,,,,
887,706,544,886,706,544,,,1,0,0,,,,,,
887,707,568,887,707,568,,,0,0,0,,,,,,
887,707,591,887,707,591,,,0,0,0,,,,,,
887,707,615,887,707,615,,,0,0,0,,,,,,
888,708,639,887,707,639,,,1,1,0,,,,,,
888,708,663,888,708,663,,,0,0,0,,,,,,
888,709,687,888,708,687,,,0,1,0,,,,,,
889,709,711,889,709,711,,,0,0,0,,,,,,
889,710,736,889,709,735,,,0,1,1,,,,,,
890,710,760,890,710,760,,,0,0,0,,,,,,
890,711,785,890,710,785,,,0,1,0,,,,,,
890,731,221,890,731,220,,,0,0,1,,,,,,
890,731,221,890,731,220,,,0,0,1,,,,,,
890,731,224,890,731,224,,,0,0,0,,,,,,
890,731,229,890,731,230,,,0,0,-1,,,,,,
890,731,236,890,731,236,,,0,0,0,,,,,,
891,731,245,890,731,245,,,1,0,0,,,,,,
891,731,256,890,731,255,,,1,0,1,,,,,,
891,731,268,890,731,269,,,1,0,-1,,,,,,
891,731,283,890,731,283,,,1,0,0,,,,,,
891,731,299,891,731,299,,,0,0,0,,,,,,
891,731,316,891,731,315,,,0,0,1,,,,,,
891,731,334,891,731,334,,,0,0,0,,,,,,
891,732,352,891,732,352,,,0,0,0,,,,,,
891,732,372,891,732,372,,,0,0,0,,,,,,
891,732,392,891,732,392,,,0,0,0,,,,,,
892,732,413,891,732,413,,,1,0,0,,,,,,
892,732,434,891,732,434,,,1,0,0,,,,,,
892,733,456,892,732,456,,,0,1,0,,,,,,
892,733,478,892,733,478,,,0,0,0,,,,,,
892,733,501,892,733,501,,,0,0,0,,,,,,
893,734,524,892,734,523,,,1,0,1,,,,,,
893,734,547,893,734,546,,,0,0,1,,,,,,
893,734,570,893,734,570,,,0,0,0,,,,,,
893,735,593,893,734,593,,,0,1,0,,,,,,
894,735,617,893,735,617,,,1,0,0,,,,,,
894,735,641,894,735,641,,,0,0,0,,,,,,
894,736,665,894,736,665,,,0,0,0,,,,,,
895,736,689,895,736,689,,,0,0,0,,,,,,
895,737,713,895,737,713,,,0,0,0,,,,,,
895,737,737,895,737,737,,,0,0,0,,,,,,
896,738,762,896,738,762,,,0,0,0,,,,,,
896,738,787,896,738,786,,,0,0,1,,,,,,
897,759,227,897,759,227,,,0,0,0,,,,,,
897,759,228,897,759,227,,,0,0,1,,,,,,
897,759,230,897,759,230,,,0,0,0,,,,,,
897,759,235,897,759,236,,,0,0,-1,,,,,,
897,759,242,897,759,242,,,0,0,0,,,,,,
897,759,251,897,759,251,,,0,0,0,,,,,,
897,759,261,897,759,261,,,0,0,0,,,,,,
897,759,274,897,759,274,,,0,0,0,,,,,,
897,759,288,897,759,288,,,0,0,0,,,,,,
897,759,303,897,759,304,,,0,0,-1,,,,,,
898,759,320,898,759,320,,,0,0,0,,,,,,
898,759,338,898,759,338,,,0,0,0,,,,,,
898,760,356,898,760,356,,,0,0,0,,,,,,
898,760,376,898,760,376,,,0,0,0,,,,,,
898,760,396,898,760,396,,,0,0,0,,,,,,
898,760,416,898,760,417,,,0,0,-1,,,,,,
898,760,438,898,760,438,,,0,0,0,,,,,,
899,761,459,898,760,459,,,1,1,0,,,,,,
899,761,481,899,761,481,,,0,0,0,,,,,,
899,761,503,899,761,503,,,0,0,0,,,,,,
899,762,526,899,762,526,,,0,0,0,,,,,,
900,762,549,899,762,549,,,1,0,0,,,,,,
900,762,572,900,762,572,,,0,0,0,,,,,,
900,763,596,900,762,595,,,0,1,1,,,,,,
900,763,619,900,763,619,,,0,0,0,,,,,,
901,763,643,900,763,643,,,1,0,0,,,,,,
901,764,667,901,764,667,,,0,0,0,,,,,,
901,764,691,901,764,691,,,0,0,0,,,,,,
902,765,715,902,765,715,,,0,0,0,,,,,,
902,765,739,902,765,739,,,0,0,0,,,,,,
902,766,764,902,766,764,,,0,0,0,,,,,,
903,766,788,902,766,788,,,1,0,0,,,,,,
904,787,234,904,787,234,,,0,0,0,,,,,,
904,787,234,904,787,234,,,0,0,0,,,,,,
904,787,237,904,787,237,,,0,0,0,,,,,,
904,787,241,904,787,242,,,0,0,-1,,,,,,
904,787,248,904,787,248,,,0,0,0,,,,,,
904,787,256,904,787,257,,,0,0,-1,,,,,,
904,787,267,904,787,267,,,0,0,0,,,,,,
904,787,279,904,787,280,,,0,0,-1,,,,,,
904,787,293,904,787,293,,,0,0,0,,,,,,
904,787,308,904,787,308,,,0,0,0,,,,,,
904,787,325,905,787,324,,,-1,0,1,,,,,,
905,788,342,905,787,342,,,0,1,0,,,,,,
905,788,360,905,788,360,,,0,0,0,,,,,,
905,788,380,905,788,380,,,0,0,0,,,,,,
905,788,399,905,788,399,,,0,0,0,,,,,,
905,788,420,905,788,420,,,0,0,0,,,,,,
905,789,441,905,788,441,,,0,1,0,,,,,,
905,789,462,905,788,462,,,0,1,0,,,,,,
906,789,484,906,789,484,,,0,0,0,,,,,,
906,789,506,906,789,506,,,0,0,0,,,,,,
906,790,529,906,790,528,,,0,0,1,,,,,,
906,790,552,906,790,551,,,0,0,1,,,,,,
907,790,575,907,790,574,,,0,0,1,,,,,,
907,791,598,907,790,598,,,0,1,0,,,,,,
907,791,621,907,791,621,,,0,0,0,,,,,,
908,791,645,907,791,645,,,1,0,0,,,,,,
908,792,669,908,792,669,,,0,0,0,,,,,,
908,792,693,908,792,693,,,0,0,0,,,,,,
909,792,717,909,793,717,,,0,-1,0,,,,,,
909,793,741,909,793,741,,,0,0,0,,,,,,
909,793,765,909,793,765,,,0,0,0,,,,,,
910,794,790,909,794,790,,,1,0,0,,,,,,
911,815,241,911,815,241,,,0,0,0,,,,,,
911,815,241,911,815,241,,,0,0,0,,,,,,
911,815,244,911,815,244,,,0,0,0,,,,,,
911,815,248,911,815,249,,,0,0,-1,,,,,,
911,815,254,911,815,254,,,0,0,0,,,,,,
911,815,263,911,815,263,,,0,0,0,,,,,,
911,815,273,911,815,273,,,0,0,0,,,,,,
911,815,285,911,815,285,,,0,0,0,,,,,,
911,815,298,911,815,298,,,0,0,0,,,,,,
911,816,313,911,815,313,,,0,1,0,,,,,,
912,816,329,912,816,329,,,0,0,0,,,,,,
912,816,346,912,816,347,,,0,0,-1,,,,,,
912,816,365,912,816,365,,,0,0,0,,,,,,
912,816,384,912,816,384,,,0,0,0,,,,,,
912,816,403,912,816,403,,,0,0,0,,,,,,
912,816,423,912,816,423,,,0,0,0,,,,,,
912,817,444,912,817,444,,,0,0,0,,,,,,
913,817,465,912,817,465,,,1,0,0,,,,,,
913,817,487,913,817,487,,,0,0,0,,,,,,
913,817,509,913,817,509,,,0,0,0,,,,,,
913,818,531,913,818,531,,,0,0,0,,,,,,
914,818,554,913,818,554,,,1,0,0,,,,,,
914,818,577,914,818,577,,,0,0,0,,,,,,
914,819,600,914,818,600,,,0,1,0,,,,,,
914,819,624,914,819,624,,,0,0,0,,,,,,
915,819,647,914,819,647,,,1,0,0,,,,,,
915,820,671,915,820,671,,,0,0,0,,,,,,
915,820,695,915,820,695,,,0,0,0,,,,,,
916,821,719,916,821,719,,,0,0,0,,,,,,
916,821,743,916,821,743,,,0,0,0,,,,,,
916,821,767,916,821,767,,,0,0,0,,,,,,
917,822,792,916,821,791,,,1,1,1,,,,,,
918,844,247,918,843,247,,,0,1,0,,,,,,
918,844,248,918,843,247,,,0,1,1,,,,,,
918,844,250,918,843,250,,,0,1,0,,,,,,
919,844,254,918,843,255,,,1,1,-1,,,,,,
919,844,261,918,843,260,,,1,1,1,,,,,,
919,844,269,918,843,269,,,1,1,0,,,,,,
919,844,279,918,843,279,,,1,1,0,,,,,,
919,844,290,918,843,291,,,1,1,-1,,,,,,
919,844,304,918,843,303,,,1,1,1,,,,,,
919,844,318,919,844,318,,,0,0,0,,,,,,
919,844,334,919,844,334,,,0,0,0,,,,,,
919,844,351,919,844,351,,,0,0,0,,,,,,
919,844,369,919,844,369,,,0,0,0,,,,,,
919,844,388,919,844,388,,,0,0,0,,,,,,
919,845,407,919,844,407,,,0,1,0,,,,,,
920,845,427,919,844,427,,,1,1,0,,,,,,
920,845,448,919,845,447,,,1,0,1,,,,,,
920,845,469,920,845,468,,,0,0,1,,,,,,
920,845,490,920,845,490,,,0,0,0,,,,,,
920,846,512,920,845,512,,,0,1,0,,,,,,
921,846,534,920,846,534,,,1,0,0,,,,,,
921,846,557,921,846,556,,,0,0,1,,,,,,
921,847,580,921,846,579,,,0,1,1,,,,,,
921,847,603,921,847,602,,,0,0,1,,,,,,
922,847,626,921,847,626,,,1,0,0,,,,,,
922,848,649,922,847,649,,,0,1,0,,,,,,
922,848,673,922,848,673,,,0,0,0,,,,,,
923,848,697,923,848,697,,,0,0,0,,,,,,
923,849,721,923,849,721,,,0,0,0,,,,,,
923,849,745,923,849,745,,,0,0,0,,,,,,
924,850,769,923,849,769,,,1,1,0,,,,,,
924,850,793,924,850,793,,,0,0,0,,,,,,
926,872,254,926,872,254,,,0,0,0,,,,,,
926,872,255,926,872,254,,,0,0,1,,,,,,
926,872,257,926,872,257,,,0,0,0,,,,,,
926,872,261,926,872,262,,,0,0,-1,,,,,,
926,872,267,926,872,267,,,0,0,0,,,,,,
926,872,275,926,872,276,,,0,0,-1,,,,,,
926,872,285,926,872,285,,,0,0,0,,,,,,
926,872,296,926,872,297,,,0,0,-1,,,,,,
926,872,309,926,872,309,,,0,0,0,,,,,,
926,872,324,926,872,324,,,0,0,0,,,,,,
927,873,339,927,873,339,,,0,0,0,,,,,,
927,873,356,927,873,356,,,0,0,0,,,,,,
927,873,373,927,873,373,,,0,0,0,,,,,,
927,873,392,927,873,392,,,0,0,0,,,,,,
927,873,411,927,873,411,,,0,0,0,,,,,,
927,873,431,927,873,431,,,0,0,0,,,,,,
927,873,451,927,873,451,,,0,0,0,,,,,,
928,874,472,927,873,472,,,1,1,0,,,,,,
928,874,493,928,874,493,,,0,0,0,,,,,,
928,874,515,928,874,515,,,0,0,0,,,,,,
928,874,537,928,874,537,,,0,0,0,,,,,,
928,875,560,928,874,559,,,0,1,1,,,,,,
929,875,582,929,875,582,,,0,0,0,,,,,,
929,875,605,929,875,605,,,0,0,0,,,,,,
929,876,628,929,876,628,,,0,0,0,,,,,,
930,876,652,929,876,651,,,1,0,1,,,,,,
930,876,675,930,876,675,,,0,0,0,,,,,,
930,877,699,930,876,699,,,0,1,0,,,,,,
931,877,723,931,877,723,,,0,0,0,,,,,,
931,877,747,931,877,747,,,0,0,0,,,,,,
931,878,771,931,878,771,,,0,0,0,,,,,,
932,878,795,931,878,795,,,1,0,0,,,,,,
934,901,261,934,900,261,,,0,1,0,,,,,,
934,901,262,934,900,261,,,0,1,1,,,,,,
934,901,264,934,900,264,,,0,1,0,,,,,,
934,901,268,934,900,268,,,0,1,0,,,,,,
934,901,274,934,900,273,,,0,1,1,,,,,,
934,901,281,934,900,282,,,0,1,-1,,,,,,
934,901,291,934,900,291,,,0,1,0,,,,,,
934,901,302,934,900,303,,,0,1,-1,,,,,,
934,901,315,934,901,315,,,0,0,0,,,,,,
934,901,329,934,901,329,,,0,0,0,,,,,,
934,901,344,935,901,344,,,-1,0,0,,,,,,
935,901,361,935,901,361,,,0,0,0,,,,,,
935,901,378,935,901,378,,,0,0,0,,,,,,
935,902,396,935,901,396,,,0,1,0,,,,,,
935,902,415,935,901,415,,,0,1,0,,,,,,
935,902,435,935,901,435,,,0,1,0,,,,,,
935,902,455,935,902,455,,,0,0,0,,,,,,
935,902,476,935,902,475,,,0,0,1,,,,,,
936,902,497,936,902,496,,,0,0,1,,,,,,
936,903,518,936,902,518,,,0,1,0,,,,,,
936,903,540,936,903,540,,,0,0,0,,,,,,
936,903,563,936,903,562,,,0,0,1,,,,,,
937,903,585,937,903,585,,,0,0,0,,,,,,
937,904,608,937,904,608,,,0,0,0,,,,,,
937,904,631,937,904,631,,,0,0,0,,,,,,
937,904,654,937,904,654,,,0,0,0,,,,,,
938,905,678,938,904,677,,,0,1,1,,,,,,
938,905,701,938,905,701,,,0,0,0,,,,,,
938,905,725,938,905,725,,,0,0,0,,,,,,
939,906,749,938,906,749,,,1,0,0,,,,,,
939,906,773,939,906,773,,,0,0,0,,,,,,
939,907,797,939,907,797,,,0,0,0,,,,,,
841,233,127,841,232,127,,,0,1,0,,,,,,
841,233,129,841,232,127,,,0,1,2,,,,,,
841,233,133,841,232,133,,,0,1,0,,,,,,
841,233,142,841,232,143,,,0,1,-1,,,,,,
841,233,153,841,233,153,,,0,0,0,,,,,,
841,233,167,841,233,168,,,0,0,-1,,,,,,
841,233,184,841,233,184,,,0,0,0,,,,,,
841,234,202,841,233,202,,,0,1,0,,,,,,
841,234,221,841,234,221,,,0,0,0,,,,,,
842,234,241,841,234,241,,,1,0,0,,,,,,
842,235,263,841,235,262,,,1,0,1,,,,,,
842,235,284,841,235,284,,,1,0,0,,,,,,
842,236,307,842,236,306,,,0,0,1,,,,,,
842,237,329,842,236,329,,,0,1,0,,,,,,
842,237,352,842,237,352,,,0,0,0,,,,,,
842,238,376,842,238,375,,,0,0,1,,,,,,
843,239,399,842,239,399,,,1,0,0,,,,,,
843,240,423,842,239,423,,,1,1,0,,,,,,
843,241,447,843,240,447,,,0,1,0,,,,,,
843,242,471,843,241,471,,,0,1,0,,,,,,
843,243,495,843,242,495,,,0,1,0,,,,,,
844,244,520,843,244,519,,,1,0,1,,,,,,
844,245,544,844,245,544,,,0,0,0,,,,,,
844,246,569,844,246,568,,,0,0,1,,,,,,
845,248,594,845,247,593,,,0,1,1,,,,,,
845,249,619,845,249,618,,,0,0,1,,,,,,
845,251,643,845,250,643,,,0,1,0,,,,,,
846,252,668,845,252,668,,,1,0,0,,,,,,
846,254,693,846,253,693,,,0,1,0,,,,,,
846,255,719,846,255,718,,,0,0,1,,,,,,
847,257,744,847,257,743,,,0,0,1,,,,,,
847,259,769,847,258,769,,,0,1,0,,,,,,
841,234,127,841,232,127,,,0,2,0,,,,,,
841,234,129,841,232,127,,,0,2,2,,,,,,
841,234,133,841,232,133,,,0,2,0,,,,,,
841,234,142,841,232,143,,,0,2,-1,,,,,,
841,234,153,841,233,153,,,0,1,0,,,,,,
841,234,167,841,233,168,,,0,1,-1,,,,,,
841,234,184,841,233,184,,,0,1,0,,,,,,
841,235,202,841,233,202,,,0,2,0,,,,,,
841,235,221,841,234,221,,,0,1,0,,,,,,
842,235,241,841,234,241,,,1,1,0,,,,,,
842,236,263,841,235,262,,,1,1,1,,,,,,
842,236,284,841,235,284,,,1,1,0,,,,,,
842,237,307,842,236,306,,,0,1,1,,,,,,
842,238,329,842,236,329,,,0,2,0,,,,,,
842,238,352,842,237,352,,,0,1,0,,,,,,
842,239,376,842,238,375,,,0,1,1,,,,,,
843,240,399,842,239,399,,,1,1,0,,,,,,
843,241,423,842,239,423,,,1,2,0,,,,,,
843,242,447,843,240,447,,,0,2,0,,,,,,
843,243,471,843,241,471,,,0,2,0,,,,,,
844,244,495,843,242,495,,,1,2,0,,,,,,
844,245,520,843,244,519,,,1,1,1,,,,,,
844,246,544,844,245,544,,,0,1,0,,,,,,
844,247,569,844,246,568,,,0,1,1,,,,,,
845,249,594,845,247,593,,,0,2,1,,,,,,
845,250,619,845,249,618,,,0,1,1,,,,,,
845,251,643,845,250,643,,,0,1,0,,,,,,
846,253,668,845,252,668,,,1,1,0,,,,,,
846,254,693,846,253,693,,,0,1,0,,,,,,
847,256,719,846,255,718,,,1,1,1,,,,,,
847,258,744,847,257,743,,,0,1,1,,,,,,
847,259,769,847,258,769,,,0,1,0,,,,,,
841,237,128,841,236,128,,,0,1,0,,,,,,
841,237,129,841,236,128,,,0,1,1,,,,,,
841,237,134,841,237,134,,,0,0,0,,,,,,
841,237,142,841,237,143,,,0,0,-1,,,,,,
841,237,154,841,237,153,,,0,0,1,,,,,,
842,237,168,841,237,168,,,1,0,0,,,,,,
842,238,184,841,237,184,,,1,1,0,,,,,,
842,238,202,841,238,202,,,1,0,0,,,,,,
842,238,221,842,238,221,,,0,0,0,,,,,,
842,239,242,842,238,242,,,0,1,0,,,,,,
842,239,263,842,239,263,,,0,0,0,,,,,,
842,240,285,842,239,284,,,0,1,1,,,,,,
842,240,307,842,240,306,,,0,0,1,,,,,,
842,241,329,842,241,329,,,0,0,0,,,,,,
842,241,352,842,241,352,,,0,0,0,,,,,,
843,242,376,842,242,376,,,1,0,0,,,,,,
843,243,399,843,243,399,,,0,0,0,,,,,,
843,244,423,843,243,423,,,0,1,0,,,,,,
843,245,447,843,244,447,,,0,1,0,,,,,,
844,246,471,843,245,471,,,1,1,0,,,,,,
844,247,495,844,247,495,,,0,0,0,,,,,,
844,248,520,844,248,520,,,0,0,0,,,,,,
844,249,544,844,249,544,,,0,0,0,,,,,,
845,250,569,844,250,569,,,1,0,0,,,,,,
845,252,594,845,252,594,,,0,0,0,,,,,,
845,253,619,845,253,618,,,0,0,1,,,,,,
846,254,643,846,254,643,,,0,0,0,,,,,,
846,256,668,846,255,668,,,0,1,0,,,,,,
846,257,694,846,257,693,,,0,0,1,,,,,,
847,259,719,846,258,718,,,1,1,1,,,,,,
847,261,744,847,260,743,,,0,1,1,,,,,,
848,262,769,847,262,769,,,1,0,0,,,,,,
842,243,129,842,244,129,,,0,-1,0,,,,,,
842,243,130,842,244,129,,,0,-1,1,,,,,,
842,243,135,842,244,135,,,0,-1,0,,,,,,
842,243,143,842,244,144,,,0,-1,-1,,,,,,
842,243,154,842,244,154,,,0,-1,0,,,,,,
842,243,168,842,244,169,,,0,-1,-1,,,,,,
842,244,185,842,244,184,,,0,0,1,,,,,,
842,244,203,842,245,203,,,0,-1,0,,,,,,
842,244,222,842,245,222,,,0,-1,0,,,,,,
842,245,242,842,246,242,,,0,-1,0,,,,,,
842,245,263,842,246,263,,,0,-1,0,,,,,,
842,246,285,842,247,285,,,0,-1,0,,,,,,
843,246,307,842,247,307,,,1,-1,0,,,,,,
843,247,330,842,248,329,,,1,-1,1,,,,,,
843,247,353,843,248,352,,,0,-1,1,,,,,,
843,248,376,843,249,376,,,0,-1,0,,,,,,
843,249,400,843,250,399,,,0,-1,1,,,,,,
843,250,423,843,250,423,,,0,0,0,,,,,,
844,251,447,843,251,447,,,1,0,0,,,,,,
844,252,471,844,252,471,,,0,0,0,,,,,,
844,253,496,844,254,495,,,0,-1,1,,,,,,
844,254,520,844,255,520,,,0,-1,0,,,,,,
845,255,545,844,256,544,,,1,-1,1,,,,,,
845,256,569,845,257,569,,,0,-1,0,,,,,,
845,257,594,845,258,594,,,0,-1,0,,,,,,
846,259,619,846,259,618,,,0,0,1,,,,,,
846,260,644,846,261,643,,,0,-1,1,,,,,,
846,261,669,846,262,668,,,0,-1,1,,,,,,
847,263,694,846,264,693,,,1,-1,1,,,,,,
847,264,719,847,265,718,,,0,-1,1,,,,,,
848,266,744,847,267,743,,,1,-1,1,,,,,,
848,268,769,848,268,769,,,0,0,0,,,,,,
842,252,130,842,251,130,,,0,1,0,,,,,,
842,252,131,842,251,130,,,0,1,1,,,,,,
842,252,136,842,252,136,,,0,0,0,,,,,,
843,252,144,842,252,145,,,1,0,-1,,,,,,
843,252,155,842,252,155,,,1,0,0,,,,,,
843,252,169,842,252,170,,,1,0,-1,,,,,,
843,252,185,842,252,185,,,1,0,0,,,,,,
843,253,203,842,252,204,,,1,1,-1,,,,,,
843,253,222,843,253,222,,,0,0,0,,,,,,
843,253,243,843,253,243,,,0,0,0,,,,,,
843,254,264,843,254,264,,,0,0,0,,,,,,
843,254,285,843,254,285,,,0,0,0,,,,,,
843,255,307,843,255,307,,,0,0,0,,,,,,
843,255,330,843,255,330,,,0,0,0,,,,,,
844,256,353,843,256,353,,,1,0,0,,,,,,
844,257,376,843,256,376,,,1,1,0,,,,,,
844,257,400,844,257,400,,,0,0,0,,,,,,
844,258,424,844,258,424,,,0,0,0,,,,,,
844,259,448,844,259,448,,,0,0,0,,,,,,
845,260,472,844,260,472,,,1,0,0,,,,,,
845,261,496,845,261,496,,,0,0,0,,,,,,
845,262,520,845,262,520,,,0,0,0,,,,,,
845,263,545,845,263,545,,,0,0,0,,,,,,
846,264,569,845,264,569,,,1,0,0,,,,,,
846,266,594,846,265,594,,,0,1,0,,,,,,
846,267,619,846,266,619,,,0,1,0,,,,,,
847,268,644,847,268,644,,,0,0,0,,,,,,
847,269,669,847,269,668,,,0,0,1,,,,,,
847,271,694,847,271,693,,,0,0,1,,,,,,
848,272,719,847,272,718,,,1,0,1,,,,,,
848,274,744,848,273,744,,,0,1,0,,,,,,
849,276,769,848,275,769,,,1,1,0,,,,,,
843,263,131,843,264,131,,,0,-1,0,,,,,,
843,263,132,843,264,131,,,0,-1,1,,,,,,
843,263,137,843,264,137,,,0,-1,0,,,,,,
843,263,145,843,264,147,,,0,-1,-2,,,,,,
843,263,156,843,264,156,,,0,-1,0,,,,,,
843,263,170,843,264,171,,,0,-1,-1,,,,,,
844,264,186,843,264,186,,,1,0,0,,,,,,
844,264,204,843,265,205,,,1,-1,-1,,,,,,
844,264,223,844,265,223,,,0,-1,0,,,,,,
844,265,243,844,265,244,,,0,0,-1,,,,,,
844,265,264,844,266,264,,,0,-1,0,,,,,,
844,265,286,844,266,286,,,0,-1,0,,,,,,
844,266,308,844,267,308,,,0,-1,0,,,,,,
844,266,331,844,267,330,,,0,-1,1,,,,,,
844,267,354,844,268,353,,,0,-1,1,,,,,,
845,268,377,844,268,377,,,1,0,0,,,,,,
845,268,400,845,269,400,,,0,-1,0,,,,,,
845,269,424,845,270,424,,,0,-1,0,,,,,,
845,270,448,845,271,448,,,0,-1,0,,,,,,
845,271,472,845,272,472,,,0,-1,0,,,,,,
846,272,496,846,273,496,,,0,-1,0,,,,,,
846,273,521,846,274,520,,,0,-1,1,,,,,,
846,274,545,846,275,545,,,0,-1,0,,,,,,
847,275,570,846,276,569,,,1,-1,1,,,,,,
847,276,594,847,277,594,,,0,-1,0,,,,,,
847,277,619,847,278,619,,,0,-1,0,,,,,,
848,279,644,848,280,644,,,0,-1,0,,,,,,
848,280,669,848,281,669,,,0,-1,0,,,,,,
848,281,694,848,282,694,,,0,-1,0,,,,,,
849,283,719,848,283,719,,,1,0,0,,,,,,
849,284,744,849,285,744,,,0,-1,0,,,,,,
850,286,769,849,287,769,,,1,-1,0,,,,,,
844,277,133,844,276,133,,,0,1,0,,,,,,
844,277,134,844,276,133,,,0,1,1,,,,,,
844,277,139,844,276,139,,,0,1,0,,,,,,
845,277,147,844,276,148,,,1,1,-1,,,,,,
845,277,158,844,277,158,,,1,0,0,,,,,,
845,277,172,844,277,172,,,1,0,0,,,,,,
845,277,188,845,277,187,,,0,0,1,,,,,,
845,278,205,845,277,206,,,0,1,-1,,,,,,
845,278,224,845,277,224,,,0,1,0,,,,,,
845,278,244,845,278,244,,,0,0,0,,,,,,
845,279,265,845,278,265,,,0,1,0,,,,,,
845,279,287,845,279,286,,,0,0,1,,,,,,
845,279,309,845,279,308,,,0,0,1,,,,,,
845,280,331,845,280,331,,,0,0,0,,,,,,
846,281,354,845,280,354,,,1,1,0,,,,,,
846,281,377,845,281,377,,,1,0,0,,,,,,
846,282,401,846,282,401,,,0,0,0,,,,,,
846,283,425,846,282,424,,,0,1,1,,,,,,
846,283,448,846,283,448,,,0,0,0,,,,,,
847,284,472,846,284,472,,,1,0,0,,,,,,
847,285,497,847,285,497,,,0,0,0,,,,,,
847,286,521,847,286,521,,,0,0,0,,,,,,
847,287,545,847,287,545,,,0,0,0,,,,,,
848,288,570,847,288,570,,,1,0,0,,,,,,
848,289,595,848,289,595,,,0,0,0,,,,,,
848,290,620,848,290,619,,,0,0,1,,,,,,
849,292,644,849,292,644,,,0,0,0,,,,,,
849,293,669,849,293,669,,,0,0,0,,,,,,
849,294,694,849,294,694,,,0,0,0,,,,,,
850,296,719,849,295,719,,,1,1,0,,,,,,
850,297,745,850,297,744,,,0,0,1,,,,,,
851,298,770,850,298,769,,,1,0,1,,,,,,
846,292,135,846,293,135,,,0,-1,0,,,,,,
846,292,137,846,293,135,,,0,-1,2,,,,,,
846,293,141,846,293,141,,,0,0,0,,,,,,
846,293,149,846,293,150,,,0,0,-1,,,,,,
846,293,160,846,293,160,,,0,0,0,,,,,,
846,293,173,846,293,174,,,0,0,-1,,,,,,
846,293,189,846,294,189,,,0,-1,0,,,,,,
846,293,207,846,294,207,,,0,-1,0,,,,,,
846,294,225,846,294,225,,,0,0,0,,,,,,
846,294,245,846,294,246,,,0,0,-1,,,,,,
846,294,266,846,295,266,,,0,-1,0,,,,,,
846,295,288,846,295,287,,,0,0,1,,,,,,
847,295,310,846,296,309,,,1,-1,1,,,,,,
847,296,332,846,296,332,,,1,0,0,,,,,,
847,296,355,847,297,355,,,0,-1,0,,,,,,
847,297,378,847,297,378,,,0,0,0,,,,,,
847,297,401,847,298,401,,,0,-1,0,,,,,,
847,298,425,847,299,425,,,0,-1,0,,,,,,
848,299,449,847,300,449,,,1,-1,0,,,,,,
848,300,473,848,300,473,,,0,0,0,,,,,,
848,300,497,848,301,497,,,0,-1,0,,,,,,
848,301,522,848,302,521,,,0,-1,1,,,,,,
849,302,546,848,303,546,,,1,-1,0,,,,,,
849,303,571,849,304,570,,,0,-1,1,,,,,,
849,304,595,849,305,595,,,0,-1,0,,,,,,
850,305,620,850,306,620,,,0,-1,0,,,,,,
850,307,645,850,307,645,,,0,0,0,,,,,,
850,308,670,850,308,669,,,0,0,1,,,,,,
851,309,695,850,309,694,,,1,0,1,,,,,,
851,310,720,851,311,719,,,0,-1,1,,,,,,
852,312,745,851,312,745,,,1,0,0,,,,,,
852,313,770,852,314,770,,,0,-1,0,,,,,,
847,310,138,847,310,138,,,0,0,0,,,,,,
847,310,139,847,310,138,,,0,0,1,,,,,,
847,310,143,847,310,143,,,0,0,0,,,,,,
847,310,151,847,310,152,,,0,0,-1,,,,,,
848,310,162,848,310,162,,,0,0,0,,,,,,
848,310,175,848,310,176,,,0,0,-1,,,,,,
848,311,191,848,310,191,,,0,1,0,,,,,,
848,311,208,848,310,209,,,0,1,-1,,,,,,
848,311,227,848,311,227,,,0,0,0,,,,,,
848,311,247,848,311,247,,,0,0,0,,,,,,
848,312,267,848,311,267,,,0,1,0,,,,,,
848,312,289,848,312,289,,,0,0,0,,,,,,
848,313,311,848,312,310,,,0,1,1,,,,,,
848,313,333,848,313,333,,,0,0,0,,,,,,
849,314,356,849,313,355,,,0,1,1,,,,,,
849,314,379,849,314,378,,,0,0,1,,,,,,
849,315,402,849,314,402,,,0,1,0,,,,,,
849,315,426,849,315,426,,,0,0,0,,,,,,
849,316,450,849,316,450,,,0,0,0,,,,,,
850,317,474,849,317,474,,,1,0,0,,,,,,
850,318,498,850,317,498,,,0,1,0,,,,,,
850,318,522,850,318,522,,,0,0,0,,,,,,
850,319,547,850,319,546,,,0,0,1,,,,,,
851,320,571,850,320,571,,,1,0,0,,,,,,
851,321,596,851,321,595,,,0,0,1,,,,,,
851,322,620,851,322,620,,,0,0,0,,,,,,
852,323,645,852,323,645,,,0,0,0,,,,,,
852,324,670,852,324,670,,,0,0,0,,,,,,
852,326,695,852,325,695,,,0,1,0,,,,,,
853,327,720,852,326,720,,,1,1,0,,,,,,
853,328,745,853,328,745,,,0,0,0,,,,,,
854,329,770,853,329,770,,,1,0,0,,,,,,
849,329,141,849,330,141,,,0,-1,0,,,,,,
849,329,142,849,330,141,,,0,-1,1,,,,,,
849,329,146,849,330,146,,,0,-1,0,,,,,,
849,329,154,849,330,155,,,0,-1,-1,,,,,,
849,329,164,849,330,164,,,0,-1,0,,,,,,
849,330,178,849,330,178,,,0,0,0,,,,,,
849,330,193,850,330,193,,,-1,0,0,,,,,,
850,330,210,850,330,211,,,0,0,-1,,,,,,
850,330,229,850,331,228,,,0,-1,1,,,,,,
850,330,248,850,331,248,,,0,-1,0,,,,,,
850,331,269,850,331,269,,,0,0,0,,,,,,
850,331,290,850,331,290,,,0,0,0,,,,,,
850,332,312,850,332,312,,,0,0,0,,,,,,
850,332,334,850,332,334,,,0,0,0,,,,,,
850,332,357,850,333,356,,,0,-1,1,,,,,,
851,333,380,850,333,379,,,1,0,1,,,,,,
851,334,403,851,334,403,,,0,0,0,,,,,,
851,334,427,851,335,426,,,0,-1,1,,,,,,
851,335,450,851,335,450,,,0,0,0,,,,,,
851,336,474,851,336,474,,,0,0,0,,,,,,
852,336,499,852,337,498,,,0,-1,1,,,,,,
852,337,523,852,337,522,,,0,0,1,,,,,,
852,338,547,852,338,547,,,0,0,0,,,,,,
853,339,572,852,339,571,,,1,0,1,,,,,,
853,340,596,853,340,596,,,0,0,0,,,,,,
853,341,621,853,341,621,,,0,0,0,,,,,,
854,342,646,853,342,646,,,1,0,0,,,,,,
854,343,671,854,343,670,,,0,0,1,,,,,,
854,344,696,854,344,695,,,0,0,1,,,,,,
855,345,721,854,345,720,,,1,0,1,,,,,,
855,346,746,855,346,746,,,0,0,0,,,,,,
855,347,771,855,348,771,,,0,-1,0,,,,,,
851,350,144,851,350,144,,,0,0,0,,,,,,
851,350,145,851,350,144,,,0,0,1,,,,,,
851,350,149,851,350,149,,,0,0,0,,,,,,
852,350,157,851,350,158,,,1,0,-1,,,,,,
852,350,167,851,350,167,,,1,0,0,,,,,,
852,350,180,851,350,181,,,1,0,-1,,,,,,
852,350,195,852,350,195,,,0,0,0,,,,,,
852,350,212,852,350,213,,,0,0,-1,,,,,,
852,351,231,852,351,230,,,0,0,1,,,,,,
852,351,250,852,351,250,,,0,0,0,,,,,,
852,351,270,852,351,270,,,0,0,0,,,,,,
852,352,292,852,351,292,,,0,1,0,,,,,,
852,352,313,852,352,313,,,0,0,0,,,,,,
852,352,335,852,352,335,,,0,0,0,,,,,,
853,353,358,852,353,358,,,1,0,0,,,,,,
853,353,381,852,353,381,,,1,0,0,,,,,,
853,354,404,853,354,404,,,0,0,0,,,,,,
853,354,428,853,354,427,,,0,0,1,,,,,,
853,355,451,853,355,451,,,0,0,0,,,,,,
854,356,475,853,355,475,,,1,1,0,,,,,,
854,356,499,854,356,499,,,0,0,0,,,,,,
854,357,524,854,357,523,,,0,0,1,,,,,,
854,358,548,854,358,548,,,0,0,0,,,,,,
855,359,572,854,358,572,,,1,1,0,,,,,,
855,360,597,855,359,597,,,0,1,0,,,,,,
855,360,622,855,360,621,,,0,0,1,,,,,,
856,361,646,855,361,646,,,1,0,0,,,,,,
856,362,671,856,362,671,,,0,0,0,,,,,,
856,363,696,856,363,696,,,0,0,0,,,,,,
857,364,721,857,364,721,,,0,0,0,,,,,,
857,366,746,857,365,746,,,0,1,0,,,,,,
858,367,771,857,366,771,,,1,1,0,,,,,,
854,371,148,854,372,148,,,0,-1,0,,,,,,
854,371,149,854,372,148,,,0,-1,1,,,,,,
854,371,153,854,372,153,,,0,-1,0,,,,,,
854,371,160,854,372,161,,,0,-1,-1,,,,,,
854,372,170,854,372,170,,,0,0,0,,,,,,
854,372,183,854,372,184,,,0,0,-1,,,,,,
854,372,198,854,372,198,,,0,0,0,,,,,,
854,372,215,854,372,215,,,0,0,0,,,,,,
854,372,233,854,372,232,,,0,0,1,,,,,,
854,372,252,854,373,252,,,0,-1,0,,,,,,
854,373,272,854,373,272,,,0,0,0,,,,,,
855,373,293,854,373,293,,,1,0,0,,,,,,
855,373,315,854,374,315,,,1,-1,0,,,,,,
855,374,337,854,374,337,,,1,0,0,,,,,,
855,374,359,855,374,359,,,0,0,0,,,,,,
855,375,382,855,375,382,,,0,0,0,,,,,,
855,375,405,855,375,405,,,0,0,0,,,,,,
856,376,429,855,376,429,,,1,0,0,,,,,,
856,376,452,856,376,452,,,0,0,0,,,,,,
856,377,476,856,377,476,,,0,0,0,,,,,,
856,378,500,856,378,500,,,0,0,0,,,,,,
856,378,524,856,378,524,,,0,0,0,,,,,,
857,379,549,857,379,549,,,0,0,0,,,,,,
857,380,573,857,380,573,,,0,0,0,,,,,,
857,381,598,857,381,597,,,0,0,1,,,,,,
858,381,622,857,381,622,,,1,0,0,,,,,,
858,382,647,858,382,647,,,0,0,0,,,,,,
858,383,672,858,383,672,,,0,0,0,,,,,,
859,384,697,859,384,697,,,0,0,0,,,,,,
859,385,722,859,385,722,,,0,0,0,,,,,,
860,386,747,860,386,747,,,0,0,0,,,,,,
860,387,772,860,387,772,,,0,0,0,,,,,,
857,394,152,856,394,151,,,1,0,1,,,,,,
857,394,153,856,394,151,,,1,0,2,,,,,,
857,394,157,856,394,156,,,1,0,1,,,,,,
857,394,164,856,394,165,,,1,0,-1,,,,,,
857,394,174,856,394,174,,,1,0,0,,,,,,
857,394,186,856,394,187,,,1,0,-1,,,,,,
857,394,201,856,394,200,,,1,0,1,,,,,,
857,395,217,856,394,217,,,1,1,0,,,,,,
857,395,235,857,394,235,,,0,1,0,,,,,,
857,395,254,857,395,254,,,0,0,0,,,,,,
857,395,274,857,395,274,,,0,0,0,,,,,,
857,396,295,857,395,295,,,0,1,0,,,,,,
857,396,317,857,396,316,,,0,0,1,,,,,,
857,396,339,857,396,338,,,0,0,1,,,,,,
858,397,361,857,396,361,,,1,1,0,,,,,,
858,397,384,857,397,384,,,1,0,0,,,,,,
858,398,407,858,397,407,,,0,1,0,,,,,,
858,398,430,858,398,430,,,0,0,0,,,,,,
858,399,454,858,398,454,,,0,1,0,,,,,,
859,399,477,858,399,477,,,1,0,0,,,,,,
859,400,501,859,400,501,,,0,0,0,,,,,,
859,400,525,859,400,525,,,0,0,0,,,,,,
859,401,550,859,401,550,,,0,0,0,,,,,,
860,402,574,859,401,574,,,1,1,0,,,,,,
860,403,599,860,402,598,,,0,1,1,,,,,,
860,403,623,860,403,623,,,0,0,0,,,,,,
861,404,648,860,404,648,,,1,0,0,,,,,,
861,405,673,861,405,672,,,0,0,1,,,,,,
861,406,698,861,406,697,,,0,0,1,,,,,,
862,407,722,862,407,722,,,0,0,0,,,,,,
862,408,747,862,408,747,,,0,0,0,,,,,,
863,409,773,863,409,772,,,0,0,1,,,,,,
859,417,156,859,417,156,,,0,0,0,,,,,,
860,417,157,859,417,156,,,1,0,1,,,,,,
860,417,161,859,417,160,,,1,0,1,,,,,,
860,417,168,859,417,169,,,1,0,-1,,,,,,
860,418,177,859,418,177,,,1,0,0,,,,,,
860,418,190,859,418,190,,,1,0,0,,,,,,
860,418,204,859,418,204,,,1,0,0,,,,,,
860,418,220,859,418,221,,,1,0,-1,,,,,,
860,418,238,860,418,238,,,0,0,0,,,,,,
860,418,257,860,418,257,,,0,0,0,,,,,,
860,419,277,860,419,276,,,0,0,1,,,,,,
860,419,297,860,419,297,,,0,0,0,,,,,,
860,419,318,860,419,318,,,0,0,0,,,,,,
860,419,340,860,419,340,,,0,0,0,,,,,,
861,420,363,860,420,362,,,1,0,1,,,,,,
861,420,385,860,420,385,,,1,0,0,,,,,,
861,421,408,861,421,408,,,0,0,0,,,,,,
861,421,431,861,421,431,,,0,0,0,,,,,,
861,422,455,861,422,455,,,0,0,0,,,,,,
862,422,479,861,422,478,,,1,0,1,,,,,,
862,423,502,862,423,502,,,0,0,0,,,,,,
862,423,526,862,423,526,,,0,0,0,,,,,,
862,424,551,862,424,551,,,0,0,0,,,,,,
863,425,575,862,425,575,,,1,0,0,,,,,,
863,425,599,863,425,599,,,0,0,0,,,,,,
863,426,624,863,426,624,,,0,0,0,,,,,,
864,427,649,863,427,648,,,1,0,1,,,,,,
864,428,673,864,428,673,,,0,0,0,,,,,,
864,429,698,864,429,698,,,0,0,0,,,,,,
865,430,723,865,430,723,,,0,0,0,,,,,,
865,430,748,865,431,748,,,0,-1,0,,,,,,
866,431,773,865,431,773,,,1,0,0,,,,,,
863,441,161,862,441,160,,,1,0,1,,,,,,
863,441,162,862,441,160,,,1,0,2,,,,,,
863,441,165,862,441,165,,,1,0,0,,,,,,
863,442,172,862,441,173,,,1,1,-1,,,,,,
863,442,181,862,441,181,,,1,1,0,,,,,,
863,442,193,862,441,194,,,1,1,-1,,,,,,
863,442,207,862,442,207,,,1,0,0,,,,,,
863,442,223,863,442,224,,,0,0,-1,,,,,,
863,442,241,863,442,241,,,0,0,0,,,,,,
863,442,259,863,442,260,,,0,0,-1,,,,,,
863,443,279,863,442,279,,,0,1,0,,,,,,
863,443,299,863,442,299,,,0,1,0,,,,,,
863,443,320,863,443,320,,,0,0,0,,,,,,
864,443,342,863,443,342,,,1,0,0,,,,,,
864,444,364,863,444,364,,,1,0,0,,,,,,
864,444,387,864,444,387,,,0,0,0,,,,,,
864,445,410,864,444,410,,,0,1,0,,,,,,
864,445,433,864,445,433,,,0,0,0,,,,,,
865,445,456,864,445,456,,,1,0,0,,,,,,
865,446,480,864,446,480,,,1,0,0,,,,,,
865,447,504,865,446,504,,,0,1,0,,,,,,
865,447,528,865,447,528,,,0,0,0,,,,,,
866,448,552,865,448,552,,,1,0,0,,,,,,
866,448,576,866,448,576,,,0,0,0,,,,,,
866,449,600,866,449,600,,,0,0,0,,,,,,
866,450,625,866,449,625,,,0,1,0,,,,,,
867,450,650,867,450,649,,,0,0,1,,,,,,
867,451,674,867,451,674,,,0,0,0,,,,,,
868,452,699,867,452,699,,,1,0,0,,,,,,
868,453,724,868,453,724,,,0,0,0,,,,,,
868,454,749,868,454,749,,,0,0,0,,,,,,
869,455,774,868,454,774,,,1,1,0,,,,,,
866,466,165,866,466,165,,,0,0,0,,,,,,
866,466,166,866,466,165,,,0,0,1,,,,,,
866,466,170,866,466,170,,,0,0,0,,,,,,
866,466,176,866,466,177,,,0,0,-1,,,,,,
866,466,185,866,466,185,,,0,0,0,,,,,,
866,466,197,866,466,198,,,0,0,-1,,,,,,
866,466,211,866,466,211,,,0,0,0,,,,,,
866,467,227,866,466,227,,,0,1,0,,,,,,
867,467,244,867,467,244,,,0,0,0,,,,,,
867,467,262,867,467,262,,,0,0,0,,,,,,
867,467,282,867,467,281,,,0,0,1,,,,,,
867,467,302,867,467,302,,,0,0,0,,,,,,
867,468,323,867,467,323,,,0,1,0,,,,,,
867,468,344,867,468,344,,,0,0,0,,,,,,
867,468,366,867,468,366,,,0,0,0,,,,,,
867,469,389,867,469,389,,,0,0,0,,,,,,
868,469,411,868,469,411,,,0,0,0,,,,,,
868,469,434,868,469,434,,,0,0,0,,,,,,
868,470,458,868,470,457,,,0,0,1,,,,,,
868,470,481,868,470,481,,,0,0,0,,,,,,
869,471,505,868,471,505,,,1,0,0,,,,,,
869,471,529,868,471,529,,,1,0,0,,,,,,
869,472,553,869,472,553,,,0,0,0,,,,,,
869,473,577,869,473,577,,,0,0,0,,,,,,
870,473,602,870,473,601,,,0,0,1,,,,,,
870,474,626,870,474,626,,,0,0,0,,,,,,
870,475,651,870,475,650,,,0,0,1,,,,,,
871,475,675,870,475,675,,,1,0,0,,,,,,
871,476,700,871,476,700,,,0,0,0,,,,,,
871,477,725,871,477,725,,,0,0,0,,,,,,
872,478,750,872,478,749,,,0,0,1,,,,,,
872,479,775,872,479,774,,,0,0,1,,,,,,
870,491,170,870,491,170,,,0,0,0,,,,,,
870,491,171,870,491,170,,,0,0,1,,,,,,
870,491,175,870,491,175,,,0,0,0,,,,,,
870,491,181,870,491,182,,,0,0,-1,,,,,,
870,491,190,870,491,190,,,0,0,0,,,,,,
870,492,201,870,491,202,,,0,1,-1,,,,,,
870,492,215,870,491,214,,,0,1,1,,,,,,
870,492,230,870,491,230,,,0,1,0,,,,,,
870,492,247,870,492,247,,,0,0,0,,,,,,
870,492,265,870,492,265,,,0,0,0,,,,,,
870,492,284,870,492,284,,,0,0,0,,,,,,
871,493,304,870,492,305,,,1,1,-1,,,,,,
871,493,325,871,492,325,,,0,1,0,,,,,,
871,493,346,871,493,347,,,0,0,-1,,,,,,
871,493,368,871,493,368,,,0,0,0,,,,,,
871,494,391,871,494,390,,,0,0,1,,,,,,
871,494,413,871,494,413,,,0,0,0,,,,,,
872,494,436,871,494,436,,,1,0,0,,,,,,
872,495,459,872,495,459,,,0,0,0,,,,,,
872,495,483,872,495,482,,,0,0,1,,,,,,
872,496,506,872,496,506,,,0,0,0,,,,,,
873,496,530,872,496,530,,,1,0,0,,,,,,
873,497,554,873,497,554,,,0,0,0,,,,,,
873,497,578,873,497,578,,,0,0,0,,,,,,
873,498,603,873,498,603,,,0,0,0,,,,,,
874,499,627,873,498,627,,,1,1,0,,,,,,
874,499,652,874,499,651,,,0,0,1,,,,,,
874,500,676,874,500,676,,,0,0,0,,,,,,
875,501,701,875,500,701,,,0,1,0,,,,,,
875,502,726,875,501,725,,,0,1,1,,,,,,
876,502,751,876,502,750,,,0,0,1,,,,,,
876,503,776,876,503,775,,,0,0,1,,,,,,
874,517,175,874,517,175,,,0,0,0,,,,,,
874,517,176,874,517,175,,,0,0,1,,,,,,
874,517,180,874,517,180,,,0,0,0,,,,,,
874,517,186,874,517,187,,,0,0,-1,,,,,,
874,517,194,874,517,194,,,0,0,0,,,,,,
874,517,205,874,517,206,,,0,0,-1,,,,,,
874,517,219,874,517,218,,,0,0,1,,,,,,
874,517,234,874,517,234,,,0,0,0,,,,,,
874,518,250,874,518,250,,,0,0,0,,,,,,
874,518,268,874,518,269,,,0,0,-1,,,,,,
875,518,287,874,518,287,,,1,0,0,,,,,,
875,518,307,874,518,307,,,1,0,0,,,,,,
875,518,328,875,518,328,,,0,0,0,,,,,,
875,519,349,875,518,349,,,0,1,0,,,,,,
875,519,371,875,519,370,,,0,0,1,,,,,,
875,519,393,875,519,392,,,0,0,1,,,,,,
875,520,415,875,520,415,,,0,0,0,,,,,,
876,520,438,875,520,438,,,1,0,0,,,,,,
876,520,461,876,520,461,,,0,0,0,,,,,,
876,521,484,876,521,484,,,0,0,0,,,,,,
876,521,508,876,521,508,,,0,0,0,,,,,,
877,522,532,876,522,532,,,1,0,0,,,,,,
877,522,556,877,522,555,,,0,0,1,,,,,,
877,523,580,877,523,580,,,0,0,0,,,,,,
877,523,604,877,523,604,,,0,0,0,,,,,,
878,524,628,878,524,628,,,0,0,0,,,,,,
878,525,653,878,524,652,,,0,1,1,,,,,,
878,525,677,878,525,677,,,0,0,0,,,,,,
879,526,702,879,526,702,,,0,0,0,,,,,,
879,527,727,879,526,726,,,0,1,1,,,,,,
880,527,752,880,527,751,,,0,0,1,,,,,,
880,528,777,880,528,776,,,0,0,1,,,,,,
878,543,181,878,543,181,,,0,0,0,,,,,,
878,543,182,878,543,181,,,0,0,1,,,,,,
878,543,185,878,543,185,,,0,0,0,,,,,,
878,543,191,878,543,192,,,0,0,-1,,,,,,
878,543,199,878,543,199,,,0,0,0,,,,,,
878,543,210,878,543,211,,,0,0,-1,,,,,,
878,543,223,878,543,223,,,0,0,0,,,,,,
879,543,238,878,543,238,,,1,0,0,,,,,,
879,544,254,879,544,254,,,0,0,0,,,,,,
879,544,272,879,544,272,,,0,0,0,,,,,,
879,544,290,879,544,290,,,0,0,0,,,,,,
879,544,310,879,544,310,,,0,0,0,,,,,,
879,544,330,879,544,330,,,0,0,0,,,,,,
879,545,351,879,544,351,,,0,1,0,,,,,,
879,545,373,879,545,373,,,0,0,0,,,,,,
880,545,395,879,545,395,,,1,0,0,,,,,,
880,545,417,880,545,417,,,0,0,0,,,,,,
880,546,440,880,545,440,,,0,1,0,,,,,,
880,546,463,880,546,463,,,0,0,0,,,,,,
880,547,486,880,546,486,,,0,1,0,,,,,,
881,547,510,880,547,510,,,1,0,0,,,,,,
881,547,533,880,547,533,,,1,0,0,,,,,,
881,548,557,881,548,557,,,0,0,0,,,,,,
881,548,581,881,548,581,,,0,0,0,,,,,,
882,549,605,882,549,605,,,0,0,0,,,,,,
882,550,630,882,549,629,,,0,1,1,,,,,,
882,550,654,882,550,654,,,0,0,0,,,,,,
883,551,679,882,550,678,,,1,1,1,,,,,,
883,551,703,883,551,703,,,0,0,0,,,,,,
883,552,728,883,552,728,,,0,0,0,,,,,,
884,553,753,884,553,752,,,0,0,1,,,,,,
884,554,778,884,553,777,,,0,1,1,,,,,,
883,569,186,882,569,186,,,1,0,0,,,,,,
883,569,187,882,569,186,,,1,0,1,,,,,,
883,569,190,882,569,190,,,1,0,0,,,,,,
883,569,196,883,569,197,,,0,0,-1,,,,,,
883,569,204,883,569,204,,,0,0,0,,,,,,
883,570,215,883,569,216,,,0,1,-1,,,,,,
883,570,227,883,569,227,,,0,1,0,,,,,,
883,570,242,883,570,242,,,0,0,0,,,,,,
883,570,258,883,570,258,,,0,0,0,,,,,,
883,570,275,883,570,276,,,0,0,-1,,,,,,
883,570,294,883,570,294,,,0,0,0,,,,,,
884,570,313,883,570,313,,,1,0,0,,,,,,
884,571,333,883,570,333,,,1,1,0,,,,,,
884,571,354,883,571,354,,,1,0,0,,,,,,
884,571,375,884,571,375,,,0,0,0,,,,,,
884,571,397,884,571,397,,,0,0,0,,,,,,
884,572,419,884,572,419,,,0,0,0,,,,,,
884,572,442,884,572,442,,,0,0,0,,,,,,
885,572,465,884,572,465,,,1,0,0,,,,,,
885,573,488,885,572,488,,,0,1,0,,,,,,
885,573,511,885,573,511,,,0,0,0,,,,,,
885,574,535,885,573,535,,,0,1,0,,,,,,
886,574,559,885,574,558,,,1,0,1,,,,,,
886,575,583,886,574,582,,,0,1,1,,,,,,
886,575,607,886,575,607,,,0,0,0,,,,,,
887,576,631,886,575,631,,,1,1,0,,,,,,
887,576,656,887,576,655,,,0,0,1,,,,,,
887,577,680,887,576,680,,,0,1,0,,,,,,
888,577,705,887,577,704,,,1,0,1,,,,,,
888,578,729,888,578,729,,,0,0,0,,,,,,
888,579,754,888,579,754,,,0,0,0,,,,,,
889,579,779,889,579,778,,,0,0,1,,,,,,
888,596,192,887,596,192,,,1,0,0,,,,,,
888,596,193,887,596,192,,,1,0,1,,,,,,
888,596,196,887,596,196,,,1,0,0,,,,,,
888,596,201,887,596,202,,,1,0,-1,,,,,,
888,596,209,888,596,209,,,0,0,0,,,,,,
888,596,220,888,596,220,,,0,0,0,,,,,,
888,596,232,888,596,232,,,0,0,0,,,,,,
888,596,246,888,596,247,,,0,0,-1,,,,,,
888,596,262,888,596,262,,,0,0,0,,,,,,
888,597,279,888,596,279,,,0,1,0,,,,,,
888,597,297,888,597,297,,,0,0,0,,,,,,
888,597,316,888,597,317,,,0,0,-1,,,,,,
888,597,336,888,597,336,,,0,0,0,,,,,,
889,597,357,888,597,357,,,1,0,0,,,,,,
889,598,378,888,597,378,,,1,1,0,,,,,,
889,598,400,889,598,400,,,0,0,0,,,,,,
889,598,422,889,598,422,,,0,0,0,,,,,,
889,599,444,889,598,444,,,0,1,0,,,,,,
890,599,467,889,599,467,,,1,0,0,,,,,,
890,599,490,890,599,490,,,0,0,0,,,,,,
890,600,513,890,599,513,,,0,1,0,,,,,,
890,600,537,890,600,536,,,0,0,1,,,,,,
891,601,561,890,600,560,,,1,1,1,,,,,,
891,601,584,891,601,584,,,0,0,0,,,,,,
891,601,608,891,601,608,,,0,0,0,,,,,,
891,602,633,891,602,632,,,0,0,1,,,,,,
892,603,657,891,602,657,,,1,1,0,,,,,,
892,603,681,892,603,681,,,0,0,0,,,,,,
892,604,706,892,603,706,,,0,1,0,,,,,,
893,604,731,893,604,730,,,0,0,1,,,,,,
893,605,755,893,605,755,,,0,0,0,,,,,,
894,606,780,894,605,780,,,0,1,0,,,,,,
893,623,198,893,623,198,,,0,0,0,,,,,,
893,623,199,893,623,198,,,0,0,1,,,,,,
893,623,202,893,623,201,,,0,0,1,,,,,,
893,623,207,893,623,208,,,0,0,-1,,,,,,
893,623,215,893,623,215,,,0,0,0,,,,,,
893,623,225,893,623,226,,,0,0,-1,,,,,,
893,623,237,893,623,237,,,0,0,0,,,,,,
893,623,251,893,623,251,,,0,0,0,,,,,,
893,623,266,893,623,266,,,0,0,0,,,,,,
893,624,283,893,623,283,,,0,1,0,,,,,,
893,624,301,893,623,301,,,0,1,0,,,,,,
893,624,320,893,624,320,,,0,0,0,,,,,,
894,624,339,893,624,339,,,1,0,0,,,,,,
894,624,360,893,624,360,,,1,0,0,,,,,,
894,625,381,894,624,381,,,0,1,0,,,,,,
894,625,402,894,625,402,,,0,0,0,,,,,,
894,625,424,894,625,424,,,0,0,0,,,,,,
894,625,447,894,625,447,,,0,0,0,,,,,,
895,626,469,894,625,469,,,1,1,0,,,,,,
895,626,492,895,626,492,,,0,0,0,,,,,,
895,626,515,895,626,515,,,0,0,0,,,,,,
895,627,539,895,627,538,,,0,0,1,,,,,,
896,627,562,895,627,562,,,1,0,0,,,,,,
896,628,586,896,628,586,,,0,0,0,,,,,,
896,628,610,896,628,610,,,0,0,0,,,,,,
897,629,634,896,629,634,,,1,0,0,,,,,,
897,629,658,896,629,658,,,1,0,0,,,,,,
897,630,683,897,630,682,,,0,0,1,,,,,,
898,630,707,897,630,707,,,1,0,0,,,,,,
898,631,732,898,631,732,,,0,0,0,,,,,,
898,631,757,898,631,756,,,0,0,1,,,,,,
899,632,781,899,632,781,,,0,0,0,,,,,,
898,650,204,898,650,204,,,0,0,0,,,,,,
898,650,205,898,650,204,,,0,0,1,,,,,,
898,650,208,898,650,207,,,0,0,1,,,,,,
898,650,213,898,650,214,,,0,0,-1,,,,,,
898,650,220,898,650,220,,,0,0,0,,,,,,
898,650,230,898,650,231,,,0,0,-1,,,,,,
898,650,242,898,650,242,,,0,0,0,,,,,,
899,650,255,898,650,256,,,1,0,-1,,,,,,
899,651,271,898,650,270,,,1,1,1,,,,,,
899,651,287,898,650,287,,,1,1,0,,,,,,
899,651,305,899,650,304,,,0,1,1,,,,,,
899,651,323,899,651,323,,,0,0,0,,,,,,
899,651,343,899,651,342,,,0,0,1,,,,,,
899,651,363,899,651,363,,,0,0,0,,,,,,
899,652,384,899,651,384,,,0,1,0,,,,,,
899,652,405,899,652,405,,,0,0,0,,,,,,
900,652,427,899,652,427,,,1,0,0,,,,,,
900,652,449,899,652,449,,,1,0,0,,,,,,
900,653,472,900,652,472,,,0,1,0,,,,,,
900,653,494,900,653,494,,,0,0,0,,,,,,
900,653,517,900,653,517,,,0,0,0,,,,,,
901,654,541,900,654,540,,,1,0,1,,,,,,
901,654,564,901,654,564,,,0,0,0,,,,,,
901,655,588,901,655,588,,,0,0,0,,,,,,
902,655,612,902,655,612,,,0,0,0,,,,,,
902,656,636,902,656,636,,,0,0,0,,,,,,
902,656,660,902,656,660,,,0,0,0,,,,,,
903,657,684,902,657,684,,,1,0,0,,,,,,
903,657,709,903,657,708,,,0,0,1,,,,,,
903,658,733,903,658,733,,,0,0,0,,,,,,
904,658,758,904,658,758,,,0,0,0,,,,,,
904,659,783,904,659,782,,,0,0,1,,,,,,
904,678,210,904,677,210,,,0,1,0,,,,,,
904,678,211,904,677,210,,,0,1,1,,,,,,
904,678,214,904,677,213,,,0,1,1,,,,,,
904,678,219,904,677,220,,,0,1,-1,,,,,,
904,678,226,904,677,226,,,0,1,0,,,,,,
904,678,235,904,677,236,,,0,1,-1,,,,,,
904,678,247,904,678,247,,,0,0,0,,,,,,
904,678,260,904,678,261,,,0,0,-1,,,,,,
904,678,275,904,678,275,,,0,0,0,,,,,,
904,678,291,904,678,291,,,0,0,0,,,,,,
904,678,309,904,678,308,,,0,0,1,,,,,,
905,678,327,904,678,327,,,1,0,0,,,,,,
905,679,346,905,678,346,,,0,1,0,,,,,,
905,679,366,905,678,366,,,0,1,0,,,,,,
905,679,387,905,679,387,,,0,0,0,,,,,,
905,679,408,905,679,408,,,0,0,0,,,,,,
905,679,430,905,679,429,,,0,0,1,,,,,,
905,680,452,905,679,452,,,0,1,0,,,,,,
906,680,474,905,680,474,,,1,0,0,,,,,,
906,680,497,906,680,497,,,0,0,0,,,,,,
906,681,520,906,680,519,,,0,1,1,,,,,,
906,681,543,906,681,543,,,0,0,0,,,,,,
907,681,566,906,681,566,,,1,0,0,,,,,,
907,682,590,907,682,590,,,0,0,0,,,,,,
907,682,614,907,682,613,,,0,0,1,,,,,,
908,683,638,907,683,637,,,1,0,1,,,,,,
908,683,662,908,683,661,,,0,0,1,,,,,,
908,684,686,908,684,686,,,0,0,0,,,,,,
909,684,710,908,684,710,,,1,0,0,,,,,,
909,685,735,909,685,734,,,0,0,1,,,,,,
909,685,759,909,685,759,,,0,0,0,,,,,,
910,686,784,910,686,784,,,0,0,0,,,,,,
910,705,216,910,705,216,,,0,0,0,,,,,,
910,705,217,910,705,216,,,0,0,1,,,,,,
910,705,220,910,705,220,,,0,0,0,,,,,,
910,705,225,910,705,226,,,0,0,-1,,,,,,
910,705,232,910,705,232,,,0,0,0,,,,,,
910,705,241,910,705,242,,,0,0,-1,,,,,,
910,705,252,910,705,252,,,0,0,0,,,,,,
910,705,265,910,705,266,,,0,0,-1,,,,,,
910,705,280,910,705,280,,,0,0,0,,,,,,
910,706,296,910,705,296,,,0,1,0,,,,,,
910,706,313,910,706,312,,,0,0,1,,,,,,
910,706,331,910,706,331,,,0,0,0,,,,,,
911,706,350,911,706,350,,,0,0,0,,,,,,
911,706,370,911,706,370,,,0,0,0,,,,,,
911,706,390,911,706,390,,,0,0,0,,,,,,
911,707,411,911,706,411,,,0,1,0,,,,,,
911,707,433,911,707,432,,,0,0,1,,,,,,
911,707,454,911,707,454,,,0,0,0,,,,,,
912,707,477,911,707,477,,,1,0,0,,,,,,
912,708,499,911,707,499,,,1,1,0,,,,,,
912,708,522,912,708,522,,,0,0,0,,,,,,
912,708,545,912,708,545,,,0,0,0,,,,,,
913,709,568,912,709,568,,,1,0,0,,,,,,
913,709,592,912,709,592,,,1,0,0,,,,,,
913,710,616,913,709,615,,,0,1,1,,,,,,
913,710,640,913,710,639,,,0,0,1,,,,,,
914,710,664,914,710,663,,,0,0,1,,,,,,
914,711,688,914,711,687,,,0,0,1,,,,,,
914,711,712,914,711,712,,,0,0,0,,,,,,
915,712,736,915,712,736,,,0,0,0,,,,,,
915,712,761,915,712,761,,,0,0,0,,,,,,
916,713,786,915,713,785,,,1,0,1,,,,,,
916,733,223,916,733,223,,,0,0,0,,,,,,
916,733,224,916,733,223,,,0,0,1,,,,,,
916,733,226,916,733,226,,,0,0,0,,,,,,
916,733,231,916,733,232,,,0,0,-1,,,,,,
916,733,238,916,733,238,,,0,0,0,,,,,,
916,733,247,916,733,247,,,0,0,0,,,,,,
916,733,258,916,733,257,,,0,0,1,,,,,,
916,733,270,916,733,271,,,0,0,-1,,,,,,
916,733,285,916,733,284,,,0,0,1,,,,,,
916,733,300,916,733,300,,,0,0,0,,,,,,
916,733,317,916,733,317,,,0,0,0,,,,,,
917,734,335,917,733,335,,,0,1,0,,,,,,
917,734,354,917,734,353,,,0,0,1,,,,,,
917,734,373,917,734,373,,,0,0,0,,,,,,
917,734,393,917,734,393,,,0,0,0,,,,,,
917,734,414,917,734,414,,,0,0,0,,,,,,
917,735,436,917,734,435,,,0,1,1,,,,,,
918,735,457,917,735,457,,,1,0,0,,,,,,
918,735,479,918,735,479,,,0,0,0,,,,,,
918,735,502,918,735,502,,,0,0,0,,,,,,
918,736,524,918,736,524,,,0,0,0,,,,,,
918,736,547,918,736,547,,,0,0,0,,,,,,
919,736,571,919,736,570,,,0,0,1,,,,,,
919,737,594,919,736,594,,,0,1,0,,,,,,
919,737,618,919,737,617,,,0,0,1,,,,,,
920,738,641,919,737,641,,,1,1,0,,,,,,
920,738,665,920,738,665,,,0,0,0,,,,,,
920,738,689,920,738,689,,,0,0,0,,,,,,
921,739,714,920,739,713,,,1,0,1,,,,,,
921,739,738,921,739,738,,,0,0,0,,,,,,
921,740,763,921,740,762,,,0,0,1,,,,,,
922,740,787,921,740,787,,,1,0,0,,,,,,
922,761,229,922,761,229,,,0,0,0,,,,,,
922,761,230,922,761,229,,,0,0,1,,,,,,
922,761,232,922,761,232,,,0,0,0,,,,,,
922,761,237,922,761,238,,,0,0,-1,,,,,,
923,761,244,922,761,244,,,1,0,0,,,,,,
923,761,252,922,761,253,,,1,0,-1,,,,,,
923,761,263,922,761,263,,,1,0,0,,,,,,
923,761,276,922,761,276,,,1,0,0,,,,,,
923,761,290,922,761,289,,,1,0,1,,,,,,
923,761,305,922,761,305,,,1,0,0,,,,,,
923,761,321,923,761,321,,,0,0,0,,,,,,
923,762,339,923,761,339,,,0,1,0,,,,,,
923,762,358,923,762,357,,,0,0,1,,,,,,
923,762,377,923,762,377,,,0,0,0,,,,,,
923,762,397,923,762,397,,,0,0,0,,,,,,
924,762,418,923,762,418,,,1,0,0,,,,,,
924,762,439,923,762,439,,,1,0,0,,,,,,
924,763,460,924,762,460,,,0,1,0,,,,,,
924,763,482,924,763,482,,,0,0,0,,,,,,
924,763,504,924,763,504,,,0,0,0,,,,,,
925,764,527,924,764,527,,,1,0,0,,,,,,
925,764,550,925,764,550,,,0,0,0,,,,,,
925,764,573,925,764,573,,,0,0,0,,,,,,
925,765,596,925,764,596,,,0,1,0,,,,,,
926,765,620,925,765,620,,,1,0,0,,,,,,
926,765,643,926,765,643,,,0,0,0,,,,,,
926,766,667,926,766,667,,,0,0,0,,,,,,
927,766,691,926,766,691,,,1,0,0,,,,,,
927,767,716,927,767,715,,,0,0,1,,,,,,
927,767,740,927,767,740,,,0,0,0,,,,,,
928,768,764,927,768,764,,,1,0,0,,,,,,
928,768,789,928,768,789,,,0,0,0,,,,,,
929,789,236,929,789,236,,,0,0,0,,,,,,
929,789,237,929,789,236,,,0,0,1,,,,,,
929,789,239,929,789,239,,,0,0,0,,,,,,
929,789,243,929,789,244,,,0,0,-1,,,,,,
929,789,250,929,789,250,,,0,0,0,,,,,,
929,789,258,929,789,259,,,0,0,-1,,,,,,
929,789,269,929,789,268,,,0,0,1,,,,,,
929,789,281,929,789,281,,,0,0,0,,,,,,
929,789,295,929,789,294,,,0,0,1,,,,,,
929,789,310,929,789,310,,,0,0,0,,,,,,
930,789,326,930,789,326,,,0,0,0,,,,,,
930,790,343,930,789,343,,,0,1,0,,,,,,
930,790,362,930,790,361,,,0,0,1,,,,,,
930,790,381,930,790,381,,,0,0,0,,,,,,
930,790,401,930,790,400,,,0,0,1,,,,,,
930,790,421,930,790,421,,,0,0,0,,,,,,
930,790,442,930,790,442,,,0,0,0,,,,,,
931,791,463,930,790,463,,,1,1,0,,,,,,
931,791,485,931,791,485,,,0,0,0,,,,,,
931,791,507,931,791,507,,,0,0,0,,,,,,
931,792,530,931,792,529,,,0,0,1,,,,,,
931,792,552,931,792,552,,,0,0,0,,,,,,
932,792,575,932,792,575,,,0,0,0,,,,,,
932,792,599,932,792,598,,,0,0,1,,,,,,
932,793,622,932,793,622,,,0,0,0,,,,,,
933,793,646,932,793,645,,,1,0,1,,,,,,
933,794,669,933,794,669,,,0,0,0,,,,,,
933,794,693,933,794,693,,,0,0,0,,,,,,
934,794,717,934,794,717,,,0,0,0,,,,,,
934,795,742,934,795,741,,,0,0,1,,,,,,
934,795,766,934,795,766,,,0,0,0,,,,,,
935,796,790,934,796,790,,,1,0,0,,,,,,
936,817,243,936,817,243,,,0,0,0,,,,,,
936,817,243,936,817,243,,,0,0,0,,,,,,
936,817,246,936,817,246,,,0,0,0,,,,,,
936,817,250,936,817,251,,,0,0,-1,,,,,,
936,817,256,936,817,256,,,0,0,0,,,,,,
936,817,264,936,817,265,,,0,0,-1,,,,,,
936,817,275,936,817,274,,,0,0,1,,,,,,
936,817,286,936,817,287,,,0,0,-1,,,,,,
936,817,300,936,817,300,,,0,0,0,,,,,,
936,817,315,936,817,315,,,0,0,0,,,,,,
937,818,331,937,818,330,,,0,0,1,,,,,,
937,818,348,937,818,348,,,0,0,0,,,,,,
937,818,366,937,818,366,,,0,0,0,,,,,,
937,818,385,937,818,385,,,0,0,0,,,,,,
937,818,404,937,818,404,,,0,0,0,,,,,,
937,818,424,937,818,424,,,0,0,0,,,,,,
937,819,445,937,819,445,,,0,0,0,,,,,,
938,819,466,937,819,466,,,1,0,0,,,,,,
938,819,488,938,819,488,,,0,0,0,,,,,,
938,819,510,938,819,510,,,0,0,0,,,,,,
938,820,532,938,820,532,,,0,0,0,,,,,,
938,820,555,938,820,555,,,0,0,0,,,,,,
939,820,578,939,820,578,,,0,0,0,,,,,,
939,821,601,939,820,601,,,0,1,0,,,,,,
939,821,624,939,821,624,,,0,0,0,,,,,,
939,821,648,939,821,648,,,0,0,0,,,,,,
940,822,671,940,822,671,,,0,0,0,,,,,,
940,822,695,940,822,695,,,0,0,0,,,,,,
940,822,719,941,822,719,,,-1,0,0,,,,,,
941,823,743,941,822,743,,,0,1,0,,,,,,
941,823,768,941,823,767,,,0,0,1,,,,,,
942,824,792,941,823,792,,,1,1,0,,,,,,
943,845,249,943,845,249,,,0,0,0,,,,,,
943,845,250,943,845,249,,,0,0,1,,,,,,
943,845,252,943,845,252,,,0,0,0,,,,,,
943,845,256,943,845,257,,,0,0,-1,,,,,,
943,845,263,943,845,262,,,0,0,1,,,,,,
943,845,271,943,845,271,,,0,0,0,,,,,,
943,846,280,943,845,280,,,0,1,0,,,,,,
943,846,292,943,845,292,,,0,1,0,,,,,,
944,846,305,943,845,305,,,1,1,0,,,,,,
944,846,320,944,845,320,,,0,1,0,,,,,,
944,846,336,944,846,335,,,0,0,1,,,,,,
944,846,352,944,846,352,,,0,0,0,,,,,,
944,846,370,944,846,370,,,0,0,0,,,,,,
944,846,389,944,846,389,,,0,0,0,,,,,,
944,846,408,944,846,408,,,0,0,0,,,,,,
944,847,428,944,846,428,,,0,1,0,,,,,,
945,847,449,944,847,448,,,1,0,1,,,,,,
945,847,470,944,847,469,,,1,0,1,,,,,,
945,847,491,945,847,491,,,0,0,0,,,,,,
945,848,513,945,847,513,,,0,1,0,,,,,,
945,848,535,945,848,535,,,0,0,0,,,,,,
946,848,558,945,848,557,,,1,0,1,,,,,,
946,848,580,946,848,580,,,0,0,0,,,,,,
946,849,603,946,848,603,,,0,1,0,,,,,,
946,849,627,946,849,626,,,0,0,1,,,,,,
947,849,650,946,849,650,,,1,0,0,,,,,,
947,850,674,947,850,673,,,0,0,1,,,,,,
947,850,697,947,850,697,,,0,0,0,,,,,,
948,851,721,948,850,721,,,0,1,0,,,,,,
948,851,745,948,851,745,,,0,0,0,,,,,,
948,851,770,948,851,769,,,0,0,1,,,,,,
949,852,794,948,851,794,,,1,1,0,,,,,,
951,874,256,950,874,256,,,1,0,0,,,,,,
951,874,257,950,874,256,,,1,0,1,,,,,,
951,874,259,950,874,259,,,1,0,0,,,,,,
951,874,263,950,874,264,,,1,0,-1,,,,,,
951,874,269,950,874,269,,,1,0,0,,,,,,
951,874,277,950,874,277,,,1,0,0,,,,,,
951,874,286,951,874,286,,,0,0,0,,,,,,
951,874,298,951,874,298,,,0,0,0,,,,,,
951,874,311,951,874,310,,,0,0,1,,,,,,
951,874,325,951,874,325,,,0,0,0,,,,,,
951,874,340,951,874,340,,,0,0,0,,,,,,
951,874,357,951,874,357,,,0,0,0,,,,,,
951,875,375,951,874,374,,,0,1,1,,,,,,
951,875,393,951,874,393,,,0,1,0,,,,,,
952,875,412,951,875,412,,,1,0,0,,,,,,
952,875,432,951,875,432,,,1,0,0,,,,,,
952,875,452,952,875,452,,,0,0,0,,,,,,
952,875,473,952,875,473,,,0,0,0,,,,,,
952,876,494,952,875,494,,,0,1,0,,,,,,
952,876,516,952,875,516,,,0,1,0,,,,,,
953,876,538,952,876,538,,,1,0,0,,,,,,
953,876,560,953,876,560,,,0,0,0,,,,,,
953,877,583,953,877,583,,,0,0,0,,,,,,
953,877,606,953,877,606,,,0,0,0,,,,,,
954,877,629,953,877,629,,,1,0,0,,,,,,
954,878,652,954,877,652,,,0,1,0,,,,,,
954,878,676,954,878,676,,,0,0,0,,,,,,
955,878,700,955,878,699,,,0,0,1,,,,,,
955,879,724,955,879,723,,,0,0,1,,,,,,
955,879,747,955,879,747,,,0,0,0,,,,,,
956,880,772,955,879,771,,,1,1,1,,,,,,
956,880,796,956,880,796,,,0,0,0,,,,,,
958,902,263,958,902,263,,,0,0,0,,,,,,
958,902,264,958,902,263,,,0,0,1,,,,,,
958,902,266,958,902,266,,,0,0,0,,,,,,
958,902,270,958,902,270,,,0,0,0,,,,,,
958,902,276,958,902,275,,,0,0,1,,,,,,
958,902,283,958,902,284,,,0,0,-1,,,,,,
958,902,293,958,902,292,,,0,0,1,,,,,,
958,903,304,958,902,304,,,0,1,0,,,,,,
959,903,316,958,902,316,,,1,1,0,,,,,,
959,903,330,959,902,331,,,0,1,-1,,,,,,
959,903,346,959,903,345,,,0,0,1,,,,,,
959,903,362,959,903,362,,,0,0,0,,,,,,
959,903,379,959,903,379,,,0,0,0,,,,,,
959,903,397,959,903,397,,,0,0,0,,,,,,
959,903,416,959,903,416,,,0,0,0,,,,,,
959,904,436,959,903,436,,,0,1,0,,,,,,
960,904,456,959,903,456,,,1,1,0,,,,,,
960,904,477,960,903,476,,,0,1,1,,,,,,
960,904,498,960,904,497,,,0,0,1,,,,,,
960,904,519,960,904,519,,,0,0,0,,,,,,
960,905,541,960,904,541,,,0,1,0,,,,,,
961,905,563,960,905,563,,,1,0,0,,,,,,
961,905,586,961,905,586,,,0,0,0,,,,,,
961,905,609,961,905,608,,,0,0,1,,,,,,
961,906,632,961,906,631,,,0,0,1,,,,,,
962,906,655,961,906,655,,,1,0,0,,,,,,
962,906,678,962,906,678,,,0,0,0,,,,,,
962,907,702,962,906,702,,,0,1,0,,,,,,
963,907,726,963,907,725,,,0,0,1,,,,,,
963,908,750,963,907,749,,,0,1,1,,,,,,
963,908,774,963,908,773,,,0,0,1,,,,,,
964,908,798,963,908,798,,,1,0,0,,,,,,
